GEOID,Total_population_e,NotHispanic_White_pop_e,Hispanic_or_Latino_population_e,Not_Hispanic_or_Latino_pop_e,OBJECTID
15000US060014001001,3018,2145,83,2935,3
15000US060014002001,1105,768,156,949,4
15000US060014002002,855,658,55,800,5
15000US060014003001,1466,877,89,1377,6
15000US060014003002,1265,846,102,1163,7
15000US060014003003,985,462,47,938,8
15000US060014003004,1520,1161,148,1372,9
15000US060014004001,1387,1066,108,1279,10
15000US060014004002,1193,693,91,1102,11
15000US060014004003,1591,999,67,1524,12
15000US060014005001,2548,1354,339,2209,13
15000US060014005002,674,348,31,643,14
15000US060014005003,526,270,116,410,15
15000US060014006001,1105,400,106,999,16
15000US060014006002,556,236,52,504,17
15000US060014007001,1143,338,244,899,18
15000US060014007002,1536,650,71,1465,19
15000US060014007003,706,265,193,513,20
15000US060014007004,1167,447,244,923,21
15000US060014008001,1585,468,116,1469,22
15000US060014008002,823,340,257,566,23
15000US060014008003,1098,582,48,1050,24
15000US060014009001,1321,396,181,1140,25
15000US060014009002,941,503,83,858,26
15000US060014010001,1248,165,232,1016,27
15000US060014010002,1046,403,294,752,28
15000US060014010003,1525,534,299,1226,29
15000US060014010004,581,193,196,385,30
15000US060014010005,837,246,207,630,31
15000US060014010006,956,373,152,804,32
15000US060014011001,480,235,25,455,33
15000US060014011002,1384,888,266,1118,34
15000US060014011003,1166,496,34,1132,35
15000US060014011004,1108,511,130,978,36
15000US060014012001,1193,694,318,875,37
15000US060014012002,869,492,66,803,38
15000US060014012003,552,300,54,498,39
15000US060014013001,1119,394,81,1038,40
15000US060014013002,1693,477,283,1410,41
15000US060014013003,1164,416,142,1022,42
15000US060014014001,1029,125,346,683,43
15000US060014014002,1990,428,592,1398,44
15000US060014014003,1089,138,207,882,45
15000US060014015001,1095,323,70,1025,46
15000US060014015002,747,360,90,657,47
15000US060014015003,763,274,154,609,48
15000US060014016001,1164,321,369,795,49
15000US060014016002,1009,233,109,900,50
15000US060014017001,768,310,125,643,51
15000US060014017002,1828,508,667,1161,52
15000US060014017003,83,33,50,33,53
15000US060014018001,954,301,187,767,54
15000US060014018002,912,209,174,738,55
15000US060014022001,916,184,181,735,56
15000US060014022002,937,194,234,703,57
15000US060014022003,553,274,130,423,58
15000US060014024001,1639,529,191,1448,59
15000US060014024002,1134,76,46,1088,60
15000US060014025001,1166,120,245,921,61
15000US060014025002,667,35,108,559,62
15000US060014026001,1272,219,94,1178,63
15000US060014027001,719,292,132,587,64
15000US060014027002,1015,185,264,751,65
15000US060014028001,1459,397,205,1254,66
15000US060014028002,2339,515,132,2207,67
15000US060014029001,1392,326,167,1225,68
15000US060014030001,1737,165,33,1704,69
15000US060014030002,1430,45,23,1407,70
15000US060014031001,1721,436,171,1550,71
15000US060014033001,2346,761,172,2174,72
15000US060014033002,1813,88,144,1669,73
15000US060014034001,887,648,52,835,74
15000US060014034002,1180,275,122,1058,75
15000US060014034003,861,323,120,741,76
15000US060014034004,1432,388,82,1350,77
15000US060014035011,1940,356,194,1746,78
15000US060014035012,2062,1038,315,1747,79
15000US060014035013,433,74,24,409,80
15000US060014035021,798,523,65,733,81
15000US060014035022,1283,552,107,1176,82
15000US060014036001,1110,309,72,1038,83
15000US060014036002,1999,842,249,1750,84
15000US060014036003,1642,647,278,1364,85
15000US060014037011,1348,724,133,1215,86
15000US060014037012,1407,800,157,1250,87
15000US060014037021,632,361,152,480,88
15000US060014037022,1395,823,95,1300,89
15000US060014038001,539,303,34,505,90
15000US060014038002,803,596,69,734,91
15000US060014038003,718,336,107,611,92
15000US060014038004,1263,905,70,1193,93
15000US060014039001,1563,821,76,1487,94
15000US060014039002,692,404,34,658,95
15000US060014039003,1683,928,49,1634,96
15000US060014040001,1933,1104,301,1632,97
15000US060014040002,999,638,129,870,98
15000US060014041011,1226,806,100,1126,99
15000US060014041012,1961,1286,116,1845,100
15000US060014041021,1278,961,73,1205,101
15000US060014041022,1160,654,145,1015,102
15000US060014042001,957,699,13,944,103
15000US060014042002,1482,1039,50,1432,104
15000US060014042003,1211,687,118,1093,105
15000US060014043001,1034,703,38,996,106
15000US060014043002,991,578,152,839,107
15000US060014043003,1304,857,168,1136,108
15000US060014044001,2206,1450,142,2064,109
15000US060014044002,1527,1019,93,1434,110
15000US060014044003,1671,1282,123,1548,111
15000US060014045011,1836,1193,150,1686,112
15000US060014045021,532,446,65,467,113
15000US060014045022,1237,781,77,1160,114
15000US060014045023,1808,977,270,1538,115
15000US060014045024,1826,1363,27,1799,116
15000US060014046001,1081,709,41,1040,117
15000US060014046002,700,471,34,666,118
15000US060014046003,1250,960,61,1189,119
15000US060014046004,1316,1038,28,1288,120
15000US060014047001,1007,662,94,913,121
15000US060014047002,1159,868,74,1085,122
15000US060014048001,1628,452,182,1446,123
15000US060014048002,1156,679,86,1070,124
15000US060014049001,629,439,55,574,125
15000US060014049002,1289,529,81,1208,126
15000US060014049003,780,413,212,568,127
15000US060014049004,1297,879,110,1187,128
15000US060014050001,638,502,40,598,129
15000US060014050002,1035,551,149,886,130
15000US060014050003,1575,1055,61,1514,131
15000US060014051001,880,683,38,842,132
15000US060014051002,749,426,22,727,133
15000US060014051003,1055,629,46,1009,134
15000US060014051004,523,300,13,510,135
15000US060014051005,1058,692,17,1041,136
15000US060014052001,1345,333,229,1116,137
15000US060014052002,970,420,72,898,138
15000US060014052003,1313,385,293,1020,139
15000US060014052004,1471,555,250,1221,140
15000US060014053011,2098,1042,231,1867,141
15000US060014053012,801,221,112,689,142
15000US060014053021,1347,418,216,1131,143
15000US060014053022,1269,264,310,959,144
15000US060014054011,1794,518,459,1335,145
15000US060014054012,1143,43,454,689,146
15000US060014054013,1150,125,98,1052,147
15000US060014054021,1753,62,236,1517,148
15000US060014054022,1486,247,213,1273,149
15000US060014055001,1063,138,146,917,150
15000US060014055002,857,81,46,811,151
15000US060014055003,1098,225,159,939,152
15000US060014055004,1086,397,136,950,153
15000US060014056001,928,160,118,810,154
15000US060014056002,1213,316,350,863,155
15000US060014056003,1007,438,207,800,156
15000US060014057001,1538,309,112,1426,157
15000US060014057002,1121,16,512,609,158
15000US060014057003,1042,104,254,788,159
15000US060014058001,1232,88,478,754,160
15000US060014058002,1251,148,144,1107,161
15000US060014058003,1109,150,117,992,162
15000US060014058004,645,78,124,521,163
15000US060014059011,1434,9,926,508,164
15000US060014059012,1814,103,446,1368,165
15000US060014059013,1045,9,194,851,166
15000US060014059021,1522,52,286,1236,167
15000US060014059022,1648,137,628,1020,168
15000US060014060001,814,427,108,706,169
15000US060014060002,383,0,43,340,170
15000US060014060003,2250,359,196,2054,171
15000US060014061001,1488,55,1222,266,172
15000US060014061002,621,24,388,233,173
15000US060014061003,1328,430,513,815,174
15000US060014061004,1398,183,850,548,175
15000US060014062011,985,131,298,687,176
15000US060014062012,897,30,345,552,177
15000US060014062013,1495,100,716,779,178
15000US060014062014,919,67,543,376,179
15000US060014062021,1002,43,797,205,180
15000US060014062022,1460,152,709,751,181
15000US060014062023,2212,245,1480,732,182
15000US060014063001,1167,113,546,621,183
15000US060014063002,1212,98,364,848,184
15000US060014063003,1031,208,286,745,185
15000US060014063004,738,25,98,640,186
15000US060014064001,707,260,66,641,187
15000US060014064002,1511,353,293,1218,188
15000US060014065001,1871,227,734,1137,189
15000US060014065002,1136,100,262,874,190
15000US060014065003,2109,30,1409,700,191
15000US060014065004,1458,156,799,659,192
15000US060014066011,974,66,134,840,193
15000US060014066012,1637,153,570,1067,194
15000US060014066013,1782,241,479,1303,195
15000US060014066014,442,67,104,338,196
15000US060014066021,1077,239,128,949,197
15000US060014066022,1690,243,571,1119,198
15000US060014067001,1177,793,145,1032,199
15000US060014067002,474,253,62,412,200
15000US060014067003,2146,841,335,1811,201
15000US060014067004,696,391,126,570,202
15000US060014067005,476,337,0,476,203
15000US060014068001,729,453,99,630,204
15000US060014068002,728,288,20,708,205
15000US060014068003,1075,382,219,856,206
15000US060014068004,951,334,162,789,207
15000US060014069001,486,375,63,423,208
15000US060014069002,1416,673,185,1231,209
15000US060014069003,2087,404,306,1781,210
15000US060014070001,1173,115,223,950,211
15000US060014070002,1410,355,204,1206,212
15000US060014070003,823,155,533,290,213
15000US060014070004,1494,115,484,1010,214
15000US060014070005,1002,28,340,662,215
15000US060014071011,1865,160,1191,674,216
15000US060014071012,1673,187,489,1184,217
15000US060014071021,1735,212,863,872,218
15000US060014071022,1030,111,648,382,219
15000US060014071023,732,41,334,398,220
15000US060014071024,799,49,204,595,221
15000US060014072001,1732,14,1402,330,222
15000US060014072002,1404,112,788,616,223
15000US060014072003,1009,216,394,615,224
15000US060014072004,2471,97,1966,505,225
15000US060014073001,1371,58,811,560,226
15000US060014073002,1130,376,531,599,227
15000US060014074001,1990,101,1165,825,228
15000US060014074002,1399,47,918,481,229
15000US060014074003,1063,28,883,180,230
15000US060014075001,895,48,263,632,231
15000US060014075002,2605,66,1679,926,232
15000US060014075003,701,143,112,589,233
15000US060014076001,1689,388,210,1479,234
15000US060014076002,1385,198,488,897,235
15000US060014076003,694,64,390,304,236
15000US060014076004,1833,35,404,1429,237
15000US060014076005,797,64,323,474,238
15000US060014077001,1452,366,142,1310,239
15000US060014077002,1105,274,154,951,240
15000US060014077003,861,321,191,670,241
15000US060014077004,905,288,61,844,242
15000US060014078001,922,327,214,708,243
15000US060014078002,1049,284,168,881,244
15000US060014078003,748,169,66,682,245
15000US060014079001,684,418,31,653,246
15000US060014079002,1234,412,149,1085,247
15000US060014079003,1159,421,199,960,248
15000US060014080001,738,478,44,694,249
15000US060014080002,2001,821,276,1725,250
15000US060014081001,1260,988,85,1175,251
15000US060014081002,3150,870,448,2702,252
15000US060014081003,1151,386,52,1099,253
15000US060014081004,705,69,115,590,254
15000US060014082001,1398,542,216,1182,255
15000US060014082002,1892,160,307,1585,256
15000US060014082003,872,82,150,722,257
15000US060014083001,530,243,176,354,258
15000US060014083002,1110,334,257,853,259
15000US060014083003,941,316,57,884,260
15000US060014083004,1760,146,443,1317,261
15000US060014083005,598,135,100,498,262
15000US060014084001,1449,108,968,481,263
15000US060014084002,874,0,335,539,264
15000US060014084003,806,220,117,689,265
15000US060014085001,1022,8,622,400,266
15000US060014085002,1245,15,884,361,267
15000US060014085003,1140,10,584,556,268
15000US060014085004,793,41,372,421,269
15000US060014085005,1547,29,1042,505,270
15000US060014086001,1882,83,833,1049,271
15000US060014086002,1649,79,692,957,272
15000US060014086003,1826,50,1432,394,273
15000US060014086004,935,18,560,375,274
15000US060014087001,1125,127,523,602,275
15000US060014087002,1558,0,576,982,276
15000US060014087003,1279,1,688,591,277
15000US060014087004,1051,85,414,637,278
15000US060014087005,1344,158,620,724,279
15000US060014087006,1401,17,1034,367,280
15000US060014088001,1783,56,1347,436,281
15000US060014088002,1146,156,324,822,282
15000US060014088003,1219,0,305,914,283
15000US060014088004,2200,17,1485,715,284
15000US060014089001,1379,56,856,523,285
15000US060014089002,1726,52,1023,703,286
15000US060014090001,1929,52,1071,858,287
15000US060014090002,0,0,0,0,288
15000US060014090003,1823,82,926,897,289
15000US060014090004,0,0,0,0,290
15000US060014091001,1262,29,616,646,291
15000US060014091002,1152,12,354,798,292
15000US060014092001,2051,105,850,1201,293
15000US060014092002,1532,36,854,678,294
15000US060014093001,1679,77,930,749,295
15000US060014093002,1304,191,707,597,296
15000US060014093003,923,13,531,392,297
15000US060014093004,1080,31,826,254,298
15000US060014094001,874,73,592,282,299
15000US060014094002,2607,93,1334,1273,300
15000US060014094003,1407,91,934,473,301
15000US060014095001,1787,140,941,846,302
15000US060014095002,1357,74,755,602,303
15000US060014095003,1204,7,944,260,304
15000US060014096001,1267,0,804,463,305
15000US060014096002,692,48,394,298,306
15000US060014096003,946,10,583,363,307
15000US060014096004,483,23,233,250,308
15000US060014096005,1455,38,1077,378,309
15000US060014097001,973,23,333,640,310
15000US060014097002,2075,27,1337,738,311
15000US060014097003,1188,67,498,690,312
15000US060014097004,1257,14,608,649,313
15000US060014098001,843,157,109,734,314
15000US060014098002,1676,202,363,1313,315
15000US060014098003,701,7,19,682,316
15000US060014099001,678,186,182,496,317
15000US060014099002,682,100,135,547,318
15000US060014099003,1263,377,86,1177,319
15000US060014099004,826,157,105,721,320
15000US060014100001,875,645,44,831,321
15000US060014100002,2336,493,161,2175,322
15000US060014100003,13,13,0,13,323
15000US060014101001,1222,145,297,925,324
15000US060014101002,1512,126,174,1338,325
15000US060014102001,1634,63,968,666,326
15000US060014102002,966,52,195,771,327
15000US060014102003,774,117,141,633,328
15000US060014103001,628,52,409,219,329
15000US060014103002,1442,11,845,597,330
15000US060014103003,1464,6,1030,434,331
15000US060014104001,1285,24,660,625,332
15000US060014104002,1409,47,493,916,333
15000US060014104003,1807,209,802,1005,334
15000US060014105001,2303,128,190,2113,335
15000US060014201001,1075,648,104,971,336
15000US060014201002,661,538,12,649,337
15000US060014201003,696,406,54,642,338
15000US060014202001,1338,743,40,1298,339
15000US060014202002,1130,500,247,883,340
15000US060014202003,866,367,135,731,341
15000US060014203001,1529,629,267,1262,342
15000US060014203002,2256,796,153,2103,343
15000US060014203003,905,411,72,833,344
15000US060014204001,3301,886,848,2453,345
15000US060014205001,898,468,90,808,346
15000US060014205002,1604,856,143,1461,347
15000US060014206001,1231,1039,30,1201,348
15000US060014206002,886,617,121,765,349
15000US060014206003,1044,538,190,854,350
15000US060014211001,791,620,19,772,351
15000US060014211002,1332,1019,84,1248,352
15000US060014212001,605,471,33,572,353
15000US060014212002,1457,1165,136,1321,354
15000US060014212003,884,673,23,861,355
15000US060014212004,697,534,96,601,356
15000US060014213001,970,724,54,916,357
15000US060014213002,1275,1023,10,1265,358
15000US060014213003,890,662,43,847,359
15000US060014213004,807,662,8,799,360
15000US060014214001,1041,756,91,950,361
15000US060014214002,649,503,30,619,362
15000US060014215001,1208,984,22,1186,363
15000US060014215002,1270,970,59,1211,364
15000US060014215003,1349,1170,79,1270,365
15000US060014216001,916,677,36,880,366
15000US060014216002,1165,884,48,1117,367
15000US060014216003,706,478,17,689,368
15000US060014216004,723,538,83,640,369
15000US060014217001,1654,1151,148,1506,370
15000US060014217002,911,497,141,770,371
15000US060014217003,1046,712,71,975,372
15000US060014218001,1040,774,40,1000,373
15000US060014218002,1090,794,42,1048,374
15000US060014219001,762,525,66,696,375
15000US060014219002,1050,621,76,974,376
15000US060014219003,993,764,13,980,377
15000US060014219004,1073,720,16,1057,378
15000US060014220001,1353,985,175,1178,379
15000US060014220002,716,275,109,607,380
15000US060014221001,813,302,142,671,381
15000US060014221002,1792,971,319,1473,382
15000US060014222001,1188,776,28,1160,383
15000US060014222002,1299,703,199,1100,384
15000US060014222003,1073,577,158,915,385
15000US060014223001,888,462,162,726,386
15000US060014223002,1403,993,89,1314,387
15000US060014223003,1562,822,128,1434,388
15000US060014224001,1967,973,152,1815,389
15000US060014224002,987,471,31,956,390
15000US060014224003,1231,791,162,1069,391
15000US060014225001,1162,748,93,1069,392
15000US060014225002,1079,514,89,990,393
15000US060014225003,1894,971,260,1634,394
15000US060014226001,1440,592,174,1266,395
15000US060014227001,919,550,156,763,396
15000US060014227002,1182,647,185,997,397
15000US060014227003,2794,1297,515,2279,398
15000US060014228001,4635,1291,720,3915,399
15000US060014228002,1747,522,287,1460,400
15000US060014228003,2266,880,147,2119,401
15000US060014229001,2234,1012,83,2151,402
15000US060014229002,2790,993,170,2620,403
15000US060014230001,1740,842,311,1429,404
15000US060014230002,1504,1030,176,1328,405
15000US060014230003,1097,828,41,1056,406
15000US060014231001,1691,897,184,1507,407
15000US060014231002,831,376,73,758,408
15000US060014231003,1081,375,162,919,409
15000US060014231004,704,413,27,677,410
15000US060014232001,1410,456,547,863,411
15000US060014232002,1522,646,262,1260,412
15000US060014233001,1603,456,200,1403,413
15000US060014233002,1642,698,279,1363,414
15000US060014233003,884,421,79,805,415
15000US060014234001,1044,619,146,898,416
15000US060014234002,1016,580,125,891,417
15000US060014234003,1847,803,278,1569,418
15000US060014234004,1335,403,302,1033,419
15000US060014235001,1206,593,209,997,420
15000US060014235002,905,428,169,736,421
15000US060014235003,1151,690,132,1019,422
15000US060014236011,1489,996,183,1306,423
15000US060014236012,1263,966,107,1156,424
15000US060014236021,1794,862,139,1655,425
15000US060014236022,1513,392,229,1284,426
15000US060014236023,2148,1019,250,1898,427
15000US060014237001,1696,930,144,1552,428
15000US060014237002,1228,1008,101,1127,429
15000US060014237003,1186,693,68,1118,430
15000US060014238001,693,497,32,661,431
15000US060014238002,1221,930,169,1052,432
15000US060014238003,1153,903,88,1065,433
15000US060014239011,921,617,112,809,434
15000US060014239012,1017,514,166,851,435
15000US060014239021,740,562,84,656,436
15000US060014239022,824,576,60,764,437
15000US060014240011,944,424,102,842,438
15000US060014240012,1117,482,164,953,439
15000US060014240013,1024,490,278,746,440
15000US060014240014,1182,322,113,1069,441
15000US060014240021,1218,347,263,955,442
15000US060014240022,1233,498,316,917,443
15000US060014251011,299,203,18,281,444
15000US060014251012,1311,732,25,1286,445
15000US060014251021,1071,407,112,959,446
15000US060014251022,1339,570,57,1282,447
15000US060014251023,670,309,64,606,448
15000US060014251031,789,364,52,737,449
15000US060014251032,879,426,27,852,450
15000US060014251033,1392,476,300,1092,451
15000US060014251041,1922,609,369,1553,452
15000US060014251042,1439,595,221,1218,453
15000US060014261001,1511,1192,41,1470,454
15000US060014261002,582,466,15,567,455
15000US060014261003,1118,635,80,1038,456
15000US060014261004,990,779,14,976,457
15000US060014261005,1260,846,94,1166,458
15000US060014261006,832,647,0,832,459
15000US060014262001,1576,1067,85,1491,460
15000US060014262002,2198,1388,145,2053,461
15000US060014262003,1134,707,158,976,462
15000US060014271001,1068,624,139,929,463
15000US060014271002,759,624,22,737,464
15000US060014271003,1732,1133,97,1635,465
15000US060014272001,897,516,95,802,466
15000US060014272002,1771,560,459,1312,467
15000US060014272003,935,274,346,589,468
15000US060014272004,534,349,95,439,469
15000US060014272005,75,58,0,75,470
15000US060014273001,1496,752,409,1087,471
15000US060014273002,1113,402,71,1042,472
15000US060014273003,1274,408,122,1152,473
15000US060014273004,883,222,77,806,474
15000US060014273005,652,110,67,585,475
15000US060014276001,2732,710,295,2437,476
15000US060014276002,2324,420,298,2026,477
15000US060014276003,701,159,18,683,478
15000US060014277001,884,250,47,837,479
15000US060014277002,2322,1248,382,1940,480
15000US060014277003,1062,547,128,934,481
15000US060014277004,845,606,68,777,482
15000US060014278001,1059,373,151,908,483
15000US060014278002,976,819,0,976,484
15000US060014278003,747,530,0,747,485
15000US060014278004,800,353,77,723,486
15000US060014278005,1226,457,274,952,487
15000US060014279001,847,344,99,748,488
15000US060014279002,1438,837,205,1233,489
15000US060014279003,706,449,49,657,490
15000US060014279004,603,337,0,603,491
15000US060014279005,1584,438,374,1210,492
15000US060014280001,598,112,285,313,493
15000US060014280002,2424,840,247,2177,494
15000US060014281001,1642,895,177,1465,495
15000US060014281002,1033,680,174,859,496
15000US060014281003,1227,659,147,1080,497
15000US060014281004,935,619,113,822,498
15000US060014282001,1329,682,258,1071,499
15000US060014282002,1832,1123,32,1800,500
15000US060014282003,872,376,153,719,501
15000US060014282004,1256,492,158,1098,502
15000US060014282005,1050,815,42,1008,503
15000US060014283011,2248,787,274,1974,504
15000US060014283012,1044,385,131,913,505
15000US060014283013,824,320,160,664,506
15000US060014283014,2861,577,149,2712,507
15000US060014283021,2504,754,53,2451,508
15000US060014283022,2424,1328,97,2327,509
15000US060014283023,2276,1007,357,1919,510
15000US060014284001,1993,810,379,1614,511
15000US060014284002,920,345,158,762,512
15000US060014284003,1494,792,100,1394,513
15000US060014285001,2451,875,279,2172,514
15000US060014285002,697,496,67,630,515
15000US060014286001,1673,583,104,1569,516
15000US060014286002,475,235,69,406,517
15000US060014286003,1079,466,23,1056,518
15000US060014287001,2872,830,218,2654,519
15000US060014287002,1331,477,255,1076,520
15000US060014301011,1309,326,166,1143,521
15000US060014301012,2123,845,238,1885,522
15000US060014301013,3598,1242,146,3452,523
15000US060014301021,2224,1325,271,1953,524
15000US060014302001,1885,1009,306,1579,525
15000US060014302002,935,614,14,921,526
15000US060014302003,811,605,124,687,527
15000US060014302004,1642,1203,118,1524,528
15000US060014302005,1428,791,181,1247,529
15000US060014303001,1354,762,247,1107,530
15000US060014303002,1450,682,55,1395,531
15000US060014303003,1023,676,160,863,532
15000US060014304001,870,548,117,753,533
15000US060014304002,1231,635,250,981,534
15000US060014305001,2860,714,1022,1838,535
15000US060014305002,1408,379,293,1115,536
15000US060014305003,1737,502,386,1351,537
15000US060014306001,1041,393,408,633,538
15000US060014306002,1013,519,180,833,539
15000US060014306003,3042,1236,125,2917,540
15000US060014306004,935,446,220,715,541
15000US060014307001,805,615,113,692,542
15000US060014307002,1702,880,168,1534,543
15000US060014307003,1559,943,382,1177,544
15000US060014308001,713,291,283,430,545
15000US060014308002,1097,678,230,867,546
15000US060014308003,2225,1098,563,1662,547
15000US060014308004,2091,642,518,1573,548
15000US060014309001,1913,963,412,1501,549
15000US060014309002,3027,1187,763,2264,550
15000US060014310001,1067,419,330,737,551
15000US060014310002,1775,593,539,1236,552
15000US060014311001,1301,547,409,892,553
15000US060014311002,2096,703,713,1383,554
15000US060014312001,1096,659,90,1006,555
15000US060014312002,2593,701,808,1785,556
15000US060014312003,2074,1153,314,1760,557
15000US060014321001,1556,528,436,1120,558
15000US060014321002,1145,316,138,1007,559
15000US060014321003,982,619,125,857,560
15000US060014322001,921,300,335,586,561
15000US060014322002,938,273,285,653,562
15000US060014322003,2376,902,582,1794,563
15000US060014323001,1324,361,676,648,564
15000US060014323002,1045,196,620,425,565
15000US060014323003,2328,374,640,1688,566
15000US060014324001,1856,335,646,1210,567
15000US060014324002,2130,482,853,1277,568
15000US060014324003,2228,573,598,1630,569
15000US060014325011,1429,155,407,1022,570
15000US060014325012,948,261,241,707,571
15000US060014325013,2383,468,615,1768,572
15000US060014325021,2436,261,495,1941,573
15000US060014325022,1168,269,405,763,574
15000US060014325023,1293,138,540,753,575
15000US060014326001,863,205,250,613,576
15000US060014326002,1176,204,528,648,577
15000US060014326003,1172,313,483,689,578
15000US060014326004,782,419,156,626,579
15000US060014326005,3363,547,1015,2348,580
15000US060014327001,1067,612,218,849,581
15000US060014327002,883,256,431,452,582
15000US060014327003,920,413,181,739,583
15000US060014328001,667,394,79,588,584
15000US060014328002,1616,706,131,1485,585
15000US060014328003,1251,281,408,843,586
15000US060014330001,932,439,150,782,587
15000US060014330002,913,415,64,849,588
15000US060014330003,924,119,628,296,589
15000US060014330004,948,370,100,848,590
15000US060014331021,1872,196,875,997,591
15000US060014331022,2216,423,620,1596,592
15000US060014331031,2638,297,940,1698,593
15000US060014331032,1099,116,332,767,594
15000US060014331041,859,305,249,610,595
15000US060014331042,1089,124,319,770,596
15000US060014331043,2131,775,720,1411,597
15000US060014332001,1707,335,487,1220,598
15000US060014332002,2365,669,439,1926,599
15000US060014332003,1945,148,536,1409,600
15000US060014332004,1512,117,194,1318,601
15000US060014333001,1425,422,348,1077,602
15000US060014333002,827,187,113,714,603
15000US060014333003,2043,388,475,1568,604
15000US060014333004,1678,226,347,1331,605
15000US060014333005,1529,555,525,1004,606
15000US060014334001,1001,111,241,760,607
15000US060014334002,470,124,83,387,608
15000US060014334003,657,146,275,382,609
15000US060014334004,1721,261,334,1387,610
15000US060014334005,1395,96,0,1395,611
15000US060014334006,1268,555,12,1256,612
15000US060014335001,827,257,298,529,613
15000US060014335002,1306,187,509,797,614
15000US060014335003,1744,428,691,1053,615
15000US060014335004,1007,225,186,821,616
15000US060014336001,758,154,32,726,617
15000US060014336002,1923,321,362,1561,618
15000US060014336003,1479,587,213,1266,619
15000US060014336004,1501,212,437,1064,620
15000US060014337001,1205,272,628,577,621
15000US060014337002,1033,134,750,283,622
15000US060014337003,1043,130,467,576,623
15000US060014338001,900,58,327,573,624
15000US060014338002,2775,474,1409,1366,625
15000US060014338003,2249,490,357,1892,626
15000US060014338004,2637,355,819,1818,627
15000US060014339001,2093,105,721,1372,628
15000US060014339002,1469,110,677,792,629
15000US060014339003,1449,154,461,988,630
15000US060014339004,2569,139,1760,809,631
15000US060014340001,2479,422,1636,843,632
15000US060014340002,1197,162,584,613,633
15000US060014340003,1525,149,464,1061,634
15000US060014351021,2256,999,369,1887,635
15000US060014351022,3544,1190,758,2786,636
15000US060014351031,2938,1106,317,2621,637
15000US060014351032,2905,858,149,2756,638
15000US060014351033,856,103,142,714,639
15000US060014351041,1547,340,352,1195,640
15000US060014351042,3359,312,1383,1976,641
15000US060014351043,885,180,234,651,642
15000US060014352001,2195,515,745,1450,643
15000US060014352002,2360,718,327,2033,644
15000US060014353001,1489,473,475,1014,645
15000US060014353002,1761,500,729,1032,646
15000US060014353003,1217,292,39,1178,647
15000US060014354001,2015,498,895,1120,648
15000US060014354002,769,164,221,548,649
15000US060014354003,1636,282,593,1043,650
15000US060014355001,747,332,60,687,651
15000US060014355002,1712,399,938,774,652
15000US060014355003,1215,281,630,585,653
15000US060014356011,3880,376,2980,900,654
15000US060014356012,1921,204,1154,767,655
15000US060014356021,1781,460,1092,689,656
15000US060014356022,920,177,498,422,657
15000US060014356023,1599,398,719,880,658
15000US060014356024,1239,434,577,662,659
15000US060014357001,1131,147,640,491,660
15000US060014357002,1221,330,538,683,661
15000US060014357003,1195,374,580,615,662
15000US060014357004,1116,220,667,449,663
15000US060014358001,1122,310,460,662,664
15000US060014358002,1390,455,525,865,665
15000US060014358003,1404,367,693,711,666
15000US060014358004,1405,282,476,929,667
15000US060014359001,1720,711,355,1365,668
15000US060014359002,1712,553,480,1232,669
15000US060014359003,1209,371,417,792,670
15000US060014359004,870,172,322,548,671
15000US060014360001,1092,454,506,586,672
15000US060014360002,1995,831,492,1503,673
15000US060014360003,1282,447,536,746,674
15000US060014361001,1190,383,533,657,675
15000US060014361002,2756,603,906,1850,676
15000US060014361003,2111,372,787,1324,677
15000US060014362001,1686,64,1022,664,678
15000US060014362002,2683,532,1527,1156,679
15000US060014363001,1979,146,1360,619,680
15000US060014363002,2539,576,1121,1418,681
15000US060014363003,1358,152,794,564,682
15000US060014363004,2104,332,370,1734,683
15000US060014364011,1062,595,92,970,684
15000US060014364012,2292,768,774,1518,685
15000US060014364013,2466,531,1110,1356,686
15000US060014364014,1226,449,289,937,687
15000US060014364015,835,114,323,512,688
15000US060014364021,1777,777,574,1203,689
15000US060014364022,1098,583,141,957,690
15000US060014365001,1904,234,975,929,691
15000US060014365002,3051,653,1145,1906,692
15000US060014366011,1548,270,569,979,693
15000US060014366012,2844,355,1423,1421,694
15000US060014366013,2074,182,1495,579,695
15000US060014366021,3549,162,1757,1792,696
15000US060014366022,1685,222,548,1137,697
15000US060014367001,1303,187,445,858,698
15000US060014367002,1881,187,1048,833,699
15000US060014368001,2356,369,1277,1079,700
15000US060014368002,1878,310,535,1343,701
15000US060014369001,2545,215,2018,527,702
15000US060014369002,979,222,397,582,703
15000US060014369003,1076,201,560,516,704
15000US060014369004,1902,257,1179,723,705
15000US060014370001,1350,297,504,846,706
15000US060014370002,931,198,179,752,707
15000US060014370003,1166,237,509,657,708
15000US060014371011,3072,507,315,2757,709
15000US060014371012,2112,185,451,1661,710
15000US060014371013,1682,285,663,1019,711
15000US060014371021,1163,124,353,810,712
15000US060014371022,1805,226,607,1198,713
15000US060014371023,1490,214,532,958,714
15000US060014372001,2879,362,794,2085,715
15000US060014372002,1060,176,0,1060,716
15000US060014372003,1338,339,591,747,717
15000US060014372004,2355,505,472,1883,718
15000US060014373001,860,155,342,518,719
15000US060014373002,1654,194,481,1173,720
15000US060014373003,779,59,316,463,721
15000US060014374001,1032,162,517,515,722
15000US060014374002,2269,463,1238,1031,723
15000US060014375001,2320,101,1749,571,724
15000US060014375002,2370,441,1288,1082,725
15000US060014376001,2358,368,1037,1321,726
15000US060014376002,1306,154,606,700,727
15000US060014377011,683,51,497,186,728
15000US060014377012,2243,359,1212,1031,729
15000US060014377013,984,43,657,327,730
15000US060014377021,2797,66,2155,642,731
15000US060014377022,2083,138,1645,438,732
15000US060014378001,3572,592,1096,2476,733
15000US060014378002,857,89,522,335,734
15000US060014379001,1126,91,706,420,735
15000US060014379002,1273,83,762,511,736
15000US060014380001,2610,608,964,1646,737
15000US060014380002,1133,604,449,684,738
15000US060014381001,1919,180,368,1551,739
15000US060014381002,648,275,15,633,740
15000US060014381003,811,218,276,535,741
15000US060014381004,1736,359,555,1181,742
15000US060014381005,1256,98,913,343,743
15000US060014381006,1378,239,843,535,744
15000US060014382011,1735,83,1093,642,745
15000US060014382012,1832,313,882,950,746
15000US060014382013,1335,70,794,541,747
15000US060014382031,1771,535,310,1461,748
15000US060014382032,2558,134,703,1855,749
15000US060014382041,1989,200,772,1217,750
15000US060014382042,857,221,191,666,751
15000US060014382043,2415,524,463,1952,752
15000US060014383001,1576,108,639,937,753
15000US060014383002,1498,94,578,920,754
15000US060014383003,1028,60,343,685,755
15000US060014384001,1168,250,305,863,756
15000US060014384002,1341,201,525,816,757
15000US060014401001,2363,891,473,1890,758
15000US060014402001,1894,69,1593,301,759
15000US060014402002,1449,213,988,461,760
15000US060014402003,1671,63,1014,657,761
15000US060014402004,1251,96,815,436,762
15000US060014403011,2071,548,760,1311,763
15000US060014403012,1865,554,688,1177,764
15000US060014403013,1286,222,58,1228,765
15000US060014403014,1765,244,799,966,766
15000US060014403041,1324,72,187,1137,767
15000US060014403042,2194,173,405,1789,768
15000US060014403043,1446,135,209,1237,769
15000US060014403051,873,126,188,685,770
15000US060014403052,1212,203,203,1009,771
15000US060014403053,2062,280,330,1732,772
15000US060014403061,2752,293,237,2515,773
15000US060014403062,1379,224,65,1314,774
15000US060014403071,2438,654,583,1855,775
15000US060014403072,1018,172,166,852,776
15000US060014403073,821,148,103,718,777
15000US060014403081,1540,343,305,1235,778
15000US060014403082,1077,84,306,771,779
15000US060014403083,1703,203,598,1105,780
15000US060014403084,1668,314,520,1148,781
15000US060014403311,2046,285,534,1512,782
15000US060014403312,1471,154,157,1314,783
15000US060014403321,1309,123,53,1256,784
15000US060014403322,2207,229,77,2130,785
15000US060014403331,1678,287,40,1638,786
15000US060014403332,1314,139,145,1169,787
15000US060014403341,1827,488,238,1589,788
15000US060014403342,2533,323,306,2227,789
15000US060014403351,3281,622,0,3281,790
15000US060014403352,3668,526,624,3044,791
15000US060014403361,2541,329,398,2143,792
15000US060014403362,2809,500,559,2250,793
15000US060014411001,2199,1027,630,1569,794
15000US060014411002,1980,849,260,1720,795
15000US060014412001,2642,855,816,1826,796
15000US060014412002,1571,845,94,1477,797
15000US060014412003,3103,820,412,2691,798
15000US060014413011,900,189,48,852,799
15000US060014413012,2324,556,135,2189,800
15000US060014413021,1930,547,300,1630,801
15000US060014413022,1191,438,110,1081,802
15000US060014413023,995,279,52,943,803
15000US060014413024,1673,332,365,1308,804
15000US060014414011,1907,431,355,1552,805
15000US060014414012,1811,660,215,1596,806
15000US060014414013,914,250,29,885,807
15000US060014414014,2852,378,225,2627,808
15000US060014414021,2180,420,58,2122,809
15000US060014414022,2142,429,220,1922,810
15000US060014414023,973,347,153,820,811
15000US060014415011,3418,305,123,3295,812
15000US060014415012,3027,331,335,2692,813
15000US060014415031,4613,246,94,4519,814
15000US060014415032,1953,178,85,1868,815
15000US060014415211,2237,432,169,2068,816
15000US060014415212,1775,141,109,1666,817
15000US060014415213,1517,318,34,1483,818
15000US060014415214,648,135,72,576,819
15000US060014415221,1327,330,6,1321,820
15000US060014415222,2086,259,698,1388,821
15000US060014415223,1943,264,177,1766,822
15000US060014415231,1615,195,56,1559,823
15000US060014415232,1318,102,148,1170,824
15000US060014415233,1334,76,28,1306,825
15000US060014415241,2905,98,190,2715,826
15000US060014415242,1444,240,6,1438,827
15000US060014416011,671,181,80,591,828
15000US060014416012,2571,949,326,2245,829
15000US060014416013,1606,506,328,1278,830
15000US060014416021,2523,402,471,2052,831
15000US060014416022,1064,307,23,1041,832
15000US060014416023,3185,566,988,2197,833
15000US060014416024,1135,428,211,924,834
15000US060014417001,2054,559,339,1715,835
15000US060014417002,2365,417,232,2133,836
15000US060014417003,1016,135,665,351,837
15000US060014417004,1835,279,408,1427,838
15000US060014418001,2566,841,493,2073,839
15000US060014418002,1362,614,0,1362,840
15000US060014418003,2382,788,342,2040,841
15000US060014418004,995,599,40,955,842
15000US060014419211,1446,334,585,861,843
15000US060014419212,2471,368,435,2036,844
15000US060014419231,1559,489,231,1328,845
15000US060014419232,1608,203,47,1561,846
15000US060014419233,3146,600,272,2874,847
15000US060014419241,2956,305,621,2335,848
15000US060014419242,1305,331,174,1131,849
15000US060014419243,2199,977,236,1963,850
15000US060014419244,1322,522,0,1322,851
15000US060014419251,3624,476,391,3233,852
15000US060014419252,3070,855,56,3014,853
15000US060014419261,2456,351,876,1580,854
15000US060014419262,2157,186,863,1294,855
15000US060014419271,2584,277,401,2183,856
15000US060014419272,1944,337,72,1872,857
15000US060014420001,2014,576,29,1985,858
15000US060014420002,1314,124,10,1304,859
15000US060014421001,2284,245,46,2238,860
15000US060014421002,2958,565,137,2821,861
15000US060014422001,2015,257,149,1866,862
15000US060014422002,2298,451,110,2188,863
15000US060014422003,1523,328,49,1474,864
15000US060014422004,1405,398,78,1327,865
15000US060014423011,1575,286,235,1340,866
15000US060014423012,996,307,236,760,867
15000US060014423013,2307,437,243,2064,868
15000US060014423021,1843,444,88,1755,869
15000US060014423022,2114,221,281,1833,870
15000US060014423023,1815,390,389,1426,871
15000US060014424001,1224,309,519,705,872
15000US060014424002,1984,371,703,1281,873
15000US060014424003,1438,304,308,1130,874
15000US060014424004,1829,513,395,1434,875
15000US060014425001,2013,387,406,1607,876
15000US060014425002,1637,493,284,1353,877
15000US060014425003,2263,583,700,1563,878
15000US060014425004,1628,217,314,1314,879
15000US060014426011,1602,602,393,1209,880
15000US060014426012,2410,788,522,1888,881
15000US060014426021,2464,684,630,1834,882
15000US060014426022,2587,1065,311,2276,883
15000US060014427001,1409,694,347,1062,884
15000US060014427002,1103,211,118,985,885
15000US060014427003,715,305,163,552,886
15000US060014428001,3051,1116,472,2579,887
15000US060014429001,2214,716,681,1533,888
15000US060014429002,1397,545,107,1290,889
15000US060014429003,3176,1177,661,2515,890
15000US060014429004,1282,79,0,1282,891
15000US060014430011,2906,686,895,2011,892
15000US060014430021,1431,267,726,705,893
15000US060014430022,2485,691,217,2268,894
15000US060014430023,2673,584,450,2223,895
15000US060014431021,1248,242,61,1187,896
15000US060014431022,922,152,65,857,897
15000US060014431023,1312,181,10,1302,898
15000US060014431024,1304,249,130,1174,899
15000US060014431031,1194,205,53,1141,900
15000US060014431032,2840,126,0,2840,901
15000US060014431041,1643,292,85,1558,902
15000US060014431042,1368,154,123,1245,903
15000US060014431043,2470,550,80,2390,904
15000US060014431051,1945,235,0,1945,905
15000US060014431052,2608,409,0,2608,906
15000US060014432001,2696,514,53,2643,907
15000US060014432002,1106,183,41,1065,908
15000US060014433011,1105,246,14,1091,909
15000US060014433012,3068,762,281,2787,910
15000US060014433211,786,112,46,740,911
15000US060014433212,2554,283,182,2372,912
15000US060014433221,1728,339,17,1711,913
15000US060014433222,1476,389,118,1358,914
15000US060014441001,3648,1328,1216,2432,915
15000US060014441002,1165,680,209,956,916
15000US060014441003,1593,434,590,1003,917
15000US060014441004,1149,590,232,917,918
15000US060014442001,1408,328,723,685,919
15000US060014442002,2662,775,828,1834,920
15000US060014442003,2670,528,932,1738,921
15000US060014443011,2067,780,543,1524,922
15000US060014443012,2110,596,786,1324,923
15000US060014443021,1978,306,1354,624,924
15000US060014443022,2560,468,952,1608,925
15000US060014444001,1343,287,613,730,926
15000US060014444002,2180,360,1111,1069,927
15000US060014444003,1534,304,725,809,928
15000US060014445001,1015,264,401,614,929
15000US060014445002,1883,282,235,1648,930
15000US060014445003,1518,376,644,874,931
15000US060014445004,2434,506,1154,1280,932
15000US060014446011,2949,1067,648,2301,933
15000US060014446012,2448,647,821,1627,934
15000US060014446021,2971,675,354,2617,935
15000US060014446022,1392,219,143,1249,936
15000US060014501011,4781,1444,261,4520,937
15000US060014501021,1559,460,828,731,938
15000US060014501022,1842,242,430,1412,939
15000US060014501023,3669,890,226,3443,940
15000US060014502001,1690,975,204,1486,941
15000US060014502002,2389,953,267,2122,942
15000US060014502003,1824,826,109,1715,943
15000US060014503001,2388,1259,293,2095,944
15000US060014503002,2693,1583,431,2262,945
15000US060014504001,2137,1764,85,2052,946
15000US060014504002,1079,703,120,959,947
15000US060014504003,2948,1372,302,2646,948
15000US060014505011,678,481,118,560,949
15000US060014505012,2748,1504,354,2394,950
15000US060014505021,2419,1674,304,2115,951
15000US060014505022,3041,1635,135,2906,952
15000US060014506011,601,499,25,576,953
15000US060014506012,3064,1618,205,2859,954
15000US060014506021,1013,381,260,753,955
15000US060014506022,1719,915,63,1656,956
15000US060014506023,2558,1738,133,2425,957
15000US060014506024,803,457,118,685,958
15000US060014506025,3680,2059,312,3368,959
15000US060014506031,1130,691,214,916,960
15000US060014506032,677,384,0,677,961
15000US060014506033,1501,955,53,1448,962
15000US060014506034,1746,1050,212,1534,963
15000US060014506041,1288,858,71,1217,964
15000US060014506042,2496,1496,324,2172,965
15000US060014506043,933,758,45,888,966
15000US060014506044,680,457,101,579,967
15000US060014506051,1908,944,186,1722,968
15000US060014506052,971,711,96,875,969
15000US060014506053,1125,818,156,969,970
15000US060014506061,2283,1100,167,2116,971
15000US060014506062,1506,942,59,1447,972
15000US060014506063,2303,1719,143,2160,973
15000US060014506071,3525,1524,375,3150,974
15000US060014506072,1714,1268,266,1448,975
15000US060014507011,1684,760,93,1591,976
15000US060014507012,880,702,52,828,977
15000US060014507013,3672,2321,400,3272,978
15000US060014507014,2504,1265,42,2462,979
15000US060014507411,1780,493,800,980,980
15000US060014507412,1533,1101,170,1363,981
15000US060014507413,1867,1285,185,1682,982
15000US060014507421,1896,1159,241,1655,983
15000US060014507422,1306,1051,32,1274,984
15000US060014507423,1609,790,231,1378,985
15000US060014507431,2099,570,0,2099,986
15000US060014507432,4013,1098,481,3532,987
15000US060014507441,3325,1982,463,2862,988
15000US060014507442,2031,1112,93,1938,989
15000US060014507451,3470,983,298,3172,990
15000US060014507452,2768,1294,119,2649,991
15000US060014507461,2667,1655,215,2452,992
15000US060014507462,832,487,231,601,993
15000US060014507501,4511,1988,618,3893,994
15000US060014507511,7253,1663,234,7019,995
15000US060014507521,5692,1376,480,5212,996
15000US060014511011,2442,1714,66,2376,997
15000US060014511012,2418,1365,597,1821,998
15000US060014511013,989,811,78,911,999
15000US060014511014,0,0,0,0,1000
15000US060014511015,1564,917,220,1344,1001
15000US060014511021,1078,938,68,1010,1002
15000US060014511022,3033,2198,235,2798,1003
15000US060014512011,3162,1908,521,2641,1004
15000US060014512012,2518,1394,706,1812,1005
15000US060014512013,1454,697,430,1024,1006
15000US060014512021,2312,1246,490,1822,1007
15000US060014512022,1046,806,125,921,1008
15000US060014512023,938,570,323,615,1009
15000US060014513001,3047,1806,663,2384,1010
15000US060014513002,1728,887,568,1160,1011
15000US060014513003,2314,1790,172,2142,1012
15000US060014514011,1551,918,445,1106,1013
15000US060014514012,2545,2008,218,2327,1014
15000US060014514013,2053,1339,392,1661,1015
15000US060014514031,963,516,340,623,1016
15000US060014514032,1380,874,242,1138,1017
15000US060014514041,1622,861,438,1184,1018
15000US060014514042,1535,556,862,673,1019
15000US060014514043,3161,1132,1709,1452,1020
15000US060014515011,1876,1044,541,1335,1021
15000US060014515012,2883,2294,192,2691,1022
15000US060014515031,3062,2263,271,2791,1023
15000US060014515032,1347,769,517,830,1024
15000US060014515033,531,491,0,531,1025
15000US060014515034,972,320,584,388,1026
15000US060014515041,1723,1064,309,1414,1027
15000US060014515051,1149,929,72,1077,1028
15000US060014515052,2140,1732,350,1790,1029
15000US060014515061,2403,1029,796,1607,1030
15000US060014515062,1104,286,726,378,1031
15000US060014516011,1873,1564,143,1730,1032
15000US060014516012,3284,2422,278,3006,1033
15000US060014516021,2545,1746,513,2032,1034
15000US060014516022,1001,660,320,681,1035
15000US060014516023,2000,1642,150,1850,1036
15000US060014516024,1573,903,283,1290,1037
15000US060014517011,764,594,100,664,1038
15000US060014517012,1627,1134,254,1373,1039
15000US060014517013,622,413,96,526,1040
15000US060014517031,1817,1159,474,1343,1041
15000US060014517032,2751,1744,267,2484,1042
15000US060014517041,1591,1082,349,1242,1043
15000US060014517042,2113,1746,191,1922,1044
15000US060014517043,943,652,226,717,1045
15000US060019819001,53,53,0,53,1046
15000US060019820001,58,36,15,43,1047
15000US060019832001,572,235,90,482,1048
15000US060019900000,0,0,0,0,1049
15000US060030100001,431,384,34,397,1050
15000US060030100002,753,420,58,695,1051
15000US060050001011,1151,1031,53,1098,1052
15000US060050001012,1124,1067,20,1104,1053
15000US060050001013,985,777,124,861,1054
15000US060050001014,763,651,51,712,1055
15000US060050001021,799,656,87,712,1056
15000US060050001022,944,749,158,786,1057
15000US060050002001,1039,887,106,933,1058
15000US060050002002,1332,975,166,1166,1059
15000US060050002003,698,646,52,646,1060
15000US060050002004,682,610,26,656,1061
15000US060050002005,680,493,171,509,1062
15000US060050003011,790,684,86,704,1063
15000US060050003012,4394,1951,1382,3012,1064
15000US060050003031,1870,1501,231,1639,1065
15000US060050003032,2965,2611,270,2695,1066
15000US060050003041,1921,1563,313,1608,1067
15000US060050003042,2258,1830,272,1986,1068
15000US060050004011,1468,1237,180,1288,1069
15000US060050004012,804,583,135,669,1070
15000US060050004013,1543,1410,106,1437,1071
15000US060050004014,826,782,44,782,1072
15000US060050004021,1897,1714,158,1739,1073
15000US060050004022,1176,815,326,850,1074
15000US060050004023,991,804,54,937,1075
15000US060050004024,700,557,125,575,1076
15000US060050005001,1434,1240,69,1365,1077
15000US060050005002,665,619,38,627,1078
15000US060050005003,1064,993,19,1045,1079
15000US060070001021,1696,1409,213,1483,1080
15000US060070001022,1596,1140,305,1291,1081
15000US060070001023,853,761,66,787,1082
15000US060070001031,3973,3019,594,3379,1083
15000US060070001041,1639,1232,281,1358,1084
15000US060070001042,3246,2146,656,2590,1085
15000US060070001043,711,641,43,668,1086
15000US060070002011,890,630,204,686,1087
15000US060070002012,993,793,149,844,1088
15000US060070002013,758,664,90,668,1089
15000US060070002014,1865,1413,417,1448,1090
15000US060070002021,1330,996,95,1235,1091
15000US060070002022,788,608,128,660,1092
15000US060070002023,675,568,37,638,1093
15000US060070002024,895,627,40,855,1094
15000US060070003001,810,622,146,664,1095
15000US060070003002,2347,1532,659,1688,1096
15000US060070003003,590,511,19,571,1097
15000US060070003004,993,727,103,890,1098
15000US060070004011,3051,1996,759,2292,1099
15000US060070004021,2667,2446,167,2500,1100
15000US060070004022,2396,1651,376,2020,1101
15000US060070004023,1147,929,160,987,1102
15000US060070004024,1422,1064,251,1171,1103
15000US060070005011,839,800,21,818,1104
15000US060070005012,902,736,70,832,1105
15000US060070005013,758,583,63,695,1106
15000US060070005014,1412,603,570,842,1107
15000US060070005021,616,523,57,559,1108
15000US060070005022,1154,627,320,834,1109
15000US060070005023,1425,941,205,1220,1110
15000US060070005024,1076,514,379,697,1111
15000US060070006011,1087,902,126,961,1112
15000US060070006012,813,730,57,756,1113
15000US060070006013,1464,1174,180,1284,1114
15000US060070006031,375,336,27,348,1115
15000US060070006032,1045,809,176,869,1116
15000US060070006033,1116,819,209,907,1117
15000US060070006034,1013,737,164,849,1118
15000US060070006041,1157,717,230,927,1119
15000US060070006042,1089,625,205,884,1120
15000US060070006043,571,356,120,451,1121
15000US060070006044,626,405,124,502,1122
15000US060070006045,1379,907,274,1105,1123
15000US060070007001,1092,938,55,1037,1124
15000US060070007002,1429,1239,147,1282,1125
15000US060070007003,1229,1158,38,1191,1126
15000US060070007004,941,845,26,915,1127
15000US060070008001,974,835,121,853,1128
15000US060070008002,718,628,65,653,1129
15000US060070008003,1316,805,239,1077,1130
15000US060070008004,1466,1216,212,1254,1131
15000US060070008005,958,675,148,810,1132
15000US060070008006,188,166,22,166,1133
15000US060070009011,2413,1950,328,2085,1134
15000US060070009031,1234,707,374,860,1135
15000US060070009032,1159,716,271,888,1136
15000US060070009033,2897,2091,326,2571,1137
15000US060070009034,1809,985,388,1421,1138
15000US060070009041,2703,2440,83,2620,1139
15000US060070009042,2746,2333,160,2586,1140
15000US060070009043,1009,505,265,744,1141
15000US060070010001,620,419,150,470,1142
15000US060070010002,802,736,53,749,1143
15000US060070010003,804,531,177,627,1144
15000US060070010004,487,373,101,386,1145
15000US060070010005,636,446,127,509,1146
15000US060070010006,874,712,162,712,1147
15000US060070011001,398,240,78,320,1148
15000US060070011002,1466,1183,199,1267,1149
15000US060070011003,1038,725,123,915,1150
15000US060070011004,790,412,154,636,1151
15000US060070011005,392,219,51,341,1152
15000US060070012001,821,692,111,710,1153
15000US060070012002,823,572,122,701,1154
15000US060070012003,857,711,101,756,1155
15000US060070012004,665,437,188,477,1156
15000US060070013001,1405,619,609,796,1157
15000US060070013002,1051,581,211,840,1158
15000US060070013003,946,386,362,584,1159
15000US060070013004,634,412,108,526,1160
15000US060070014001,2167,1656,455,1712,1161
15000US060070014002,1188,1066,122,1066,1162
15000US060070014003,1011,602,329,682,1163
15000US060070014004,1134,985,124,1010,1164
15000US060070015001,1250,1089,161,1089,1165
15000US060070015002,1360,1325,35,1325,1166
15000US060070015003,1746,1511,206,1540,1167
15000US060070015004,912,684,202,710,1168
15000US060070015005,278,166,0,278,1169
15000US060070016001,1407,1320,48,1359,1170
15000US060070016002,888,738,75,813,1171
15000US060070016003,998,848,17,981,1172
15000US060070016004,1420,993,333,1087,1173
15000US060070017021,666,646,0,666,1174
15000US060070017022,1286,1059,71,1215,1175
15000US060070017023,2983,2624,167,2816,1176
15000US060070017024,916,742,108,808,1177
15000US060070017031,911,751,44,867,1178
15000US060070017032,1964,1852,79,1885,1179
15000US060070017041,472,444,28,444,1180
15000US060070017042,1209,1001,183,1026,1181
15000US060070017043,1520,1272,206,1314,1182
15000US060070018001,1514,1217,178,1336,1183
15000US060070018002,891,810,35,856,1184
15000US060070018003,1194,1132,62,1132,1185
15000US060070018004,899,633,140,759,1186
15000US060070018005,1110,1027,0,1110,1187
15000US060070019001,487,430,15,472,1188
15000US060070019002,1068,867,137,931,1189
15000US060070019003,800,708,56,744,1190
15000US060070019004,901,830,27,874,1191
15000US060070020001,1139,1066,73,1066,1192
15000US060070020002,648,614,34,614,1193
15000US060070020003,516,341,83,433,1194
15000US060070020004,814,627,62,752,1195
15000US060070020005,1794,1589,27,1767,1196
15000US060070020006,772,631,80,692,1197
15000US060070021001,1160,1013,48,1112,1198
15000US060070021002,686,500,169,517,1199
15000US060070021003,439,422,0,439,1200
15000US060070021004,1479,1463,16,1463,1201
15000US060070021005,781,695,33,748,1202
15000US060070022001,1611,1459,59,1552,1203
15000US060070022002,1961,1821,92,1869,1204
15000US060070022003,667,491,96,571,1205
15000US060070022004,930,766,69,861,1206
15000US060070023001,1140,1032,80,1060,1207
15000US060070023002,578,491,87,491,1208
15000US060070023003,954,788,60,894,1209
15000US060070023004,1631,1380,209,1422,1210
15000US060070023005,818,735,48,770,1211
15000US060070024001,943,654,165,778,1212
15000US060070024002,960,861,56,904,1213
15000US060070024003,1307,1103,108,1199,1214
15000US060070024004,976,843,66,910,1215
15000US060070024005,765,539,189,576,1216
15000US060070025001,822,438,87,735,1217
15000US060070025002,1520,1052,195,1325,1218
15000US060070025003,1766,1051,338,1428,1219
15000US060070025004,1284,951,61,1223,1220
15000US060070026011,674,499,61,613,1221
15000US060070026012,643,563,10,633,1222
15000US060070026013,877,639,107,770,1223
15000US060070026021,1142,959,106,1036,1224
15000US060070026022,1502,1277,37,1465,1225
15000US060070026023,841,771,66,775,1226
15000US060070027001,777,645,25,752,1227
15000US060070027002,1214,971,16,1198,1228
15000US060070027003,541,431,31,510,1229
15000US060070027004,467,316,122,345,1230
15000US060070027005,1536,835,165,1371,1231
15000US060070027006,1245,931,243,1002,1232
15000US060070028001,914,544,237,677,1233
15000US060070028002,758,421,71,687,1234
15000US060070028003,1095,693,106,989,1235
15000US060070028004,235,215,20,215,1236
15000US060070028005,863,484,177,686,1237
15000US060070029001,1438,894,48,1390,1238
15000US060070029002,1780,727,222,1558,1239
15000US060070030011,1080,762,186,894,1240
15000US060070030012,610,317,16,594,1241
15000US060070030013,780,422,19,761,1242
15000US060070030014,759,309,157,602,1243
15000US060070030021,850,514,284,566,1244
15000US060070030022,721,529,114,607,1245
15000US060070030023,941,423,163,778,1246
15000US060070030024,1032,358,449,583,1247
15000US060070031001,1286,1100,62,1224,1248
15000US060070031002,844,531,128,716,1249
15000US060070031003,1070,539,194,876,1250
15000US060070031004,1061,620,87,974,1251
15000US060070032001,826,485,238,588,1252
15000US060070032002,1923,1200,494,1429,1253
15000US060070032003,1591,728,739,852,1254
15000US060070033001,1821,1441,192,1629,1255
15000US060070033002,788,667,23,765,1256
15000US060070033003,1908,923,451,1457,1257
15000US060070034001,1311,640,525,786,1258
15000US060070034002,1655,940,606,1049,1259
15000US060070035011,734,535,97,637,1260
15000US060070035012,1024,511,499,525,1261
15000US060070035013,830,436,354,476,1262
15000US060070035014,728,435,178,550,1263
15000US060070035021,843,544,252,591,1264
15000US060070035022,1427,606,787,640,1265
15000US060070035023,1108,471,570,538,1266
15000US060070035024,1306,529,727,579,1267
15000US060070036001,1010,500,437,573,1268
15000US060070036002,1203,540,524,679,1269
15000US060070036003,1259,1008,164,1095,1270
15000US060070037001,1452,968,130,1322,1271
15000US060070037002,1068,745,218,850,1272
15000US060070037003,1097,611,122,975,1273
15000US060070037004,940,645,124,816,1274
15000US060090001201,4944,4265,538,4406,1275
15000US060090001211,2291,1970,240,2051,1276
15000US060090001212,2109,1768,264,1845,1277
15000US060090001221,1880,1732,127,1753,1278
15000US060090001222,470,392,49,421,1279
15000US060090001223,1246,946,240,1006,1280
15000US060090002101,3247,2909,215,3032,1281
15000US060090002102,1938,1353,242,1696,1282
15000US060090002103,2243,1857,258,1985,1283
15000US060090002104,2738,1998,722,2016,1284
15000US060090002201,2085,1246,554,1531,1285
15000US060090002202,4446,3518,410,4036,1286
15000US060090003001,1206,916,200,1006,1287
15000US060090003002,1473,1354,49,1424,1288
15000US060090003003,1758,1178,40,1718,1289
15000US060090003004,1318,1195,77,1241,1290
15000US060090003005,749,489,211,538,1291
15000US060090004001,477,449,11,466,1292
15000US060090004002,633,563,70,563,1293
15000US060090004003,807,725,13,794,1294
15000US060090004004,460,348,61,399,1295
15000US060090004005,565,506,32,533,1296
15000US060090004006,323,323,0,323,1297
15000US060090005011,925,806,119,806,1298
15000US060090005012,2515,2262,239,2276,1299
15000US060090005031,336,336,0,336,1300
15000US060090005032,875,835,0,875,1301
15000US060090005033,312,235,43,269,1302
15000US060090005041,266,245,2,264,1303
15000US060090005042,152,138,2,150,1304
15000US060110001001,630,198,423,207,1305
15000US060110001002,713,494,192,521,1306
15000US060110001003,2494,366,2128,366,1307
15000US060110001004,1338,526,744,594,1308
15000US060110002001,1197,448,706,491,1309
15000US060110002002,826,402,318,508,1310
15000US060110002003,1515,301,1111,404,1311
15000US060110002004,881,553,311,570,1312
15000US060110002005,498,224,204,294,1313
15000US060110003001,669,436,136,533,1314
15000US060110003002,1821,195,1478,343,1315
15000US060110003003,1699,250,1449,250,1316
15000US060110003004,2037,730,1219,818,1317
15000US060110004001,781,492,255,526,1318
15000US060110004002,815,542,273,542,1319
15000US060110004003,750,536,54,696,1320
15000US060110005001,515,184,322,193,1321
15000US060110005002,739,203,469,270,1322
15000US060110005003,915,622,289,626,1323
15000US060110005004,528,179,270,258,1324
15000US060133010001,1202,904,220,982,1325
15000US060133010002,997,784,175,822,1326
15000US060133010003,2645,1366,685,1960,1327
15000US060133020051,1359,974,21,1338,1328
15000US060133020052,2207,985,855,1352,1329
15000US060133020053,1521,812,649,872,1330
15000US060133020054,1608,641,846,762,1331
15000US060133020061,1423,731,531,892,1332
15000US060133020062,2678,1213,1040,1638,1333
15000US060133020071,3973,1734,1246,2727,1334
15000US060133020072,2867,956,1455,1412,1335
15000US060133020081,2775,1232,668,2107,1336
15000US060133020082,5577,1475,2464,3113,1337
15000US060133020091,3045,687,570,2475,1338
15000US060133020092,4092,969,1550,2542,1339
15000US060133020101,3756,1662,1485,2271,1340
15000US060133020102,1977,978,880,1097,1341
15000US060133020103,1466,932,305,1161,1342
15000US060133020104,3962,1940,796,3166,1343
15000US060133031021,5813,2689,1541,4272,1344
15000US060133031022,3088,1030,1404,1684,1345
15000US060133031031,2360,1233,808,1552,1346
15000US060133031032,2962,795,1504,1458,1347
15000US060133031033,2340,972,918,1422,1348
15000US060133031034,4217,2398,1002,3215,1349
15000US060133032011,3823,1153,959,2864,1350
15000US060133032012,3251,777,744,2507,1351
15000US060133032013,4381,2562,761,3620,1352
15000US060133032021,640,18,460,180,1353
15000US060133032022,2131,1690,331,1800,1354
15000US060133032023,1964,933,391,1573,1355
15000US060133032024,2402,1677,398,2004,1356
15000US060133032031,9445,4789,2115,7330,1357
15000US060133032041,1002,477,382,620,1358
15000US060133032042,1147,580,542,605,1359
15000US060133032043,2519,1415,529,1990,1360
15000US060133032051,3906,3074,587,3319,1361
15000US060133032052,4525,2645,1321,3204,1362
15000US060133040011,4375,2651,672,3703,1363
15000US060133040021,1465,892,540,925,1364
15000US060133040031,2212,1632,269,1943,1365
15000US060133040032,704,596,54,650,1366
15000US060133040033,976,719,179,797,1367
15000US060133040041,2725,2119,316,2409,1368
15000US060133040042,1087,834,158,929,1369
15000US060133040051,4946,2964,967,3979,1370
15000US060133040052,2685,1914,461,2224,1371
15000US060133050001,1594,261,1075,519,1372
15000US060133050002,966,291,274,692,1373
15000US060133050003,783,316,47,736,1374
15000US060133050004,1772,635,913,859,1375
15000US060133050005,1386,239,711,675,1376
15000US060133060021,1166,727,219,947,1377
15000US060133060022,1889,797,893,996,1378
15000US060133060031,1655,695,510,1145,1379
15000US060133060032,1957,631,1107,850,1380
15000US060133060033,1648,690,339,1309,1381
15000US060133060041,2094,729,698,1396,1382
15000US060133060042,1275,497,418,857,1383
15000US060133071011,2179,1078,899,1280,1384
15000US060133071012,1233,463,278,955,1385
15000US060133071013,1192,574,217,975,1386
15000US060133071021,781,246,505,276,1387
15000US060133071022,1263,227,929,334,1388
15000US060133071023,1471,299,927,544,1389
15000US060133071024,1813,465,1015,798,1390
15000US060133072011,1915,761,673,1242,1391
15000US060133072012,1455,294,800,655,1392
15000US060133072021,1661,248,504,1157,1393
15000US060133072022,706,130,342,364,1394
15000US060133072023,2002,318,814,1188,1395
15000US060133072041,1235,370,547,688,1396
15000US060133072042,866,402,410,456,1397
15000US060133072043,1859,680,879,980,1398
15000US060133072051,1153,160,289,864,1399
15000US060133072052,2530,403,780,1750,1400
15000US060133072053,1273,652,485,788,1401
15000US060133072054,1957,572,1061,896,1402
15000US060133080011,1680,947,635,1045,1403
15000US060133080012,2523,1133,862,1661,1404
15000US060133080013,1417,920,274,1143,1405
15000US060133080014,1256,858,217,1039,1406
15000US060133080021,3016,894,779,2237,1407
15000US060133080022,1414,515,252,1162,1408
15000US060133090001,2699,546,929,1770,1409
15000US060133090002,809,130,176,633,1410
15000US060133100001,1442,354,807,635,1411
15000US060133100002,1112,140,615,497,1412
15000US060133100003,3979,293,2500,1479,1413
15000US060133110001,1247,203,805,442,1414
15000US060133110002,1754,273,933,821,1415
15000US060133110003,2353,162,360,1993,1416
15000US060133120001,2373,209,1012,1361,1417
15000US060133131011,1464,404,555,909,1418
15000US060133131012,2007,457,1171,836,1419
15000US060133131013,2560,635,1100,1460,1420
15000US060133131014,1106,134,154,952,1421
15000US060133131021,2331,268,660,1671,1422
15000US060133131022,1684,663,662,1022,1423
15000US060133131031,5171,1385,827,4344,1424
15000US060133131032,1463,526,345,1118,1425
15000US060133131033,1594,335,1080,514,1426
15000US060133132031,1552,492,596,956,1427
15000US060133132032,691,186,409,282,1428
15000US060133132033,954,217,410,544,1429
15000US060133132041,2225,251,1567,658,1430
15000US060133132042,1565,658,346,1219,1431
15000US060133132043,1399,416,570,829,1432
15000US060133132051,1777,380,668,1109,1433
15000US060133132061,1571,156,642,929,1434
15000US060133132062,2746,51,1786,960,1435
15000US060133132063,1451,368,735,716,1436
15000US060133141021,1675,197,1053,622,1437
15000US060133141022,996,182,309,687,1438
15000US060133141023,2909,554,1780,1129,1439
15000US060133141031,2186,136,1248,938,1440
15000US060133141032,1624,279,808,816,1441
15000US060133141033,2344,166,1443,901,1442
15000US060133141041,1566,549,716,850,1443
15000US060133141042,3196,101,1894,1302,1444
15000US060133141043,1702,342,1163,539,1445
15000US060133141044,1353,103,1181,172,1446
15000US060133142001,2354,221,1838,516,1447
15000US060133142002,2441,546,1736,705,1448
15000US060133142003,2176,184,1667,509,1449
15000US060133150001,917,498,60,857,1450
15000US060133150002,2585,1073,719,1866,1451
15000US060133160001,964,681,210,754,1452
15000US060133170001,1173,869,209,964,1453
15000US060133170002,1252,891,59,1193,1454
15000US060133180001,960,777,142,818,1455
15000US060133180002,1290,969,183,1107,1456
15000US060133180003,1152,704,272,880,1457
15000US060133190001,1177,957,201,976,1458
15000US060133190002,1940,1202,440,1500,1459
15000US060133190003,1699,949,499,1200,1460
15000US060133190004,658,427,85,573,1461
15000US060133190005,799,533,258,541,1462
15000US060133190006,1887,1358,400,1487,1463
15000US060133200011,1644,821,705,939,1464
15000US060133200012,2603,1087,934,1669,1465
15000US060133200031,2825,1859,376,2449,1466
15000US060133200041,2992,2217,260,2732,1467
15000US060133200042,1781,712,648,1133,1468
15000US060133200043,1789,1313,239,1550,1469
15000US060133211011,2547,1658,555,1992,1470
15000US060133211012,1451,847,140,1311,1471
15000US060133211013,1923,1378,251,1672,1472
15000US060133211014,1404,841,296,1108,1473
15000US060133211021,1119,767,114,1005,1474
15000US060133211022,1876,1380,124,1752,1475
15000US060133211023,1439,1044,146,1293,1476
15000US060133211024,2393,1507,485,1908,1477
15000US060133211031,1837,1412,121,1716,1478
15000US060133211032,1831,1258,375,1456,1479
15000US060133211033,657,602,37,620,1480
15000US060133212001,1316,908,155,1161,1481
15000US060133212002,2642,1543,325,2317,1482
15000US060133212003,1502,511,166,1336,1483
15000US060133220001,1071,341,580,491,1484
15000US060133220002,647,568,44,603,1485
15000US060133220003,2250,1489,325,1925,1486
15000US060133220004,1546,857,190,1356,1487
15000US060133220005,595,444,28,567,1488
15000US060133230001,1270,881,301,969,1489
15000US060133230002,1020,818,142,878,1490
15000US060133230003,1422,985,71,1351,1491
15000US060133230004,978,719,145,833,1492
15000US060133240011,626,423,60,566,1493
15000US060133240012,2047,1296,242,1805,1494
15000US060133240013,2166,1087,302,1864,1495
15000US060133240014,621,430,0,621,1496
15000US060133240021,1929,1237,160,1769,1497
15000US060133240022,1418,929,185,1233,1498
15000US060133240023,2016,1014,536,1480,1499
15000US060133250001,1413,884,231,1182,1500
15000US060133250002,771,584,89,682,1501
15000US060133250003,1574,1275,192,1382,1502
15000US060133250004,1101,910,118,983,1503
15000US060133250005,877,672,196,681,1504
15000US060133260001,2383,1965,196,2187,1505
15000US060133260002,1104,877,49,1055,1506
15000US060133270001,2131,1193,615,1516,1507
15000US060133270002,513,331,182,331,1508
15000US060133270003,2091,715,1153,938,1509
15000US060133270004,1200,552,428,772,1510
15000US060133270005,1803,829,724,1079,1511
15000US060133280001,1090,502,269,821,1512
15000US060133280002,1433,643,281,1152,1513
15000US060133290001,1342,724,548,794,1514
15000US060133290002,1707,940,409,1298,1515
15000US060133290003,1286,557,440,846,1516
15000US060133290004,2352,1172,1002,1350,1517
15000US060133300001,993,503,111,882,1518
15000US060133300002,2306,1201,572,1734,1519
15000US060133300003,890,489,245,645,1520
15000US060133300004,1545,760,584,961,1521
15000US060133310001,870,569,80,790,1522
15000US060133310002,1371,929,190,1181,1523
15000US060133310003,1479,335,749,730,1524
15000US060133310004,889,502,51,838,1525
15000US060133310005,1536,896,342,1194,1526
15000US060133310006,1431,629,475,956,1527
15000US060133320001,1937,1329,329,1608,1528
15000US060133320002,686,430,161,525,1529
15000US060133320003,1653,833,569,1084,1530
15000US060133320004,1389,940,144,1245,1531
15000US060133320005,976,566,376,600,1532
15000US060133320006,1002,438,475,527,1533
15000US060133320007,700,422,180,520,1534
15000US060133331011,685,590,65,620,1535
15000US060133331012,2131,954,594,1537,1536
15000US060133331013,1544,939,305,1239,1537
15000US060133331021,1348,1031,151,1197,1538
15000US060133331022,979,762,144,835,1539
15000US060133331023,1640,653,349,1291,1540
15000US060133332001,471,361,92,379,1541
15000US060133332002,1021,831,15,1006,1542
15000US060133332003,1317,852,333,984,1543
15000US060133332004,1044,720,139,905,1544
15000US060133332005,1529,907,558,971,1545
15000US060133340011,1773,1249,251,1522,1546
15000US060133340012,2077,1207,369,1708,1547
15000US060133340041,1737,1100,360,1377,1548
15000US060133340042,2005,1148,296,1709,1549
15000US060133340043,2507,1122,493,2014,1550
15000US060133340044,1247,780,135,1112,1551
15000US060133340061,853,606,38,815,1552
15000US060133340062,2622,1361,298,2324,1553
15000US060133340063,1340,819,198,1142,1554
15000US060133342001,1701,1359,98,1603,1555
15000US060133342002,1687,957,470,1217,1556
15000US060133342003,2684,2311,58,2626,1557
15000US060133342004,1017,414,102,915,1558
15000US060133342005,923,760,0,923,1559
15000US060133350001,1479,722,608,871,1560
15000US060133350002,1343,710,175,1168,1561
15000US060133350003,620,216,263,357,1562
15000US060133361011,1646,275,706,940,1563
15000US060133361012,2055,389,1222,833,1564
15000US060133361013,1623,204,1139,484,1565
15000US060133361021,1890,359,896,994,1566
15000US060133361022,2017,318,1192,825,1567
15000US060133361023,1612,218,1213,399,1568
15000US060133361024,2132,364,1192,940,1569
15000US060133362011,1702,496,830,872,1570
15000US060133362012,1401,299,868,533,1571
15000US060133362013,824,151,538,286,1572
15000US060133362021,3081,731,2031,1050,1573
15000US060133362022,1014,49,953,61,1574
15000US060133362023,1959,273,1350,609,1575
15000US060133371001,1796,1209,212,1584,1576
15000US060133371002,1755,945,444,1311,1577
15000US060133372001,649,270,256,393,1578
15000US060133372002,2363,861,948,1415,1579
15000US060133372003,1321,645,388,933,1580
15000US060133372004,602,419,114,488,1581
15000US060133372005,1638,799,416,1222,1582
15000US060133372006,1533,1006,281,1252,1583
15000US060133373001,964,825,87,877,1584
15000US060133373002,1425,1029,213,1212,1585
15000US060133373003,796,535,207,589,1586
15000US060133373004,632,478,12,620,1587
15000US060133373005,742,385,117,625,1588
15000US060133373006,1345,1116,88,1257,1589
15000US060133381011,1101,419,579,522,1590
15000US060133381012,690,415,135,555,1591
15000US060133381013,2991,826,1330,1661,1592
15000US060133381021,1209,851,105,1104,1593
15000US060133381022,514,208,134,380,1594
15000US060133381023,1893,1263,343,1550,1595
15000US060133382011,2171,1588,208,1963,1596
15000US060133382012,1529,1054,100,1429,1597
15000US060133382031,1955,1173,63,1892,1598
15000US060133382032,2360,1525,179,2181,1599
15000US060133382033,874,690,101,773,1600
15000US060133382041,1925,1461,51,1874,1601
15000US060133382042,1044,694,129,915,1602
15000US060133382043,1231,906,156,1075,1603
15000US060133382044,2013,1379,83,1930,1604
15000US060133383011,1741,1244,118,1623,1605
15000US060133383012,1163,790,228,935,1606
15000US060133383021,2178,1918,35,2143,1607
15000US060133383022,1598,951,398,1200,1608
15000US060133383023,2436,1646,56,2380,1609
15000US060133390011,1663,1075,147,1516,1610
15000US060133390012,1580,832,516,1064,1611
15000US060133390021,1639,812,189,1450,1612
15000US060133390022,1844,1246,122,1722,1613
15000US060133390023,2521,1353,390,2131,1614
15000US060133390024,962,564,32,930,1615
15000US060133400011,640,592,13,627,1616
15000US060133400012,2081,1485,93,1988,1617
15000US060133400013,1587,1250,142,1445,1618
15000US060133400014,1608,1184,78,1530,1619
15000US060133400021,823,614,18,805,1620
15000US060133400022,732,512,127,605,1621
15000US060133400023,1883,1381,242,1641,1622
15000US060133400024,1856,1407,71,1785,1623
15000US060133400025,585,530,14,571,1624
15000US060133400026,1599,1101,163,1436,1625
15000US060133410001,1392,1139,134,1258,1626
15000US060133410002,1572,1087,182,1390,1627
15000US060133410003,2579,2097,33,2546,1628
15000US060133430011,724,646,32,692,1629
15000US060133430012,704,606,46,658,1630
15000US060133430013,1967,1415,247,1720,1631
15000US060133430014,1408,1046,217,1191,1632
15000US060133430021,2147,1566,140,2007,1633
15000US060133430022,2665,1818,474,2191,1634
15000US060133430031,2236,1735,55,2181,1635
15000US060133430032,1670,1374,119,1551,1636
15000US060133451011,1084,668,93,991,1637
15000US060133451012,2002,1362,339,1663,1638
15000US060133451013,859,488,323,536,1639
15000US060133451014,1849,768,242,1607,1640
15000US060133451021,1093,713,167,926,1641
15000US060133451022,1770,1111,234,1536,1642
15000US060133451023,835,512,84,751,1643
15000US060133451031,1567,1069,78,1489,1644
15000US060133451032,1051,681,10,1041,1645
15000US060133451033,2210,1195,315,1895,1646
15000US060133451051,3626,2651,268,3358,1647
15000US060133451052,1253,884,151,1102,1648
15000US060133451053,787,637,39,748,1649
15000US060133451054,959,813,142,817,1650
15000US060133451081,2083,1083,154,1929,1651
15000US060133451082,2750,1725,142,2608,1652
15000US060133451083,1247,715,13,1234,1653
15000US060133451084,1400,460,120,1280,1654
15000US060133451111,1316,838,90,1226,1655
15000US060133451112,2841,640,208,2633,1656
15000US060133451113,926,639,137,789,1657
15000US060133451121,2440,1149,324,2116,1658
15000US060133451122,3505,1346,335,3170,1659
15000US060133451131,1485,867,91,1394,1660
15000US060133451132,2821,1926,201,2620,1661
15000US060133451141,1392,964,185,1207,1662
15000US060133451142,1242,1095,12,1230,1663
15000US060133451143,3063,2799,26,3037,1664
15000US060133451144,821,780,17,804,1665
15000US060133451151,4112,2116,207,3905,1666
15000US060133451152,1878,1012,110,1768,1667
15000US060133451161,1240,691,53,1187,1668
15000US060133451162,1612,856,338,1274,1669
15000US060133452021,3857,2269,497,3360,1670
15000US060133452022,1780,1015,16,1764,1671
15000US060133452023,2243,1441,66,2177,1672
15000US060133452031,2897,2034,44,2853,1673
15000US060133452032,753,715,38,715,1674
15000US060133452033,1049,754,107,942,1675
15000US060133452034,2122,1906,160,1962,1676
15000US060133452041,2336,2098,114,2222,1677
15000US060133452042,1597,1490,81,1516,1678
15000US060133461011,2357,1818,159,2198,1679
15000US060133461012,1089,902,66,1023,1680
15000US060133461021,2147,1760,140,2007,1681
15000US060133461022,2791,2148,277,2514,1682
15000US060133461023,855,711,18,837,1683
15000US060133462011,1342,1048,155,1187,1684
15000US060133462012,2066,1801,49,2017,1685
15000US060133462013,3026,2796,0,3026,1686
15000US060133462014,854,824,0,854,1687
15000US060133462031,2644,2275,91,2553,1688
15000US060133462032,1202,957,62,1140,1689
15000US060133462041,3058,2163,196,2862,1690
15000US060133462042,2281,1632,160,2121,1691
15000US060133462043,2072,1668,251,1821,1692
15000US060133470001,2554,1852,188,2366,1693
15000US060133470002,1991,1768,76,1915,1694
15000US060133470003,1655,1090,179,1476,1695
15000US060133480001,886,699,93,793,1696
15000US060133480002,2077,1703,75,2002,1697
15000US060133480003,1899,1164,137,1762,1698
15000US060133490001,2516,1671,305,2211,1699
15000US060133490002,1601,1375,45,1556,1700
15000US060133490003,1401,1146,172,1229,1701
15000US060133500001,1945,1177,271,1674,1702
15000US060133500002,1278,1010,64,1214,1703
15000US060133500003,1791,1066,21,1770,1704
15000US060133500004,1461,1195,74,1387,1705
15000US060133511011,915,811,17,898,1706
15000US060133511012,404,364,0,404,1707
15000US060133511013,1281,1103,28,1253,1708
15000US060133511021,1696,1380,125,1571,1709
15000US060133511022,734,643,45,689,1710
15000US060133511023,1237,1049,33,1204,1711
15000US060133511031,783,696,18,765,1712
15000US060133511032,1101,985,38,1063,1713
15000US060133512001,1407,1076,130,1277,1714
15000US060133512002,2166,1904,56,2110,1715
15000US060133512003,2430,1819,94,2336,1716
15000US060133521011,1454,1092,65,1389,1717
15000US060133521012,1766,1039,318,1448,1718
15000US060133521021,1290,926,94,1196,1719
15000US060133521022,1095,880,144,951,1720
15000US060133521023,2645,1798,243,2402,1721
15000US060133521024,711,600,12,699,1722
15000US060133522011,3150,1960,399,2751,1723
15000US060133522012,1112,912,0,1112,1724
15000US060133522013,1998,1348,78,1920,1725
15000US060133522021,2542,1810,135,2407,1726
15000US060133530011,1306,1074,0,1306,1727
15000US060133530012,2391,1777,6,2385,1728
15000US060133530021,819,676,86,733,1729
15000US060133530022,1276,992,78,1198,1730
15000US060133530023,1449,957,295,1154,1731
15000US060133530024,885,612,103,782,1732
15000US060133540011,2064,1610,86,1978,1733
15000US060133540021,2843,2078,134,2709,1734
15000US060133540022,679,527,39,640,1735
15000US060133540023,1537,1233,121,1416,1736
15000US060133540024,1522,868,140,1382,1737
15000US060133551071,3698,1614,1089,2609,1738
15000US060133551072,1303,441,512,791,1739
15000US060133551081,4702,1004,855,3847,1740
15000US060133551082,4915,1407,1308,3607,1741
15000US060133551083,4330,689,1020,3310,1742
15000US060133551091,3544,1478,740,2804,1743
15000US060133551092,674,317,214,460,1744
15000US060133551093,3063,1164,758,2305,1745
15000US060133551101,2025,560,523,1502,1746
15000US060133551102,2066,455,545,1521,1747
15000US060133551111,3814,960,1108,2706,1748
15000US060133551112,2585,809,857,1728,1749
15000US060133551121,1321,802,225,1096,1750
15000US060133551122,1925,1469,33,1892,1751
15000US060133551123,2043,1608,130,1913,1752
15000US060133551131,1877,1096,76,1801,1753
15000US060133551132,1906,1291,107,1799,1754
15000US060133551133,1197,643,92,1105,1755
15000US060133551141,1922,1220,188,1734,1756
15000US060133551142,2902,1220,155,2747,1757
15000US060133551143,6578,2233,574,6004,1758
15000US060133551151,7330,1729,625,6705,1759
15000US060133551161,7865,1529,461,7404,1760
15000US060133551171,7278,1413,75,7203,1761
15000US060133552001,2434,227,438,1996,1762
15000US060133552002,7801,1839,1396,6405,1763
15000US060133553011,3320,1889,356,2964,1764
15000US060133553012,1433,962,95,1338,1765
15000US060133553013,2261,1278,407,1854,1766
15000US060133553014,1132,912,144,988,1767
15000US060133553021,932,590,119,813,1768
15000US060133553022,1006,637,50,956,1769
15000US060133553023,1531,1165,76,1455,1770
15000US060133553041,2288,1695,97,2191,1771
15000US060133553042,1474,1174,121,1353,1772
15000US060133553043,959,646,211,748,1773
15000US060133553044,2289,1839,210,2079,1774
15000US060133553045,1220,922,83,1137,1775
15000US060133553061,1117,978,60,1057,1776
15000US060133553062,1247,1024,81,1166,1777
15000US060133553063,1093,786,91,1002,1778
15000US060133553064,1139,982,110,1029,1779
15000US060133553065,633,567,48,585,1780
15000US060133560011,1151,301,446,705,1781
15000US060133560012,1257,466,124,1133,1782
15000US060133560013,1967,276,469,1498,1783
15000US060133560021,2013,346,242,1771,1784
15000US060133560022,688,318,112,576,1785
15000US060133560023,614,91,36,578,1786
15000US060133560024,1942,992,299,1643,1787
15000US060133570001,949,653,232,717,1788
15000US060133570002,1069,818,156,913,1789
15000US060133570003,1147,736,351,796,1790
15000US060133580001,1452,379,198,1254,1791
15000US060133580002,618,314,187,431,1792
15000US060133580003,1170,375,604,566,1793
15000US060133580004,1585,348,597,988,1794
15000US060133580005,1060,338,245,815,1795
15000US060133591021,1140,440,336,804,1796
15000US060133591022,2749,571,1161,1588,1797
15000US060133591023,1945,573,450,1495,1798
15000US060133591031,1421,666,323,1098,1799
15000US060133591032,1096,424,190,906,1800
15000US060133591033,2390,796,354,2036,1801
15000US060133591041,1974,456,206,1768,1802
15000US060133591051,4733,691,635,4098,1803
15000US060133592021,2308,607,724,1584,1804
15000US060133592022,2537,1433,348,2189,1805
15000US060133592023,1152,609,317,835,1806
15000US060133592031,1368,388,260,1108,1807
15000US060133592032,1207,325,102,1105,1808
15000US060133592033,1172,60,191,981,1809
15000US060133592034,2627,210,381,2246,1810
15000US060133592035,678,247,167,511,1811
15000US060133592041,774,194,141,633,1812
15000US060133592042,1468,77,333,1135,1813
15000US060133592043,2605,398,323,2282,1814
15000US060133601011,949,432,181,768,1815
15000US060133601012,2069,978,398,1671,1816
15000US060133601013,1880,498,684,1196,1817
15000US060133601021,1911,717,449,1462,1818
15000US060133601022,1615,422,522,1093,1819
15000US060133601023,613,224,57,556,1820
15000US060133602001,1651,517,383,1268,1821
15000US060133602002,1703,590,718,985,1822
15000US060133602003,1360,538,208,1152,1823
15000US060133610001,1176,332,402,774,1824
15000US060133610002,2097,546,504,1593,1825
15000US060133610003,1446,540,292,1154,1826
15000US060133620001,1089,643,303,786,1827
15000US060133620002,909,637,90,819,1828
15000US060133620003,979,434,217,762,1829
15000US060133630001,1813,437,433,1380,1830
15000US060133630002,1824,813,317,1507,1831
15000US060133630003,2560,576,667,1893,1832
15000US060133630004,1129,437,621,508,1833
15000US060133640021,2186,603,474,1712,1834
15000US060133640022,1983,356,891,1092,1835
15000US060133640023,1321,408,577,744,1836
15000US060133650021,2394,101,1398,996,1837
15000US060133650022,1858,80,1259,599,1838
15000US060133650023,2010,105,1131,879,1839
15000US060133650031,2156,361,349,1807,1840
15000US060133650032,1038,344,230,808,1841
15000US060133650033,1807,394,639,1168,1842
15000US060133660011,1449,127,831,618,1843
15000US060133660012,1890,219,933,957,1844
15000US060133660013,1131,38,459,672,1845
15000US060133660021,1506,177,980,526,1846
15000US060133660022,2192,61,1568,624,1847
15000US060133660023,2621,207,1350,1271,1848
15000US060133671001,1870,149,1069,801,1849
15000US060133671002,560,92,84,476,1850
15000US060133671003,1453,158,590,863,1851
15000US060133671004,1118,16,118,1000,1852
15000US060133672001,2075,276,1095,980,1853
15000US060133672002,2383,236,786,1597,1854
15000US060133672003,907,224,549,358,1855
15000US060133680011,1069,0,1035,34,1856
15000US060133680012,1786,48,1524,262,1857
15000US060133680013,1027,58,849,178,1858
15000US060133680014,1261,75,994,267,1859
15000US060133680021,1464,146,1013,451,1860
15000US060133680022,1916,121,1223,693,1861
15000US060133690011,1753,224,658,1095,1862
15000US060133690012,2134,457,206,1928,1863
15000US060133690013,1638,99,1346,292,1864
15000US060133690014,1900,145,1079,821,1865
15000US060133690021,970,85,423,547,1866
15000US060133690022,662,342,116,546,1867
15000US060133690023,724,250,260,464,1868
15000US060133700001,1550,627,291,1259,1869
15000US060133700002,658,279,37,621,1870
15000US060133700003,651,421,115,536,1871
15000US060133710001,1187,209,614,573,1872
15000US060133710002,901,150,458,443,1873
15000US060133710003,1320,565,321,999,1874
15000US060133710004,1250,357,311,939,1875
15000US060133710005,1036,147,528,508,1876
15000US060133710006,455,173,122,333,1877
15000US060133720001,1046,86,772,274,1878
15000US060133720002,1482,335,275,1207,1879
15000US060133720003,1027,217,471,556,1880
15000US060133720004,1049,142,372,677,1881
15000US060133720005,1215,55,1065,150,1882
15000US060133720006,1315,124,893,422,1883
15000US060133720007,481,86,372,109,1884
15000US060133730001,2097,30,1261,836,1885
15000US060133730002,1050,31,686,364,1886
15000US060133730003,955,25,829,126,1887
15000US060133740001,987,325,457,530,1888
15000US060133740002,973,207,339,634,1889
15000US060133740003,816,94,307,509,1890
15000US060133740004,1470,268,900,570,1891
15000US060133750001,2478,134,1877,601,1892
15000US060133750002,1256,101,1052,204,1893
15000US060133750003,1053,7,787,266,1894
15000US060133760001,1248,61,799,449,1895
15000US060133760002,2260,88,1680,580,1896
15000US060133760003,1036,89,412,624,1897
15000US060133760004,1003,9,612,391,1898
15000US060133770001,614,48,189,425,1899
15000US060133770002,778,25,537,241,1900
15000US060133770003,1227,14,974,253,1901
15000US060133770004,2837,72,1714,1123,1902
15000US060133770005,1379,322,703,676,1903
15000US060133780001,1587,1037,345,1242,1904
15000US060133780002,1529,1022,141,1388,1905
15000US060133790001,1226,7,664,562,1906
15000US060133790002,1525,65,627,898,1907
15000US060133790003,1749,18,1285,464,1908
15000US060133790004,2168,57,1449,719,1909
15000US060133800001,3523,1852,404,3119,1910
15000US060133800002,1398,0,406,992,1911
15000US060133800003,1648,73,362,1286,1912
15000US060133810001,1142,26,681,461,1913
15000US060133810002,1602,74,832,770,1914
15000US060133810003,2247,21,1298,949,1915
15000US060133810004,1220,173,650,570,1916
15000US060133810005,785,332,368,417,1917
15000US060133820001,799,85,32,767,1918
15000US060133820002,3294,55,1200,2094,1919
15000US060133820003,1750,86,839,911,1920
15000US060133820004,1643,220,250,1393,1921
15000US060133830001,1864,505,158,1706,1922
15000US060133830002,1374,586,154,1220,1923
15000US060133830003,1600,945,223,1377,1924
15000US060133840001,782,468,44,738,1925
15000US060133840002,1106,521,114,992,1926
15000US060133840003,1402,755,84,1318,1927
15000US060133840004,609,387,73,536,1928
15000US060133851001,1984,1099,172,1812,1929
15000US060133851002,957,441,87,870,1930
15000US060133852001,587,255,11,576,1931
15000US060133852002,588,293,57,531,1932
15000US060133860001,706,116,127,579,1933
15000US060133860002,775,80,83,692,1934
15000US060133860003,738,451,171,567,1935
15000US060133860004,1398,468,155,1243,1936
15000US060133870001,926,681,44,882,1937
15000US060133870002,958,400,72,886,1938
15000US060133870003,874,330,152,722,1939
15000US060133880001,1386,607,183,1203,1940
15000US060133880002,1390,720,180,1210,1941
15000US060133891001,1099,350,258,841,1942
15000US060133891002,917,454,162,755,1943
15000US060133892001,697,121,115,582,1944
15000US060133892002,1003,348,165,838,1945
15000US060133901001,678,419,43,635,1946
15000US060133901002,1019,664,76,943,1947
15000US060133901003,627,313,63,564,1948
15000US060133902001,953,706,57,896,1949
15000US060133902002,782,526,33,749,1950
15000US060133910001,1835,1399,144,1691,1951
15000US060133910002,844,610,23,821,1952
15000US060133920001,1254,924,47,1207,1953
15000US060133920002,723,501,88,635,1954
15000US060133920003,850,634,19,831,1955
15000US060133922001,2213,175,1659,554,1956
15000US060133922002,6458,991,1588,4870,1957
15000US060133922003,1642,788,368,1274,1958
15000US060133922004,1161,177,769,392,1959
15000US060133923001,3277,297,321,2956,1960
15000US060139900000,0,0,0,0,1961
15000US060150001011,2118,1339,203,1915,1962
15000US060150001012,1802,1244,232,1570,1963
15000US060150001021,1589,1003,68,1521,1964
15000US060150001022,1805,1181,280,1525,1965
15000US060150001041,2152,1186,602,1550,1966
15000US060150001051,1580,1139,167,1413,1967
15000US060150001052,1357,1057,19,1338,1968
15000US060150001053,957,698,80,877,1969
15000US060150001054,369,301,48,321,1970
15000US060150001055,2235,1782,348,1887,1971
15000US060150002011,1074,880,71,1003,1972
15000US060150002012,938,726,55,883,1973
15000US060150002013,4297,1239,2246,2051,1974
15000US060150002014,314,304,10,304,1975
15000US060150002021,1221,599,389,832,1976
15000US060150002022,827,515,279,548,1977
15000US060150002023,797,611,74,723,1978
15000US060150002024,908,837,47,861,1979
15000US060150002031,1288,786,108,1180,1980
15000US060159900000,0,0,0,0,1981
15000US060170302001,2287,758,1411,876,1982
15000US060170302002,799,684,80,719,1983
15000US060170302003,850,528,168,682,1984
15000US060170302004,445,170,275,170,1985
15000US060170302005,704,226,434,270,1986
15000US060170303011,820,381,427,393,1987
15000US060170303012,615,473,121,494,1988
15000US060170303013,844,539,293,551,1989
15000US060170303021,786,490,237,549,1990
15000US060170303022,933,506,303,630,1991
15000US060170303023,443,401,42,401,1992
15000US060170303024,621,489,132,489,1993
15000US060170304011,992,955,12,980,1994
15000US060170304012,611,500,32,579,1995
15000US060170304013,672,620,51,621,1996
15000US060170304014,911,543,286,625,1997
15000US060170304015,541,314,212,329,1998
15000US060170304021,464,436,13,451,1999
15000US060170304022,697,393,145,552,2000
15000US060170304023,968,774,156,812,2001
15000US060170304024,946,543,267,679,2002
15000US060170304025,679,313,278,401,2003
15000US060170305021,759,647,112,647,2004
15000US060170305022,728,707,13,715,2005
15000US060170305023,906,759,83,823,2006
15000US060170305041,1439,1125,219,1220,2007
15000US060170305042,503,345,63,440,2008
15000US060170305043,581,533,27,554,2009
15000US060170305051,1006,828,122,884,2010
15000US060170305052,543,534,9,534,2011
15000US060170305053,957,768,117,840,2012
15000US060170306011,3261,3161,0,3261,2013
15000US060170306012,2151,1986,113,2038,2014
15000US060170306021,570,500,70,500,2015
15000US060170306022,2837,2379,390,2447,2016
15000US060170306023,1241,1156,62,1179,2017
15000US060170306024,1629,1432,82,1547,2018
15000US060170306025,806,689,25,781,2019
15000US060170306031,902,826,59,843,2020
15000US060170306032,962,728,64,898,2021
15000US060170306033,1226,1076,125,1101,2022
15000US060170306034,47,45,1,46,2023
15000US060170307011,3401,2937,110,3291,2024
15000US060170307012,2912,2330,335,2577,2025
15000US060170307041,4125,2866,728,3397,2026
15000US060170307042,2968,1909,272,2696,2027
15000US060170307061,2638,1895,418,2220,2028
15000US060170307062,2982,2275,129,2853,2029
15000US060170307091,2320,1912,144,2176,2030
15000US060170307092,2416,1987,274,2142,2031
15000US060170307101,2552,1932,228,2324,2032
15000US060170307102,658,546,55,603,2033
15000US060170307103,1773,1124,95,1678,2034
15000US060170308011,3120,2305,318,2802,2035
15000US060170308012,1472,1275,80,1392,2036
15000US060170308031,4070,3469,452,3618,2037
15000US060170308032,1799,1441,354,1445,2038
15000US060170308033,1666,1478,142,1524,2039
15000US060170308041,2729,2330,203,2526,2040
15000US060170308042,1191,1181,0,1191,2041
15000US060170308043,2335,1986,273,2062,2042
15000US060170308071,2314,2010,113,2201,2043
15000US060170308072,2104,1983,34,2070,2044
15000US060170308081,2196,1245,879,1317,2045
15000US060170308082,3208,2483,291,2917,2046
15000US060170308083,1524,1278,75,1449,2047
15000US060170308091,952,699,224,728,2048
15000US060170308092,1534,1301,101,1433,2049
15000US060170308101,2557,1798,621,1936,2050
15000US060170308102,1085,812,161,924,2051
15000US060170309011,1997,1916,38,1959,2052
15000US060170309012,1146,995,44,1102,2053
15000US060170309021,1746,1357,140,1606,2054
15000US060170309022,1400,1150,139,1261,2055
15000US060170309023,1595,1458,115,1480,2056
15000US060170310001,666,607,24,642,2057
15000US060170310002,1274,1243,0,1274,2058
15000US060170310003,2292,1303,574,1718,2059
15000US060170310004,1454,1064,377,1077,2060
15000US060170311001,2192,1736,383,1809,2061
15000US060170311002,1299,1161,104,1195,2062
15000US060170311003,1532,1206,284,1248,2063
15000US060170312001,1982,1770,212,1770,2064
15000US060170312002,2294,1967,249,2045,2065
15000US060170312003,948,804,35,913,2066
15000US060170313011,1117,977,71,1046,2067
15000US060170313012,949,817,114,835,2068
15000US060170313013,1585,1401,121,1464,2069
15000US060170313021,1080,995,81,999,2070
15000US060170313022,2063,1996,11,2052,2071
15000US060170313023,1789,1384,315,1474,2072
15000US060170314021,1988,1868,57,1931,2073
15000US060170314022,1170,1008,103,1067,2074
15000US060170314023,1401,1151,142,1259,2075
15000US060170314024,674,469,142,532,2076
15000US060170314041,1315,1129,93,1222,2077
15000US060170314042,1007,898,76,931,2078
15000US060170314051,2531,2308,68,2463,2079
15000US060170314061,783,770,12,771,2080
15000US060170314062,2357,1962,205,2152,2081
15000US060170314063,1123,1078,45,1078,2082
15000US060170314064,1375,1013,127,1248,2083
15000US060170315021,2654,1946,454,2200,2084
15000US060170315022,2637,2282,185,2452,2085
15000US060170315023,1152,772,141,1011,2086
15000US060170315031,750,689,47,703,2087
15000US060170315032,1924,1669,172,1752,2088
15000US060170315041,1574,1192,364,1210,2089
15000US060170315042,979,913,66,913,2090
15000US060170315043,834,752,82,752,2091
15000US060170315044,2031,1896,73,1958,2092
15000US060170316001,1141,479,325,816,2093
15000US060170316002,411,304,105,306,2094
15000US060170316003,495,137,330,165,2095
15000US060170316004,933,277,323,610,2096
15000US060170316005,888,212,676,212,2097
15000US060170317001,2863,2144,159,2704,2098
15000US060170318001,850,349,27,823,2099
15000US060170318002,4131,2691,333,3798,2100
15000US060170318003,2449,1693,201,2248,2101
15000US060170319001,104,88,12,92,2102
15000US060170320001,598,443,0,598,2103
15000US060170320002,76,65,1,75,2104
15000US060170320003,119,68,51,68,2105
15000US060179900000,0,0,0,0,2106
15000US060190001001,3036,715,1600,1436,2107
15000US060190002001,843,23,704,139,2108
15000US060190002002,991,91,493,498,2109
15000US060190002003,1313,15,872,441,2110
15000US060190003001,1444,167,610,834,2111
15000US060190003002,784,53,544,240,2112
15000US060190003003,1042,40,778,264,2113
15000US060190004001,1607,27,1549,58,2114
15000US060190004002,1521,8,1333,188,2115
15000US060190004003,1915,194,1254,661,2116
15000US060190004004,973,66,686,287,2117
15000US060190005011,914,96,668,246,2118
15000US060190005012,1434,19,1266,168,2119
15000US060190005021,838,351,351,487,2120
15000US060190005022,1658,45,1598,60,2121
15000US060190005023,874,20,727,147,2122
15000US060190006001,731,312,373,358,2123
15000US060190006002,652,135,400,252,2124
15000US060190006003,2104,32,1632,472,2125
15000US060190006004,1864,257,1299,565,2126
15000US060190007001,399,18,272,127,2127
15000US060190007002,1808,59,1298,510,2128
15000US060190007003,1551,38,719,832,2129
15000US060190008001,1192,70,800,392,2130
15000US060190009011,2979,73,1820,1159,2131
15000US060190009021,1345,0,1033,312,2132
15000US060190009022,2061,21,1164,897,2133
15000US060190009023,1676,38,1163,513,2134
15000US060190010001,1835,30,987,848,2135
15000US060190010002,2120,22,1067,1053,2136
15000US060190011001,1464,38,1205,259,2137
15000US060190011002,1264,74,964,300,2138
15000US060190012011,747,7,261,486,2139
15000US060190012012,2230,131,2099,131,2140
15000US060190012013,2050,36,1374,676,2141
15000US060190012014,287,23,264,23,2142
15000US060190012021,2584,86,1779,805,2143
15000US060190012022,2244,47,1570,674,2144
15000US060190013011,1887,24,1590,297,2145
15000US060190013012,841,85,737,104,2146
15000US060190013013,842,9,701,141,2147
15000US060190013014,893,38,761,132,2148
15000US060190013015,1042,76,879,163,2149
15000US060190013031,1125,0,1096,29,2150
15000US060190013032,1190,41,517,673,2151
15000US060190013041,1044,0,508,536,2152
15000US060190013042,2872,81,1827,1045,2153
15000US060190013043,1612,38,1057,555,2154
15000US060190014071,2032,206,1131,901,2155
15000US060190014072,1019,55,654,365,2156
15000US060190014073,1479,25,776,703,2157
15000US060190014081,1943,922,599,1344,2158
15000US060190014082,579,139,318,261,2159
15000US060190014091,2026,779,617,1409,2160
15000US060190014101,8345,1025,4294,4051,2161
15000US060190014102,3102,99,2170,932,2162
15000US060190014111,1200,284,519,681,2163
15000US060190014112,910,570,268,642,2164
15000US060190014113,2148,262,839,1309,2165
15000US060190014114,1921,338,1080,841,2166
15000US060190014121,3217,849,1187,2030,2167
15000US060190014131,5736,1616,2342,3394,2168
15000US060190014141,1386,397,746,640,2169
15000US060190014142,1004,716,23,981,2170
15000US060190014143,6008,776,2228,3780,2171
15000US060190015001,356,179,173,183,2172
15000US060190015002,2012,468,1487,525,2173
15000US060190016001,2256,745,1418,838,2174
15000US060190016002,932,117,810,122,2175
15000US060190016003,1587,217,1121,466,2176
15000US060190017001,1608,220,1177,431,2177
15000US060190017002,1351,347,715,636,2178
15000US060190017003,3378,584,2218,1160,2179
15000US060190018001,1723,294,1211,512,2180
15000US060190018002,1018,124,867,151,2181
15000US060190018003,1151,529,601,550,2182
15000US060190018004,1329,395,910,419,2183
15000US060190019001,822,220,316,506,2184
15000US060190019002,974,130,777,197,2185
15000US060190019003,1028,319,663,365,2186
15000US060190020001,1844,177,1261,583,2187
15000US060190020002,1863,283,1357,506,2188
15000US060190020003,1014,124,681,333,2189
15000US060190020004,1131,259,872,259,2190
15000US060190020005,689,131,322,367,2191
15000US060190021001,735,446,264,471,2192
15000US060190021002,1326,269,940,386,2193
15000US060190021003,1158,389,681,477,2194
15000US060190021004,1109,149,720,389,2195
15000US060190021005,1321,574,666,655,2196
15000US060190022001,579,228,331,248,2197
15000US060190022002,958,354,536,422,2198
15000US060190022003,1058,295,630,428,2199
15000US060190022004,813,533,181,632,2200
15000US060190023001,969,401,544,425,2201
15000US060190023002,1173,345,748,425,2202
15000US060190023003,1152,297,715,437,2203
15000US060190024001,1288,111,734,554,2204
15000US060190024002,941,81,452,489,2205
15000US060190024003,1220,21,585,635,2206
15000US060190024004,1493,140,1301,192,2207
15000US060190025011,1355,104,1145,210,2208
15000US060190025012,990,97,778,212,2209
15000US060190025013,742,136,310,432,2210
15000US060190025014,1706,23,1007,699,2211
15000US060190025021,1529,36,838,691,2212
15000US060190025022,1574,23,1140,434,2213
15000US060190025023,2279,305,1428,851,2214
15000US060190026011,2120,62,1968,152,2215
15000US060190026012,1963,83,1774,189,2216
15000US060190026013,1348,55,1126,222,2217
15000US060190026021,691,220,420,271,2218
15000US060190026022,2084,248,1695,389,2219
15000US060190026023,955,153,612,343,2220
15000US060190027011,1357,43,1101,256,2221
15000US060190027012,721,83,576,145,2222
15000US060190027013,1208,71,947,261,2223
15000US060190027014,1011,80,915,96,2224
15000US060190027021,1233,43,1072,161,2225
15000US060190027022,1499,58,1174,325,2226
15000US060190027023,2571,54,2108,463,2227
15000US060190028001,1101,28,787,314,2228
15000US060190028002,630,40,273,357,2229
15000US060190028003,1354,54,1041,313,2230
15000US060190028004,1373,52,724,649,2231
15000US060190029031,1681,92,995,686,2232
15000US060190029032,1339,275,698,641,2233
15000US060190029033,1300,216,736,564,2234
15000US060190029041,1754,149,1105,649,2235
15000US060190029042,1502,192,996,506,2236
15000US060190029051,1428,204,623,805,2237
15000US060190029052,1766,181,1082,684,2238
15000US060190029061,2300,279,1075,1225,2239
15000US060190029062,1596,151,1079,517,2240
15000US060190029063,1763,211,892,871,2241
15000US060190030011,1682,127,881,801,2242
15000US060190030012,1674,200,873,801,2243
15000US060190030031,2782,360,660,2122,2244
15000US060190030032,1873,282,1203,670,2245
15000US060190030041,1511,313,964,547,2246
15000US060190030042,1242,338,697,545,2247
15000US060190031021,674,129,436,238,2248
15000US060190031022,808,610,85,723,2249
15000US060190031023,2442,1264,813,1629,2250
15000US060190031024,1399,328,799,600,2251
15000US060190031025,1957,897,585,1372,2252
15000US060190031031,1333,200,917,416,2253
15000US060190031032,1164,605,383,781,2254
15000US060190031033,711,258,327,384,2255
15000US060190031034,1523,606,864,659,2256
15000US060190031035,977,563,304,673,2257
15000US060190031041,2541,954,899,1642,2258
15000US060190031042,853,624,196,657,2259
15000US060190031043,820,360,384,436,2260
15000US060190032011,2497,458,1699,798,2261
15000US060190032012,2960,566,1332,1628,2262
15000US060190032021,1065,334,124,941,2263
15000US060190032022,1526,206,854,672,2264
15000US060190032023,2761,474,1487,1274,2265
15000US060190033011,2023,510,1174,849,2266
15000US060190033012,939,224,461,478,2267
15000US060190033021,1675,173,1155,520,2268
15000US060190033022,763,221,473,290,2269
15000US060190033023,1368,82,992,376,2270
15000US060190033024,1263,190,989,274,2271
15000US060190034001,1416,205,1078,338,2272
15000US060190034002,2263,92,1310,953,2273
15000US060190034003,790,120,522,268,2274
15000US060190034004,1188,357,509,679,2275
15000US060190035001,802,51,569,233,2276
15000US060190035002,1358,423,669,689,2277
15000US060190035003,1419,521,811,608,2278
15000US060190035004,998,349,538,460,2279
15000US060190035005,1196,101,620,576,2280
15000US060190036001,637,454,126,511,2281
15000US060190036002,800,393,398,402,2282
15000US060190036003,869,354,326,543,2283
15000US060190036004,773,428,312,461,2284
15000US060190036005,950,468,326,624,2285
15000US060190037011,2184,534,1364,820,2286
15000US060190037012,1327,331,925,402,2287
15000US060190037021,1787,252,845,942,2288
15000US060190037022,1065,257,371,694,2289
15000US060190037023,644,349,255,389,2290
15000US060190037024,950,177,746,204,2291
15000US060190038031,1208,363,471,737,2292
15000US060190038032,7436,1603,3393,4043,2293
15000US060190038033,914,248,324,590,2294
15000US060190038041,1820,491,622,1198,2295
15000US060190038042,1705,216,893,812,2296
15000US060190038043,2281,479,1236,1045,2297
15000US060190038051,2750,506,1844,906,2298
15000US060190038052,1019,0,608,411,2299
15000US060190038053,3230,348,1898,1332,2300
15000US060190038071,1505,160,1094,411,2301
15000US060190038072,1172,391,621,551,2302
15000US060190038073,467,168,230,237,2303
15000US060190038081,1468,514,705,763,2304
15000US060190038082,3807,310,2251,1556,2305
15000US060190038091,2911,627,1563,1348,2306
15000US060190038092,1805,354,1050,755,2307
15000US060190038101,2899,544,1364,1535,2308
15000US060190038102,2956,727,1428,1528,2309
15000US060190039001,998,531,457,541,2310
15000US060190039002,935,152,781,154,2311
15000US060190039003,1450,267,1183,267,2312
15000US060190039004,632,516,108,524,2313
15000US060190039005,1192,334,846,346,2314
15000US060190040011,3734,586,2927,807,2315
15000US060190040012,3387,813,2384,1003,2316
15000US060190040013,735,55,680,55,2317
15000US060190040021,2594,274,2297,297,2318
15000US060190040022,2334,125,2053,281,2319
15000US060190040023,2636,604,1681,955,2320
15000US060190041001,1532,1021,451,1081,2321
15000US060190041002,1353,53,1135,218,2322
15000US060190042051,1117,286,325,792,2323
15000US060190042052,905,281,358,547,2324
15000US060190042053,2544,434,1498,1046,2325
15000US060190042054,1995,511,1166,829,2326
15000US060190042071,5492,1464,2306,3186,2327
15000US060190042072,3944,201,2708,1236,2328
15000US060190042081,6164,3200,1418,4746,2329
15000US060190042082,1518,1124,144,1374,2330
15000US060190042101,1524,361,603,921,2331
15000US060190042102,1963,1119,599,1364,2332
15000US060190042111,2409,1069,930,1479,2333
15000US060190042112,4131,1787,1590,2541,2334
15000US060190042121,6394,1621,2625,3769,2335
15000US060190042122,735,355,35,700,2336
15000US060190042123,3341,1634,980,2361,2337
15000US060190042124,1509,410,766,743,2338
15000US060190042131,1338,455,696,642,2339
15000US060190042132,2219,1207,765,1454,2340
15000US060190042141,1060,739,194,866,2341
15000US060190042142,893,616,239,654,2342
15000US060190042143,1353,1055,268,1085,2343
15000US060190042144,1627,926,475,1152,2344
15000US060190042151,4577,1771,1165,3412,2345
15000US060190042161,2792,1040,1134,1658,2346
15000US060190043011,1032,807,20,1012,2347
15000US060190043012,1203,696,387,816,2348
15000US060190043013,1752,1250,265,1487,2349
15000US060190043021,718,583,28,690,2350
15000US060190043022,1234,977,156,1078,2351
15000US060190043023,708,478,146,562,2352
15000US060190043024,1597,899,303,1294,2353
15000US060190043025,1035,798,223,812,2354
15000US060190043031,974,781,123,851,2355
15000US060190043032,823,663,107,716,2356
15000US060190043033,819,677,104,715,2357
15000US060190043034,1488,900,473,1015,2358
15000US060190044041,2078,520,1297,781,2359
15000US060190044042,1563,138,1169,394,2360
15000US060190044051,934,704,70,864,2361
15000US060190044052,1900,998,530,1370,2362
15000US060190044053,1209,729,439,770,2363
15000US060190044061,2392,1404,611,1781,2364
15000US060190044062,620,367,238,382,2365
15000US060190044063,1987,1163,498,1489,2366
15000US060190044081,1642,951,459,1183,2367
15000US060190044082,1744,968,332,1412,2368
15000US060190044091,1368,494,622,746,2369
15000US060190044092,903,602,223,680,2370
15000US060190044093,1114,504,567,547,2371
15000US060190045031,2389,1613,367,2022,2372
15000US060190045032,2379,1458,692,1687,2373
15000US060190045041,1925,611,1010,915,2374
15000US060190045042,1128,733,242,886,2375
15000US060190045043,1252,255,817,435,2376
15000US060190045044,866,662,188,678,2377
15000US060190045051,1923,1149,510,1413,2378
15000US060190045052,3150,759,1702,1448,2379
15000US060190045061,1383,972,173,1210,2380
15000US060190045062,1796,1174,453,1343,2381
15000US060190046011,1765,972,658,1107,2382
15000US060190046012,1283,817,397,886,2383
15000US060190046021,666,598,26,640,2384
15000US060190046022,953,584,218,735,2385
15000US060190046023,776,512,168,608,2386
15000US060190047011,1834,425,1263,571,2387
15000US060190047012,1680,623,616,1064,2388
15000US060190047013,2142,576,1281,861,2389
15000US060190047014,2083,232,618,1465,2390
15000US060190047031,1795,399,1090,705,2391
15000US060190047032,1114,178,600,514,2392
15000US060190047033,1256,170,940,316,2393
15000US060190047041,2398,260,1617,781,2394
15000US060190047042,2374,711,1126,1248,2395
15000US060190048011,1125,179,931,194,2396
15000US060190048012,1188,225,740,448,2397
15000US060190048013,973,238,563,410,2398
15000US060190048014,2009,317,1102,907,2399
15000US060190048021,2313,415,1413,900,2400
15000US060190048022,1180,398,439,741,2401
15000US060190048023,1378,450,819,559,2402
15000US060190049011,2037,692,1013,1024,2403
15000US060190049012,1565,480,746,819,2404
15000US060190049021,1288,295,933,355,2405
15000US060190049022,807,604,113,694,2406
15000US060190050001,1117,244,748,369,2407
15000US060190050002,1428,361,727,701,2408
15000US060190050003,1592,1009,348,1244,2409
15000US060190051001,1540,574,568,972,2410
15000US060190051002,2010,208,1213,797,2411
15000US060190051003,445,221,50,395,2412
15000US060190051004,1300,110,774,526,2413
15000US060190051005,981,372,404,577,2414
15000US060190052021,1466,370,739,727,2415
15000US060190052022,2195,176,1274,921,2416
15000US060190052031,2494,441,1512,982,2417
15000US060190052032,2062,521,1236,826,2418
15000US060190052041,1499,452,420,1079,2419
15000US060190052042,1687,554,1007,680,2420
15000US060190052043,1069,293,497,572,2421
15000US060190053011,1890,335,643,1247,2422
15000US060190053012,1521,689,620,901,2423
15000US060190053013,2642,576,1657,985,2424
15000US060190053021,2696,717,1366,1330,2425
15000US060190053022,2886,760,1107,1779,2426
15000US060190053041,1447,415,447,1000,2427
15000US060190053042,3642,1124,1977,1665,2428
15000US060190053043,822,134,178,644,2429
15000US060190053051,1923,580,1198,725,2430
15000US060190053052,1900,706,598,1302,2431
15000US060190054031,1688,409,776,912,2432
15000US060190054032,950,417,323,627,2433
15000US060190054033,1629,282,909,720,2434
15000US060190054051,1474,943,357,1117,2435
15000US060190054052,970,632,265,705,2436
15000US060190054053,1437,687,506,931,2437
15000US060190054061,1104,680,251,853,2438
15000US060190054062,906,486,267,639,2439
15000US060190054063,2002,824,729,1273,2440
15000US060190054071,1309,883,319,990,2441
15000US060190054072,2111,997,673,1438,2442
15000US060190054081,2755,1300,785,1970,2443
15000US060190054091,2141,773,809,1332,2444
15000US060190054092,1438,889,269,1169,2445
15000US060190054101,663,319,222,441,2446
15000US060190054102,2832,869,1469,1363,2447
15000US060190055031,2462,1750,393,2069,2448
15000US060190055032,2943,1793,532,2411,2449
15000US060190055041,3193,1926,503,2690,2450
15000US060190055051,6590,3415,1589,5001,2451
15000US060190055071,3196,1364,1347,1849,2452
15000US060190055072,2586,1613,432,2154,2453
15000US060190055081,2239,1293,522,1717,2454
15000US060190055082,3000,1804,283,2717,2455
15000US060190055091,2272,1184,659,1613,2456
15000US060190055092,2759,1556,575,2184,2457
15000US060190055101,1905,1091,618,1287,2458
15000US060190055102,1721,1128,410,1311,2459
15000US060190055103,1205,862,216,989,2460
15000US060190055121,2073,1212,463,1610,2461
15000US060190055122,2722,1485,957,1765,2462
15000US060190055131,1667,1190,233,1434,2463
15000US060190055132,1205,660,292,913,2464
15000US060190055141,1198,1068,75,1123,2465
15000US060190055142,1487,916,342,1145,2466
15000US060190055143,1286,728,242,1044,2467
15000US060190055151,1547,1069,196,1351,2468
15000US060190055161,2251,1532,384,1867,2469
15000US060190055162,1743,1000,550,1193,2470
15000US060190055163,1604,887,494,1110,2471
15000US060190055171,3670,2379,406,3264,2472
15000US060190055172,2210,1738,229,1981,2473
15000US060190055173,2181,1048,903,1278,2474
15000US060190055181,4649,3024,902,3747,2475
15000US060190055201,1878,1125,251,1627,2476
15000US060190055202,94,46,42,52,2477
15000US060190055203,811,503,146,665,2478
15000US060190055221,358,338,10,348,2479
15000US060190055222,637,273,150,487,2480
15000US060190055223,3198,2164,413,2785,2481
15000US060190055224,257,169,77,180,2482
15000US060190055241,4631,2854,857,3774,2483
15000US060190055251,350,194,84,266,2484
15000US060190055252,838,672,61,777,2485
15000US060190056021,1224,730,388,836,2486
15000US060190056022,1234,417,730,504,2487
15000US060190056023,2157,1378,434,1723,2488
15000US060190056024,783,415,190,593,2489
15000US060190056051,1462,977,306,1156,2490
15000US060190056061,2064,918,879,1185,2491
15000US060190056062,1962,1222,392,1570,2492
15000US060190056071,1272,682,581,691,2493
15000US060190056072,1162,526,309,853,2494
15000US060190056073,1185,407,516,669,2495
15000US060190056074,837,377,340,497,2496
15000US060190056081,1104,647,166,938,2497
15000US060190056082,689,419,243,446,2498
15000US060190056083,940,598,263,677,2499
15000US060190056084,604,293,277,327,2500
15000US060190057011,1248,791,309,939,2501
15000US060190057012,661,428,56,605,2502
15000US060190057013,973,102,740,233,2503
15000US060190057014,859,426,324,535,2504
15000US060190057021,927,538,263,664,2505
15000US060190057022,1662,1210,297,1365,2506
15000US060190057023,1037,789,155,882,2507
15000US060190057024,1523,951,442,1081,2508
15000US060190057031,585,319,158,427,2509
15000US060190057032,1770,971,467,1303,2510
15000US060190057033,1630,1252,164,1466,2511
15000US060190057034,1123,860,194,929,2512
15000US060190057041,2077,729,1045,1032,2513
15000US060190057042,1324,650,558,766,2514
15000US060190057043,1383,805,398,985,2515
15000US060190057044,961,417,466,495,2516
15000US060190058011,2372,1204,855,1517,2517
15000US060190058012,1344,838,447,897,2518
15000US060190058013,1044,603,370,674,2519
15000US060190058021,2168,1136,364,1804,2520
15000US060190058022,2286,1117,651,1635,2521
15000US060190058041,1347,995,308,1039,2522
15000US060190058042,1320,515,733,587,2523
15000US060190058043,1371,827,472,899,2524
15000US060190058044,1044,463,508,536,2525
15000US060190058045,1638,57,754,884,2526
15000US060190058051,4746,1992,1435,3311,2527
15000US060190059041,4156,2392,1132,3024,2528
15000US060190059042,672,166,361,311,2529
15000US060190059051,613,406,34,579,2530
15000US060190059052,4825,3724,802,4023,2531
15000US060190059053,1402,761,179,1223,2532
15000US060190059061,1850,997,602,1248,2533
15000US060190059062,742,335,328,414,2534
15000US060190059071,77,77,0,77,2535
15000US060190059072,3232,1769,736,2496,2536
15000US060190059091,3802,1854,952,2850,2537
15000US060190059092,2519,1308,397,2122,2538
15000US060190059111,3958,2132,1010,2948,2539
15000US060190059112,410,106,247,163,2540
15000US060190059121,2334,1590,531,1803,2541
15000US060190059122,1679,1085,298,1381,2542
15000US060190060001,4579,1275,3134,1445,2543
15000US060190060002,880,128,752,128,2544
15000US060190060003,1222,184,1038,184,2545
15000US060190060004,1188,289,890,298,2546
15000US060190060005,770,196,563,207,2547
15000US060190061001,628,73,555,73,2548
15000US060190061002,1390,67,1291,99,2549
15000US060190061003,1496,151,1345,151,2550
15000US060190061004,1303,252,1051,252,2551
15000US060190061005,3080,425,2220,860,2552
15000US060190062011,1312,19,1293,19,2553
15000US060190062012,1231,114,1101,130,2554
15000US060190062021,1301,152,1149,152,2555
15000US060190062022,1420,3,1386,34,2556
15000US060190062023,1549,113,1428,121,2557
15000US060190062024,2370,79,2235,135,2558
15000US060190063001,1773,1393,349,1424,2559
15000US060190063002,858,469,297,561,2560
15000US060190063003,1932,1120,661,1271,2561
15000US060190063004,735,392,256,479,2562
15000US060190063005,2145,724,1180,965,2563
15000US060190064021,224,186,16,208,2564
15000US060190064022,1196,826,79,1117,2565
15000US060190064023,1246,962,48,1198,2566
15000US060190064024,68,63,0,68,2567
15000US060190064025,31,31,0,31,2568
15000US060190064026,355,338,10,345,2569
15000US060190064031,1516,1134,231,1285,2570
15000US060190064032,328,240,0,328,2571
15000US060190064033,1121,755,259,862,2572
15000US060190064034,2691,2036,442,2249,2573
15000US060190064041,1720,1410,160,1560,2574
15000US060190064042,679,572,73,606,2575
15000US060190064043,2595,2089,346,2249,2576
15000US060190064051,2069,1607,283,1786,2577
15000US060190064052,1388,1256,83,1305,2578
15000US060190064053,1477,817,544,933,2579
15000US060190065011,4374,165,4131,243,2580
15000US060190065012,1286,0,1276,10,2581
15000US060190065013,1085,121,964,121,2582
15000US060190065021,1654,93,1536,118,2583
15000US060190065022,3049,136,2904,145,2584
15000US060190066021,849,180,625,224,2585
15000US060190066022,2247,144,1999,248,2586
15000US060190066023,1682,225,1440,242,2587
15000US060190066024,1260,53,1207,53,2588
15000US060190066031,975,318,532,443,2589
15000US060190066032,1372,559,674,698,2590
15000US060190066041,2718,110,2428,290,2591
15000US060190066042,3379,36,3233,146,2592
15000US060190066043,579,8,550,29,2593
15000US060190066044,597,191,235,362,2594
15000US060190066045,1473,0,1473,0,2595
15000US060190067001,1148,625,339,809,2596
15000US060190067002,998,186,812,186,2597
15000US060190067003,2289,397,1799,490,2598
15000US060190067004,1067,434,497,570,2599
15000US060190067005,1066,476,436,630,2600
15000US060190068021,1137,89,1048,89,2601
15000US060190068022,584,222,294,290,2602
15000US060190068023,1662,30,1579,83,2603
15000US060190068024,456,0,456,0,2604
15000US060190069001,1531,23,1454,77,2605
15000US060190069002,956,170,719,237,2606
15000US060190069003,859,158,667,192,2607
15000US060190070021,1132,208,875,257,2608
15000US060190070022,1956,196,1745,211,2609
15000US060190070023,1431,181,1188,243,2610
15000US060190070031,2105,333,1595,510,2611
15000US060190070032,3850,226,3232,618,2612
15000US060190070033,1411,274,1103,308,2613
15000US060190070034,1264,255,985,279,2614
15000US060190070041,1259,465,506,753,2615
15000US060190070042,2771,630,1749,1022,2616
15000US060190070043,1366,133,1138,228,2617
15000US060190071001,1084,139,927,157,2618
15000US060190071002,487,28,459,28,2619
15000US060190071003,517,180,298,219,2620
15000US060190071004,1934,26,1901,33,2621
15000US060190071005,3461,139,3072,389,2622
15000US060190072011,1664,483,1022,642,2623
15000US060190072012,1722,1378,137,1585,2624
15000US060190072013,1299,807,474,825,2625
15000US060190072014,769,449,264,505,2626
15000US060190072015,2226,1471,670,1556,2627
15000US060190072021,1649,479,1170,479,2628
15000US060190072022,3528,1573,1654,1874,2629
15000US060190073001,669,192,439,230,2630
15000US060190073002,769,257,394,375,2631
15000US060190073003,827,82,494,333,2632
15000US060190073004,1090,347,678,412,2633
15000US060190073005,998,304,604,394,2634
15000US060190074001,952,404,548,404,2635
15000US060190074002,962,289,655,307,2636
15000US060190074003,1770,236,1534,236,2637
15000US060190075001,1040,323,673,367,2638
15000US060190075002,552,179,308,244,2639
15000US060190075003,754,326,428,326,2640
15000US060190075004,1147,80,1042,105,2641
15000US060190075005,1825,430,1210,615,2642
15000US060190076001,911,281,567,344,2643
15000US060190076002,733,238,477,256,2644
15000US060190076003,1375,126,1219,156,2645
15000US060190076004,1543,392,1047,496,2646
15000US060190077001,2562,702,1825,737,2647
15000US060190077002,1300,297,998,302,2648
15000US060190077003,1975,577,1398,577,2649
15000US060190077004,736,21,679,57,2650
15000US060190078011,2801,84,2717,84,2651
15000US060190078021,954,129,764,190,2652
15000US060190078022,724,0,724,0,2653
15000US060190078023,2175,101,2074,101,2654
15000US060190078024,1325,0,1325,0,2655
15000US060190079011,3788,948,1927,1861,2656
15000US060190079021,1544,559,707,837,2657
15000US060190079022,1708,98,1606,102,2658
15000US060190080001,631,172,352,279,2659
15000US060190080002,1556,480,1076,480,2660
15000US060190080003,934,617,302,632,2661
15000US060190080004,1124,386,662,462,2662
15000US060190080005,958,613,321,637,2663
15000US060190081001,1606,660,819,787,2664
15000US060190081002,2542,288,1894,648,2665
15000US060190081003,699,330,359,340,2666
15000US060190081004,1512,441,880,632,2667
15000US060190082001,302,43,259,43,2668
15000US060190082002,595,145,450,145,2669
15000US060190082003,552,239,313,239,2670
15000US060190082004,3286,179,3107,179,2671
15000US060190082005,752,12,740,12,2672
15000US060190082006,890,9,881,9,2673
15000US060190083011,1175,0,1150,25,2674
15000US060190083012,2118,0,2118,0,2675
15000US060190083013,2515,99,2416,99,2676
15000US060190083021,3170,0,3161,9,2677
15000US060190083022,1280,59,942,338,2678
15000US060190083023,526,0,504,22,2679
15000US060190083024,951,17,934,17,2680
15000US060190083025,1593,0,1593,0,2681
15000US060190084011,3033,147,2886,147,2682
15000US060190084012,794,135,659,135,2683
15000US060190084013,1105,123,982,123,2684
15000US060190084014,1363,48,1197,166,2685
15000US060190084015,1220,125,1089,131,2686
15000US060190084016,1372,46,1326,46,2687
15000US060190084021,625,162,463,162,2688
15000US060190084022,576,130,437,139,2689
15000US060190085011,1686,92,1503,183,2690
15000US060190085012,1741,51,1690,51,2691
15000US060190085013,961,0,961,0,2692
15000US060190085021,2564,20,2536,28,2693
15000US060190085022,2712,18,2694,18,2694
15000US060190085023,3297,129,3135,162,2695
15000US060210101001,2431,1373,982,1449,2696
15000US060210101002,2887,1429,1406,1481,2697
15000US060210101003,1795,857,896,899,2698
15000US060210101004,947,268,514,433,2699
15000US060210102001,1035,375,653,382,2700
15000US060210102002,1830,1411,367,1463,2701
15000US060210102003,402,331,70,332,2702
15000US060210102004,1635,1028,603,1032,2703
15000US060210103001,554,397,76,478,2704
15000US060210103002,896,856,34,862,2705
15000US060210103003,579,329,74,505,2706
15000US060210104001,1697,662,970,727,2707
15000US060210104002,1721,967,511,1210,2708
15000US060210104003,1102,448,405,697,2709
15000US060210104004,808,390,252,556,2710
15000US060210104005,984,615,285,699,2711
15000US060210104006,413,335,0,413,2712
15000US060210104007,716,274,442,274,2713
15000US060210105011,2135,416,1703,432,2714
15000US060210105012,641,491,120,521,2715
15000US060210105013,1182,384,575,607,2716
15000US060210105021,902,667,216,686,2717
15000US060210105022,684,542,101,583,2718
15000US060230001001,1360,954,205,1155,2719
15000US060230001002,1402,1023,154,1248,2720
15000US060230001003,414,322,25,389,2721
15000US060230001004,871,538,138,733,2722
15000US060230002001,795,569,154,641,2723
15000US060230002002,745,527,70,675,2724
15000US060230002003,730,471,0,730,2725
15000US060230002004,1373,1033,21,1352,2726
15000US060230002005,1018,649,341,677,2727
15000US060230002006,1187,911,49,1138,2728
15000US060230003001,980,748,42,938,2729
15000US060230003002,696,528,44,652,2730
15000US060230003003,1106,692,227,879,2731
15000US060230003004,2393,1570,247,2146,2732
15000US060230003005,1448,1170,103,1345,2733
15000US060230004001,1121,865,125,996,2734
15000US060230004002,888,698,59,829,2735
15000US060230004003,2110,1290,433,1677,2736
15000US060230005001,1132,815,94,1038,2737
15000US060230005002,998,709,100,898,2738
15000US060230005003,658,527,37,621,2739
15000US060230005004,1413,1087,145,1268,2740
15000US060230006001,763,584,108,655,2741
15000US060230006002,734,695,25,709,2742
15000US060230006003,1009,676,71,938,2743
15000US060230006004,1074,852,119,955,2744
15000US060230006005,949,616,125,824,2745
15000US060230007001,1341,1240,13,1328,2746
15000US060230007002,1706,1352,287,1419,2747
15000US060230007003,1473,1277,44,1429,2748
15000US060230007004,669,656,13,656,2749
15000US060230008001,1318,929,124,1194,2750
15000US060230008002,2056,1668,135,1921,2751
15000US060230008003,2101,1555,156,1945,2752
15000US060230009001,1715,1391,217,1498,2753
15000US060230009002,1467,1273,144,1323,2754
15000US060230009003,2414,1994,240,2174,2755
15000US060230010001,1222,751,222,1000,2756
15000US060230010002,1189,613,399,790,2757
15000US060230010003,721,607,95,626,2758
15000US060230010004,1200,1059,76,1124,2759
15000US060230010005,1723,995,262,1461,2760
15000US060230011011,1450,1215,108,1342,2761
15000US060230011012,1822,1271,206,1616,2762
15000US060230011013,1798,1287,394,1404,2763
15000US060230011014,1557,1045,401,1156,2764
15000US060230012001,2754,1844,494,2260,2765
15000US060230012002,1050,973,47,1003,2766
15000US060230012003,1239,948,139,1100,2767
15000US060230013001,1285,1046,59,1226,2768
15000US060230101021,1182,803,121,1061,2769
15000US060230101022,213,38,0,213,2770
15000US060230101023,643,342,71,572,2771
15000US060230101024,373,268,88,285,2772
15000US060230102001,1065,947,46,1019,2773
15000US060230102002,526,397,21,505,2774
15000US060230102003,826,694,59,767,2775
15000US060230103001,786,651,13,773,2776
15000US060230103002,760,688,21,739,2777
15000US060230103003,689,581,4,685,2778
15000US060230103004,809,686,21,788,2779
15000US060230103005,756,629,61,695,2780
15000US060230104001,2150,1810,161,1989,2781
15000US060230104002,1451,1144,118,1333,2782
15000US060230105011,2131,1745,107,2024,2783
15000US060230105012,2356,1396,684,1672,2784
15000US060230105013,1848,1429,256,1592,2785
15000US060230105014,1568,1132,225,1343,2786
15000US060230105021,2469,2348,73,2396,2787
15000US060230105022,1686,1360,96,1590,2788
15000US060230105023,1663,1353,65,1598,2789
15000US060230106001,1073,1004,7,1066,2790
15000US060230106002,764,685,71,693,2791
15000US060230107001,816,607,14,802,2792
15000US060230107002,2367,1763,215,2152,2793
15000US060230107003,2529,1853,119,2410,2794
15000US060230107004,387,319,0,387,2795
15000US060230107005,1181,615,431,750,2796
15000US060230108001,1098,787,144,954,2797
15000US060230108002,1089,926,50,1039,2798
15000US060230108003,812,675,131,681,2799
15000US060230108004,1065,804,210,855,2800
15000US060230109011,1140,905,103,1037,2801
15000US060230109012,1299,686,426,873,2802
15000US060230109013,2251,1430,727,1524,2803
15000US060230109021,439,418,7,432,2804
15000US060230109022,995,841,44,951,2805
15000US060230109023,968,839,31,937,2806
15000US060230109024,1456,1352,35,1421,2807
15000US060230110001,2232,1809,274,1958,2808
15000US060230110002,1447,1038,255,1192,2809
15000US060230110003,968,783,116,852,2810
15000US060230111001,1248,1073,53,1195,2811
15000US060230111002,1296,1083,159,1137,2812
15000US060230111003,1201,978,77,1124,2813
15000US060230111004,1016,879,78,938,2814
15000US060230112001,1004,941,55,949,2815
15000US060230112002,852,790,30,822,2816
15000US060230112003,1619,1124,381,1238,2817
15000US060230115001,1078,937,141,937,2818
15000US060230115002,1257,1169,79,1178,2819
15000US060230115003,953,730,22,931,2820
15000US060230116001,1026,857,50,976,2821
15000US060230116002,1350,1169,67,1283,2822
15000US060230116003,1272,1199,0,1272,2823
15000US060239400001,1595,199,53,1542,2824
15000US060239400002,1452,88,28,1424,2825
15000US060239901000,0,0,0,0,2826
15000US060250101011,4223,367,2666,1557,2827
15000US060250101021,1211,303,861,350,2828
15000US060250101022,1122,23,1075,47,2829
15000US060250101023,1251,107,1052,199,2830
15000US060250101024,1071,32,1018,53,2831
15000US060250102001,985,165,713,272,2832
15000US060250102002,1412,85,1304,108,2833
15000US060250103001,1115,524,541,574,2834
15000US060250104001,1178,0,1178,0,2835
15000US060250104002,1524,75,1291,233,2836
15000US060250104003,890,127,763,127,2837
15000US060250104004,1715,0,1715,0,2838
15000US060250104005,2869,265,2604,265,2839
15000US060250105001,3001,480,2309,692,2840
15000US060250105002,1193,43,999,194,2841
15000US060250105003,1268,289,938,330,2842
15000US060250105004,1177,86,1091,86,2843
15000US060250106001,1979,353,1626,353,2844
15000US060250106002,919,295,588,331,2845
15000US060250106003,585,354,231,354,2846
15000US060250106004,2965,976,1815,1150,2847
15000US060250107001,915,14,885,30,2848
15000US060250107002,1356,101,1255,101,2849
15000US060250107003,2283,48,2112,171,2850
15000US060250108001,732,181,421,311,2851
15000US060250108002,820,482,256,564,2852
15000US060250109001,1701,263,1412,289,2853
15000US060250109002,2063,383,1646,417,2854
15000US060250109003,1487,688,799,688,2855
15000US060250109004,613,153,460,153,2856
15000US060250109005,679,27,652,27,2857
15000US060250109006,374,109,265,109,2858
15000US060250110001,857,136,721,136,2859
15000US060250110002,525,59,466,59,2860
15000US060250110003,466,221,238,228,2861
15000US060250110004,653,155,331,322,2862
15000US060250110005,4975,931,3598,1377,2863
15000US060250110006,5360,948,4020,1340,2864
15000US060250111001,480,144,316,164,2865
15000US060250111002,1242,413,569,673,2866
15000US060250111003,1592,118,1412,180,2867
15000US060250112011,4479,804,3384,1095,2868
15000US060250112012,1958,140,1790,168,2869
15000US060250112021,2315,246,1910,405,2870
15000US060250112022,2250,0,2250,0,2871
15000US060250112023,909,64,845,64,2872
15000US060250113001,5352,651,4543,809,2873
15000US060250113002,1667,113,1541,126,2874
15000US060250113003,2188,0,2188,0,2875
15000US060250113004,2099,0,2099,0,2876
15000US060250114001,1470,21,1374,96,2877
15000US060250114002,863,44,802,61,2878
15000US060250114003,2121,25,1950,171,2879
15000US060250115001,1165,20,1068,97,2880
15000US060250115002,1385,35,1324,61,2881
15000US060250115003,2002,83,1881,121,2882
15000US060250115004,1795,187,1545,250,2883
15000US060250116001,1683,235,1424,259,2884
15000US060250116002,2061,85,1848,213,2885
15000US060250116003,611,40,513,98,2886
15000US060250116004,1666,188,1449,217,2887
15000US060250117001,2459,104,2247,212,2888
15000US060250117002,1430,243,1083,347,2889
15000US060250117003,1580,213,1334,246,2890
15000US060250118011,1734,501,1174,560,2891
15000US060250118012,2127,499,1454,673,2892
15000US060250118021,1671,304,1294,377,2893
15000US060250118022,774,235,530,244,2894
15000US060250118023,2058,285,1715,343,2895
15000US060250118024,1079,206,857,222,2896
15000US060250118031,6373,763,5021,1352,2897
15000US060250119001,320,34,286,34,2898
15000US060250119002,8239,316,7833,406,2899
15000US060250119003,2618,0,2618,0,2900
15000US060250120011,3342,9,3301,41,2901
15000US060250120012,939,32,896,43,2902
15000US060250120021,6759,191,6449,310,2903
15000US060250120022,3687,149,3445,242,2904
15000US060250121001,1579,46,1533,46,2905
15000US060250121002,689,0,688,1,2906
15000US060250121003,1614,9,1578,36,2907
15000US060250121004,2827,0,2827,0,2908
15000US060250122001,2789,7,2782,7,2909
15000US060250122002,1282,62,1220,62,2910
15000US060250122003,1543,0,1498,45,2911
15000US060250122004,2023,30,1993,30,2912
15000US060250123011,5147,670,3226,1921,2913
15000US060250123012,126,126,0,126,2914
15000US060250123021,1173,119,1010,163,2915
15000US060250123022,3439,890,2489,950,2916
15000US060250123023,1393,620,695,698,2917
15000US060250124001,685,613,30,655,2918
15000US060250124002,202,154,40,162,2919
15000US060259400001,1096,231,370,726,2920
15000US060259400002,701,46,326,375,2921
15000US060259400003,445,123,98,347,2922
15000US060270001001,1408,976,385,1023,2923
15000US060270001002,1230,998,223,1007,2924
15000US060270002001,1039,686,146,893,2925
15000US060270002002,683,507,128,555,2926
15000US060270003001,1324,1097,130,1194,2927
15000US060270003002,1388,1111,222,1166,2928
15000US060270004001,1660,271,346,1314,2929
15000US060270004002,1528,1105,329,1199,2930
15000US060270004003,1616,1242,259,1357,2931
15000US060270004004,1046,324,659,387,2932
15000US060270005001,827,638,101,726,2933
15000US060270005002,1679,892,243,1436,2934
15000US060270008001,492,389,37,455,2935
15000US060270008002,420,376,5,415,2936
15000US060270008003,1094,527,528,566,2937
15000US060270008004,892,594,126,766,2938
15000US060290001011,1422,1223,77,1345,2939
15000US060290001012,793,685,108,685,2940
15000US060290001013,1501,1094,206,1295,2941
15000US060290001014,1316,1005,278,1038,2942
15000US060290001015,8057,5609,2283,5774,2943
15000US060290001021,2029,1638,248,1781,2944
15000US060290001022,1222,1063,49,1173,2945
15000US060290002001,978,889,0,978,2946
15000US060290002002,1276,1021,205,1071,2947
15000US060290002003,563,382,56,507,2948
15000US060290002004,1311,655,530,781,2949
15000US060290002005,722,426,263,459,2950
15000US060290002006,1719,1450,161,1558,2951
15000US060290002007,1151,958,180,971,2952
15000US060290003001,1461,1028,333,1128,2953
15000US060290003002,1461,1112,274,1187,2954
15000US060290003003,1120,680,250,870,2955
15000US060290003004,466,303,152,314,2956
15000US060290004001,1294,913,228,1066,2957
15000US060290004002,1436,1092,194,1242,2958
15000US060290004003,1372,923,324,1048,2959
15000US060290005031,3468,1633,975,2493,2960
15000US060290005032,2188,1726,326,1862,2961
15000US060290005033,1698,1608,61,1637,2962
15000US060290005041,2071,1504,557,1514,2963
15000US060290005042,2667,1498,976,1691,2964
15000US060290005051,1923,1554,226,1697,2965
15000US060290005052,2009,1402,422,1587,2966
15000US060290005061,2585,1572,568,2017,2967
15000US060290005071,3394,2309,917,2477,2968
15000US060290006001,2561,1408,607,1954,2969
15000US060290006002,643,122,492,151,2970
15000US060290006003,1342,149,760,582,2971
15000US060290006004,2090,781,1080,1010,2972
15000US060290007001,1123,715,390,733,2973
15000US060290007002,725,381,328,397,2974
15000US060290007003,684,460,224,460,2975
15000US060290007004,1777,531,1136,641,2976
15000US060290007005,1024,177,814,210,2977
15000US060290008001,1214,437,725,489,2978
15000US060290008002,1539,313,1142,397,2979
15000US060290008003,646,337,283,363,2980
15000US060290008004,866,391,429,437,2981
15000US060290008005,964,357,597,367,2982
15000US060290009021,2363,838,1301,1062,2983
15000US060290009022,1246,630,590,656,2984
15000US060290009031,3019,729,2067,952,2985
15000US060290009032,861,487,320,541,2986
15000US060290009041,1316,486,521,795,2987
15000US060290009042,2015,475,1373,642,2988
15000US060290009043,1344,370,789,555,2989
15000US060290009051,945,247,633,312,2990
15000US060290009052,1419,292,1082,337,2991
15000US060290009061,2653,659,1899,754,2992
15000US060290009062,1678,399,1220,458,2993
15000US060290009071,2743,587,1942,801,2994
15000US060290009081,1669,603,921,748,2995
15000US060290009082,1705,421,814,891,2996
15000US060290009083,1946,998,781,1165,2997
15000US060290009091,1194,588,472,722,2998
15000US060290009092,1213,733,295,918,2999
15000US060290009101,1708,845,537,1171,3000
15000US060290009102,2425,883,1340,1085,3001
15000US060290009103,4296,1817,1928,2368,3002
15000US060290009104,2477,991,1066,1411,3003
15000US060290010001,4365,762,3583,782,3004
15000US060290010002,2417,917,1457,960,3005
15000US060290010003,898,191,694,204,3006
15000US060290010004,2227,1400,675,1552,3007
15000US060290011011,3066,784,2215,851,3008
15000US060290011012,2139,225,1914,225,3009
15000US060290011021,2574,422,2080,494,3010
15000US060290011022,1661,187,1156,505,3011
15000US060290011023,1531,267,1189,342,3012
15000US060290011024,1163,69,1082,81,3013
15000US060290011031,1642,130,1378,264,3014
15000US060290011032,1859,129,1643,216,3015
15000US060290011033,1675,139,1536,139,3016
15000US060290012011,1641,170,1452,189,3017
15000US060290012012,1235,183,822,413,3018
15000US060290012021,1251,148,1063,188,3019
15000US060290012022,2113,366,1524,589,3020
15000US060290012023,1351,59,1161,190,3021
15000US060290012024,936,161,619,317,3022
15000US060290013001,2008,45,1733,275,3023
15000US060290013002,941,116,720,221,3024
15000US060290013003,2056,28,1968,88,3025
15000US060290013004,1006,30,838,168,3026
15000US060290013005,959,0,900,59,3027
15000US060290013006,691,109,367,324,3028
15000US060290014001,2008,170,1724,284,3029
15000US060290014002,1557,83,1463,94,3030
15000US060290014003,1595,340,1204,391,3031
15000US060290014004,4125,326,3364,761,3032
15000US060290015001,763,150,548,215,3033
15000US060290015002,889,47,807,82,3034
15000US060290015003,912,24,694,218,3035
15000US060290016001,1060,316,426,634,3036
15000US060290016002,509,161,271,238,3037
15000US060290017001,805,592,199,606,3038
15000US060290017002,1019,785,179,840,3039
15000US060290017003,1676,724,423,1253,3040
15000US060290017004,564,297,226,338,3041
15000US060290018011,1477,462,796,681,3042
15000US060290018012,2300,753,1256,1044,3043
15000US060290018013,2102,1134,555,1547,3044
15000US060290018021,1017,356,357,660,3045
15000US060290018022,2934,1163,1538,1396,3046
15000US060290018023,1226,759,245,981,3047
15000US060290019011,1359,679,644,715,3048
15000US060290019012,841,450,272,569,3049
15000US060290019013,1194,399,657,537,3050
15000US060290019014,547,269,164,383,3051
15000US060290019021,1427,347,872,555,3052
15000US060290019022,1194,367,522,672,3053
15000US060290019023,660,175,254,406,3054
15000US060290019024,1362,397,771,591,3055
15000US060290020001,1105,212,513,592,3056
15000US060290020002,1847,115,1321,526,3057
15000US060290020003,2049,242,1068,981,3058
15000US060290020004,2134,162,1502,632,3059
15000US060290021001,570,0,551,19,3060
15000US060290021002,766,0,689,77,3061
15000US060290021003,1129,29,1013,116,3062
15000US060290021004,897,33,785,112,3063
15000US060290022001,1190,23,950,240,3064
15000US060290022002,917,17,708,209,3065
15000US060290022003,1139,33,828,311,3066
15000US060290022004,1489,0,1278,211,3067
15000US060290022005,776,0,572,204,3068
15000US060290023011,3644,518,2521,1123,3069
15000US060290023012,3750,341,3034,716,3070
15000US060290023013,1592,0,1592,0,3071
15000US060290023014,1960,90,1838,122,3072
15000US060290023021,1808,30,1774,34,3073
15000US060290023022,1781,11,1770,11,3074
15000US060290024001,8233,1103,6467,1766,3075
15000US060290025001,905,0,840,65,3076
15000US060290025002,1629,331,1032,597,3077
15000US060290025003,3077,233,2516,561,3078
15000US060290025004,2331,123,1627,704,3079
15000US060290025005,1630,438,1120,510,3080
15000US060290026001,803,169,468,335,3081
15000US060290026002,1327,124,1086,241,3082
15000US060290026003,1252,115,900,352,3083
15000US060290027001,951,432,484,467,3084
15000US060290027002,965,183,754,211,3085
15000US060290027003,1832,495,1279,553,3086
15000US060290027004,1238,313,545,693,3087
15000US060290027005,1182,114,963,219,3088
15000US060290028041,1230,915,229,1001,3089
15000US060290028042,1519,1000,387,1132,3090
15000US060290028061,2339,1450,483,1856,3091
15000US060290028071,1569,1253,248,1321,3092
15000US060290028072,685,445,227,458,3093
15000US060290028073,447,354,54,393,3094
15000US060290028074,995,646,243,752,3095
15000US060290028081,1263,907,130,1133,3096
15000US060290028082,1100,731,10,1090,3097
15000US060290028083,2034,964,535,1499,3098
15000US060290028084,1183,854,144,1039,3099
15000US060290028085,1587,507,724,863,3100
15000US060290028111,3380,2121,477,2903,3101
15000US060290028121,1664,586,928,736,3102
15000US060290028122,1053,498,494,559,3103
15000US060290028123,1724,402,937,787,3104
15000US060290028124,973,403,210,763,3105
15000US060290028131,1292,495,748,544,3106
15000US060290028132,1049,176,387,662,3107
15000US060290028133,1714,339,819,895,3108
15000US060290028141,1314,661,482,832,3109
15000US060290028142,1127,339,600,527,3110
15000US060290028143,1651,444,1069,582,3111
15000US060290028151,2517,742,1378,1139,3112
15000US060290028152,1839,627,846,993,3113
15000US060290028161,3234,691,2250,984,3114
15000US060290028162,611,284,145,466,3115
15000US060290028163,2383,586,1249,1134,3116
15000US060290028171,866,326,307,559,3117
15000US060290028172,2504,878,1157,1347,3118
15000US060290028173,1929,384,991,938,3119
15000US060290028181,2372,1195,968,1404,3120
15000US060290028182,1292,741,217,1075,3121
15000US060290028191,1677,891,587,1090,3122
15000US060290028192,3157,1306,1267,1890,3123
15000US060290028201,1632,538,790,842,3124
15000US060290028202,1353,213,837,516,3125
15000US060290028203,2708,1416,1090,1618,3126
15000US060290028204,1177,667,191,986,3127
15000US060290028211,1716,766,447,1269,3128
15000US060290028212,1109,505,588,521,3129
15000US060290028213,2025,1159,569,1456,3130
15000US060290029001,1714,380,913,801,3131
15000US060290029002,2897,439,1891,1006,3132
15000US060290029003,1486,627,399,1087,3133
15000US060290029004,1488,285,1013,475,3134
15000US060290030001,361,44,317,44,3135
15000US060290030002,1046,156,881,165,3136
15000US060290030003,690,35,569,121,3137
15000US060290030004,1980,402,1272,708,3138
15000US060290030005,1594,149,1261,333,3139
15000US060290030006,1919,396,1504,415,3140
15000US060290031031,1080,229,821,259,3141
15000US060290031032,1596,265,1287,309,3142
15000US060290031033,1073,125,917,156,3143
15000US060290031121,2125,604,1289,836,3144
15000US060290031122,1630,552,654,976,3145
15000US060290031123,1546,442,789,757,3146
15000US060290031131,2700,700,1539,1161,3147
15000US060290031132,2686,413,1800,886,3148
15000US060290031141,1594,570,650,944,3149
15000US060290031142,2004,600,1308,696,3150
15000US060290031143,2006,493,1283,723,3151
15000US060290031144,2286,620,1154,1132,3152
15000US060290031151,1522,276,1119,403,3153
15000US060290031152,1841,195,1388,453,3154
15000US060290031153,2673,441,1816,857,3155
15000US060290031211,1335,194,1122,213,3156
15000US060290031212,817,223,288,529,3157
15000US060290031213,2207,21,1709,498,3158
15000US060290031214,2098,366,1323,775,3159
15000US060290031215,1937,210,1207,730,3160
15000US060290031221,2404,103,2040,364,3161
15000US060290031222,2002,252,1734,268,3162
15000US060290031223,1981,25,1855,126,3163
15000US060290031224,1688,440,1003,685,3164
15000US060290031231,8022,2143,4161,3861,3165
15000US060290031232,3748,842,1150,2598,3166
15000US060290031233,828,339,484,344,3167
15000US060290031234,3367,1085,787,2580,3168
15000US060290031235,1862,923,557,1305,3169
15000US060290031236,1374,445,826,548,3170
15000US060290031241,1347,694,351,996,3171
15000US060290031242,2076,654,966,1110,3172
15000US060290031243,1529,559,948,581,3173
15000US060290031244,842,391,401,441,3174
15000US060290032021,4334,594,3081,1253,3175
15000US060290032022,7741,221,6536,1205,3176
15000US060290032023,2130,673,1277,853,3177
15000US060290032024,1830,333,1441,389,3178
15000US060290032025,1365,527,559,806,3179
15000US060290032031,2541,1632,645,1896,3180
15000US060290032041,9675,4385,2645,7030,3181
15000US060290032051,3275,1023,1371,1904,3182
15000US060290032052,3064,439,1845,1219,3183
15000US060290032053,3931,526,3154,777,3184
15000US060290032061,3596,814,1265,2331,3185
15000US060290032062,4057,485,2340,1717,3186
15000US060290032063,8535,2060,5055,3480,3187
15000US060290033031,1397,932,282,1115,3188
15000US060290033041,1024,787,155,869,3189
15000US060290033042,943,804,110,833,3190
15000US060290033043,2601,219,2041,560,3191
15000US060290033051,759,710,9,750,3192
15000US060290033052,391,350,17,374,3193
15000US060290033053,1884,1232,539,1345,3194
15000US060290033061,2004,975,768,1236,3195
15000US060290033062,2662,2207,322,2340,3196
15000US060290034001,2209,1139,1042,1167,3197
15000US060290034002,2536,650,1848,688,3198
15000US060290035001,2287,1159,781,1506,3199
15000US060290035002,2290,1508,627,1663,3200
15000US060290035003,1784,1123,542,1242,3201
15000US060290036001,520,153,367,153,3202
15000US060290036002,903,599,276,627,3203
15000US060290036003,3461,2503,864,2597,3204
15000US060290037001,1380,216,1048,332,3205
15000US060290037002,2340,956,1377,963,3206
15000US060290038031,6263,4423,1327,4936,3207
15000US060290038041,4636,2713,1507,3129,3208
15000US060290038042,4739,3307,934,3805,3209
15000US060290038043,6333,3839,1584,4749,3210
15000US060290038051,2882,1821,897,1985,3211
15000US060290038052,3054,1794,1127,1927,3212
15000US060290038053,1298,626,517,781,3213
15000US060290038054,2286,1280,485,1801,3214
15000US060290038061,4899,2727,1018,3881,3215
15000US060290038071,1860,1569,104,1756,3216
15000US060290038072,981,881,58,923,3217
15000US060290038081,1597,1036,443,1154,3218
15000US060290038082,2802,1305,966,1836,3219
15000US060290038091,1874,1175,262,1612,3220
15000US060290038092,5902,3841,1472,4430,3221
15000US060290038093,4707,2636,1312,3395,3222
15000US060290038101,1277,1000,192,1085,3223
15000US060290038102,1508,1106,289,1219,3224
15000US060290038111,1727,1285,348,1379,3225
15000US060290038112,977,666,207,770,3226
15000US060290038121,1796,1095,483,1313,3227
15000US060290038122,1841,844,635,1206,3228
15000US060290038123,793,492,189,604,3229
15000US060290038131,7946,4825,2181,5765,3230
15000US060290039001,2040,873,876,1164,3231
15000US060290039002,455,137,165,290,3232
15000US060290040001,1624,406,1019,605,3233
15000US060290040002,1609,73,1516,93,3234
15000US060290040003,1860,96,1747,113,3235
15000US060290040004,3298,374,2900,398,3236
15000US060290041011,2369,1061,1166,1203,3237
15000US060290041012,1132,126,981,151,3238
15000US060290041013,1310,121,1166,144,3239
15000US060290041021,2133,341,1792,341,3240
15000US060290041022,3188,93,3095,93,3241
15000US060290042001,1401,268,1078,323,3242
15000US060290043011,1190,247,943,247,3243
15000US060290043012,1981,148,1745,236,3244
15000US060290043013,4767,260,4364,403,3245
15000US060290043021,5607,1073,2887,2720,3246
15000US060290044011,2482,487,1926,556,3247
15000US060290044012,2747,395,2343,404,3248
15000US060290044013,2699,327,2215,484,3249
15000US060290044021,2123,87,1990,133,3250
15000US060290044022,2780,87,2550,230,3251
15000US060290045001,1487,14,1473,14,3252
15000US060290045002,1886,188,1679,207,3253
15000US060290046011,4293,808,2003,2290,3254
15000US060290046031,2329,440,1155,1174,3255
15000US060290046041,842,245,574,268,3256
15000US060290046042,10353,569,8630,1723,3257
15000US060290046043,108,10,58,50,3258
15000US060290046044,2660,35,1994,666,3259
15000US060290047011,4289,187,4092,197,3260
15000US060290047012,3532,86,3446,86,3261
15000US060290047013,1890,156,1506,384,3262
15000US060290047021,1446,10,1410,36,3263
15000US060290047022,1179,17,1162,17,3264
15000US060290047023,1278,14,1177,101,3265
15000US060290048001,2311,93,2088,223,3266
15000US060290048002,1766,10,1471,295,3267
15000US060290048003,1816,0,1784,32,3268
15000US060290048004,4256,106,3841,415,3269
15000US060290049011,1117,35,675,442,3270
15000US060290049012,1406,59,1174,232,3271
15000US060290049013,809,0,393,416,3272
15000US060290049014,1765,98,1561,204,3273
15000US060290049021,1524,49,1326,198,3274
15000US060290049022,1880,68,1305,575,3275
15000US060290049023,2054,0,1575,479,3276
15000US060290049024,1211,46,827,384,3277
15000US060290049025,1944,26,1391,553,3278
15000US060290050031,1335,150,908,427,3279
15000US060290050032,2324,24,2214,110,3280
15000US060290050041,4135,303,3072,1063,3281
15000US060290050042,2040,52,1878,162,3282
15000US060290050043,1578,214,1222,356,3283
15000US060290051031,2698,2203,223,2475,3284
15000US060290051041,2254,1966,156,2098,3285
15000US060290051042,1612,1023,488,1124,3286
15000US060290052011,683,495,179,504,3287
15000US060290052012,798,608,164,634,3288
15000US060290052013,484,447,23,461,3289
15000US060290052014,1106,1077,29,1077,3290
15000US060290052015,110,110,0,110,3291
15000US060290052016,797,769,0,797,3292
15000US060290052017,996,891,72,924,3293
15000US060290052031,1121,1062,0,1121,3294
15000US060290052032,924,780,0,924,3295
15000US060290052033,1687,1514,124,1563,3296
15000US060290052034,1077,1019,0,1077,3297
15000US060290052041,759,586,102,657,3298
15000US060290052042,644,587,57,587,3299
15000US060290052043,1870,1678,192,1678,3300
15000US060290052044,1537,937,508,1029,3301
15000US060290052045,980,903,36,944,3302
15000US060290053001,476,344,87,389,3303
15000US060290053002,1597,1057,461,1136,3304
15000US060290054011,1364,1028,286,1078,3305
15000US060290054012,1513,999,413,1100,3306
15000US060290054013,1003,408,412,591,3307
15000US060290054014,1380,1000,236,1144,3308
15000US060290054015,1301,730,217,1084,3309
15000US060290054021,1488,1021,358,1130,3310
15000US060290054022,1640,1191,194,1446,3311
15000US060290054023,1844,1420,305,1539,3312
15000US060290054031,2052,1390,522,1530,3313
15000US060290054032,3341,1828,452,2889,3314
15000US060290054033,1156,1010,89,1067,3315
15000US060290054034,1252,974,109,1143,3316
15000US060290054035,948,294,415,533,3317
15000US060290054041,1116,511,335,781,3318
15000US060290054042,3078,1994,227,2851,3319
15000US060290054043,2005,1396,332,1673,3320
15000US060290054044,804,540,249,555,3321
15000US060290055011,976,373,126,850,3322
15000US060290055012,1335,883,195,1140,3323
15000US060290055013,2261,1944,251,2010,3324
15000US060290055014,26,14,0,26,3325
15000US060290055015,1225,1102,97,1128,3326
15000US060290055016,908,896,0,908,3327
15000US060290055061,2733,1731,424,2309,3328
15000US060290055062,511,423,73,438,3329
15000US060290055063,995,529,243,752,3330
15000US060290055064,1101,470,523,578,3331
15000US060290055071,1955,779,266,1689,3332
15000US060290055072,3187,1741,769,2418,3333
15000US060290055073,1765,629,589,1176,3334
15000US060290055081,1269,707,244,1025,3335
15000US060290055082,1494,997,320,1174,3336
15000US060290055083,2074,625,581,1493,3337
15000US060290056001,1406,970,191,1215,3338
15000US060290056002,908,539,180,728,3339
15000US060290057001,2700,1837,343,2357,3340
15000US060290058011,2708,1248,917,1791,3341
15000US060290058012,1037,710,241,796,3342
15000US060290058013,2895,1479,960,1935,3343
15000US060290058021,1144,575,483,661,3344
15000US060290058022,1951,591,864,1087,3345
15000US060290058023,1508,519,247,1261,3346
15000US060290058024,3958,1062,2128,1830,3347
15000US060290059001,948,152,531,417,3348
15000US060290059002,901,240,573,328,3349
15000US060290059003,1859,792,629,1230,3350
15000US060290060021,4495,1707,1888,2607,3351
15000US060290060031,1083,823,243,840,3352
15000US060290060032,1587,726,760,827,3353
15000US060290060033,1249,924,312,937,3354
15000US060290060034,1993,973,988,1005,3355
15000US060290060041,829,687,74,755,3356
15000US060290060042,678,420,208,470,3357
15000US060290060061,1474,1243,159,1315,3358
15000US060290060062,1019,888,124,895,3359
15000US060290060063,1271,1001,194,1077,3360
15000US060290060071,1180,669,434,746,3361
15000US060290060072,3114,2798,256,2858,3362
15000US060290060073,1245,838,376,869,3363
15000US060290060081,685,504,97,588,3364
15000US060290060082,1263,1018,38,1225,3365
15000US060290060083,2239,1754,374,1865,3366
15000US060290060084,1901,1547,205,1696,3367
15000US060290061001,1342,791,432,910,3368
15000US060290061002,2422,1544,747,1675,3369
15000US060290061003,2775,1877,730,2045,3370
15000US060290061004,1766,738,662,1104,3371
15000US060290062011,3110,777,2279,831,3372
15000US060290062021,7757,311,7359,398,3373
15000US060290063011,1874,216,1581,293,3374
15000US060290063012,2158,242,1844,314,3375
15000US060290063031,2858,416,2365,493,3376
15000US060290063032,3410,51,3321,89,3377
15000US060290063041,1663,92,1557,106,3378
15000US060290063042,1635,105,1508,127,3379
15000US060290063043,1007,106,901,106,3380
15000US060290064011,1282,76,1147,135,3381
15000US060290064012,1644,0,1644,0,3382
15000US060290064013,1636,87,1539,97,3383
15000US060290064014,2282,51,2201,81,3384
15000US060290064015,1418,39,1379,39,3385
15000US060290064031,1712,92,1609,103,3386
15000US060290064032,1910,60,1844,66,3387
15000US060290064033,1812,91,1669,143,3388
15000US060290064034,901,19,882,19,3389
15000US060290064041,1757,28,1712,45,3390
15000US060290064042,1401,92,1309,92,3391
15000US060290065001,837,655,120,717,3392
15000US060290065002,2047,557,980,1067,3393
15000US060290065003,793,456,264,529,3394
15000US060310001001,757,432,283,474,3395
15000US060310001002,1214,673,431,783,3396
15000US060310001003,1112,732,342,770,3397
15000US060310002001,1387,939,425,962,3398
15000US060310002002,953,343,496,457,3399
15000US060310003001,3286,1660,601,2685,3400
15000US060310003002,3258,1524,858,2400,3401
15000US060310004021,1431,820,593,838,3402
15000US060310004022,2354,808,750,1604,3403
15000US060310004023,2403,1208,849,1554,3404
15000US060310004031,1649,509,957,692,3405
15000US060310004032,2891,1216,1087,1804,3406
15000US060310004033,881,251,169,712,3407
15000US060310004041,2052,871,629,1423,3408
15000US060310004042,750,456,41,709,3409
15000US060310004043,1964,542,981,983,3410
15000US060310004044,2886,1574,920,1966,3411
15000US060310004045,1965,788,957,1008,3412
15000US060310004051,2270,968,965,1305,3413
15000US060310004052,1045,489,335,710,3414
15000US060310004053,1442,549,804,638,3415
15000US060310004054,1732,209,1369,363,3416
15000US060310005001,774,364,329,445,3417
15000US060310005002,705,384,286,419,3418
15000US060310005003,2058,207,1748,310,3419
15000US060310005004,1563,566,637,926,3420
15000US060310006011,8123,3660,2999,5124,3421
15000US060310006012,2032,853,806,1226,3422
15000US060310006021,1425,887,427,998,3423
15000US060310006022,2030,859,548,1482,3424
15000US060310006023,953,672,234,719,3425
15000US060310006024,637,592,45,592,3426
15000US060310007011,1966,1096,837,1129,3427
15000US060310007012,1691,1262,373,1318,3428
15000US060310007013,1243,557,493,750,3429
15000US060310007014,1368,815,360,1008,3430
15000US060310007021,1514,1003,316,1198,3431
15000US060310007022,2825,1035,1694,1131,3432
15000US060310008001,766,543,211,555,3433
15000US060310008002,2284,827,1340,944,3434
15000US060310008003,1005,303,692,313,3435
15000US060310008004,411,182,202,209,3436
15000US060310009001,636,399,215,421,3437
15000US060310009002,1224,535,689,535,3438
15000US060310009003,1074,667,322,752,3439
15000US060310009004,1839,459,1064,775,3440
15000US060310009005,2293,211,1997,296,3441
15000US060310009006,480,145,260,220,3442
15000US060310009007,653,154,347,306,3443
15000US060310010011,618,362,178,440,3444
15000US060310010012,3464,1720,1154,2310,3445
15000US060310010021,1547,524,747,800,3446
15000US060310010022,1416,170,1174,242,3447
15000US060310010023,1748,528,1057,691,3448
15000US060310010031,3563,853,2374,1189,3449
15000US060310010032,2522,735,1627,895,3450
15000US060310011001,1307,202,899,408,3451
15000US060310011002,2750,373,1995,755,3452
15000US060310011003,1716,182,1440,276,3453
15000US060310011004,1219,223,879,340,3454
15000US060310012001,1125,505,602,523,3455
15000US060310012002,1494,817,647,847,3456
15000US060310013001,2560,318,2210,350,3457
15000US060310013002,2422,185,1875,547,3458
15000US060310014011,2986,202,2728,258,3459
15000US060310014021,930,172,747,183,3460
15000US060310014022,1496,258,1205,291,3461
15000US060310015001,1604,470,1077,527,3462
15000US060310015002,1194,23,1089,105,3463
15000US060310015003,778,289,417,361,3464
15000US060310015004,747,197,520,227,3465
15000US060310016011,1825,80,1730,95,3466
15000US060310016012,1350,230,597,753,3467
15000US060310016013,1041,179,848,193,3468
15000US060310016021,9965,2317,4995,4970,3469
15000US060310017011,3510,305,3205,305,3470
15000US060310017012,1485,133,1352,133,3471
15000US060310017013,1451,56,1395,56,3472
15000US060310017014,2505,111,2381,124,3473
15000US060310017015,30,0,30,0,3474
15000US060319818001,4639,1019,2375,2264,3475
15000US060330001001,1510,792,353,1157,3476
15000US060330001002,1907,1622,151,1756,3477
15000US060330003001,1249,942,148,1101,3478
15000US060330003002,2294,1834,410,1884,3479
15000US060330004001,1329,1165,160,1169,3480
15000US060330004002,1423,1226,121,1302,3481
15000US060330004003,1276,754,464,812,3482
15000US060330004004,610,532,59,551,3483
15000US060330004005,577,505,0,577,3484
15000US060330005011,1161,831,296,865,3485
15000US060330005012,1947,1084,409,1538,3486
15000US060330005013,418,277,123,295,3487
15000US060330005021,1501,1061,173,1328,3488
15000US060330005022,662,525,0,662,3489
15000US060330006001,706,617,70,636,3490
15000US060330006002,943,856,45,898,3491
15000US060330006003,744,601,76,668,3492
15000US060330006004,383,252,0,383,3493
15000US060330006005,1050,1015,17,1033,3494
15000US060330007011,1850,1336,210,1640,3495
15000US060330007012,2501,1565,522,1979,3496
15000US060330007021,2048,1432,471,1577,3497
15000US060330007022,1766,1088,588,1178,3498
15000US060330007023,32,22,10,22,3499
15000US060330008011,1436,683,582,854,3500
15000US060330008012,1443,1019,300,1143,3501
15000US060330008021,1823,1107,425,1398,3502
15000US060330008022,1231,753,297,934,3503
15000US060330008023,1051,688,312,739,3504
15000US060330009001,2387,1771,446,1941,3505
15000US060330009002,851,814,0,851,3506
15000US060330009003,3348,2457,786,2562,3507
15000US060330010001,686,272,289,397,3508
15000US060330010002,859,513,151,708,3509
15000US060330010003,982,548,243,739,3510
15000US060330010004,735,287,448,287,3511
15000US060330010005,2141,1208,848,1293,3512
15000US060330010006,975,630,329,646,3513
15000US060330011001,1639,1382,185,1454,3514
15000US060330011002,1955,1616,210,1745,3515
15000US060330012001,1267,995,262,1005,3516
15000US060330012002,1367,1073,172,1195,3517
15000US060330012003,710,639,41,669,3518
15000US060330013001,306,306,0,306,3519
15000US060330013002,1651,1078,225,1426,3520
15000US060330013003,789,551,216,573,3521
15000US060330013004,3613,3089,431,3182,3522
15000US060330013005,944,888,12,932,3523
15000US060350401001,297,228,25,272,3524
15000US060350401002,714,690,14,700,3525
15000US060350401003,352,316,30,322,3526
15000US060350402001,855,803,3,852,3527
15000US060350402002,1418,1071,186,1232,3528
15000US060350402003,565,423,132,433,3529
15000US060350403021,1243,1060,113,1130,3530
15000US060350403022,1523,1337,108,1415,3531
15000US060350403023,1409,1157,151,1258,3532
15000US060350403031,1390,1127,135,1255,3533
15000US060350403032,653,590,29,624,3534
15000US060350403033,841,707,72,769,3535
15000US060350403041,642,498,12,630,3536
15000US060350403042,884,678,42,842,3537
15000US060350403051,1405,1063,167,1238,3538
15000US060350403052,692,609,5,687,3539
15000US060350403053,1194,952,51,1143,3540
15000US060350404001,1190,1033,114,1076,3541
15000US060350404002,7968,1885,3463,4505,3542
15000US060350405001,1458,1330,63,1395,3543
15000US060350405002,586,571,0,586,3544
15000US060350405003,1392,1233,122,1270,3545
15000US060350406001,866,681,57,809,3546
15000US060350406002,1739,446,770,969,3547
15000US060350406003,669,613,16,653,3548
15000US060371011101,1785,1161,507,1278,3549
15000US060371011102,1770,634,944,826,3550
15000US060371011103,1112,777,191,921,3551
15000US060371011221,2169,1681,312,1857,3552
15000US060371011222,1132,836,111,1021,3553
15000US060371012101,2720,797,1757,963,3554
15000US060371012102,3071,1517,1168,1903,3555
15000US060371012201,1035,622,327,708,3556
15000US060371012202,2132,1082,521,1611,3557
15000US060371013001,1380,1235,47,1333,3558
15000US060371013002,1165,888,21,1144,3559
15000US060371013003,837,657,155,682,3560
15000US060371013004,856,694,131,725,3561
15000US060371014001,1066,488,428,638,3562
15000US060371014002,1797,1252,298,1499,3563
15000US060371014003,1368,731,294,1074,3564
15000US060371021031,1870,1445,323,1547,3565
15000US060371021041,2426,1737,186,2240,3566
15000US060371021042,1152,925,194,958,3567
15000US060371021051,805,192,549,256,3568
15000US060371021052,1144,229,768,376,3569
15000US060371021071,2814,1503,840,1974,3570
15000US060371021072,1136,764,261,875,3571
15000US060371031011,1557,1080,287,1270,3572
15000US060371031012,1177,706,444,733,3573
15000US060371031021,584,426,105,479,3574
15000US060371031022,788,479,285,503,3575
15000US060371031023,1246,516,366,880,3576
15000US060371031024,736,495,152,584,3577
15000US060371031025,1278,754,268,1010,3578
15000US060371032001,2167,811,871,1296,3579
15000US060371032002,1687,1186,343,1344,3580
15000US060371032003,2339,1074,966,1373,3581
15000US060371033001,1636,1362,193,1443,3582
15000US060371033002,1501,1190,43,1458,3583
15000US060371034001,1857,879,534,1323,3584
15000US060371034002,996,417,455,541,3585
15000US060371034003,583,451,87,496,3586
15000US060371034004,831,660,149,682,3587
15000US060371034005,2275,1362,354,1921,3588
15000US060371041031,2031,245,1471,560,3589
15000US060371041032,1830,92,1105,725,3590
15000US060371041051,1785,211,1162,623,3591
15000US060371041052,4094,204,3406,688,3592
15000US060371041081,1315,31,1042,273,3593
15000US060371041082,2111,98,1709,402,3594
15000US060371041083,1469,47,1124,345,3595
15000US060371041241,1988,215,1626,362,3596
15000US060371041242,1602,491,627,975,3597
15000US060371041243,789,369,241,548,3598
15000US060371042011,1354,11,1184,170,3599
15000US060371042012,1841,23,1605,236,3600
15000US060371042013,1429,0,1233,196,3601
15000US060371042031,2577,14,2264,313,3602
15000US060371042032,2303,0,2062,241,3603
15000US060371042041,1743,205,1257,486,3604
15000US060371042042,1674,201,1254,420,3605
15000US060371043101,1448,9,1289,159,3606
15000US060371043102,2227,15,2122,105,3607
15000US060371043103,1299,28,1218,81,3608
15000US060371043201,2831,61,2523,308,3609
15000US060371043202,979,7,871,108,3610
15000US060371043203,1169,42,1088,81,3611
15000US060371043204,815,0,720,95,3612
15000US060371044011,1600,40,1560,40,3613
15000US060371044012,2233,22,2211,22,3614
15000US060371044031,1883,65,1777,106,3615
15000US060371044032,1049,0,1049,0,3616
15000US060371044041,1032,31,947,85,3617
15000US060371044042,1890,20,1697,193,3618
15000US060371045001,738,0,738,0,3619
15000US060371045002,2184,34,2144,40,3620
15000US060371046101,2208,41,2163,45,3621
15000US060371046102,1129,19,1070,59,3622
15000US060371046201,1041,13,1028,13,3623
15000US060371046202,2370,34,2316,54,3624
15000US060371047011,1655,0,1564,91,3625
15000US060371047012,1616,6,1513,103,3626
15000US060371047013,757,0,731,26,3627
15000US060371047031,1177,25,1124,53,3628
15000US060371047032,1162,56,1064,98,3629
15000US060371047041,4140,237,3187,953,3630
15000US060371048101,1071,35,1024,47,3631
15000US060371048102,1152,30,1104,48,3632
15000US060371048103,3811,111,3610,201,3633
15000US060371048211,2023,116,1648,375,3634
15000US060371048212,1128,5,1108,20,3635
15000US060371048221,2477,105,2146,331,3636
15000US060371060101,3334,452,2541,793,3637
15000US060371060201,2812,264,2458,354,3638
15000US060371060202,3511,563,2759,752,3639
15000US060371061111,1782,619,993,789,3640
15000US060371061112,3012,636,1936,1076,3641
15000US060371061121,1901,248,1572,329,3642
15000US060371061122,3960,745,2638,1322,3643
15000US060371061131,2174,303,1611,563,3644
15000US060371061132,1328,133,1086,242,3645
15000US060371061141,5135,350,4233,902,3646
15000US060371061142,1316,6,1236,80,3647
15000US060371064031,1467,198,1245,222,3648
15000US060371064032,1161,27,1103,58,3649
15000US060371064033,981,79,894,87,3650
15000US060371064051,1402,240,1083,319,3651
15000US060371064052,1679,427,1022,657,3652
15000US060371064053,1183,63,1054,129,3653
15000US060371064061,3375,674,2225,1150,3654
15000US060371064062,769,186,537,232,3655
15000US060371064063,1364,161,878,486,3656
15000US060371064071,1997,249,1438,559,3657
15000US060371064072,1080,184,761,319,3658
15000US060371064081,2737,105,2406,331,3659
15000US060371064082,907,11,811,96,3660
15000US060371065101,2040,180,1534,506,3661
15000US060371065102,1323,321,947,376,3662
15000US060371065103,1815,427,1044,771,3663
15000US060371065201,2349,324,1967,382,3664
15000US060371065202,1868,243,1588,280,3665
15000US060371065203,1399,70,1266,133,3666
15000US060371066031,1618,779,352,1266,3667
15000US060371066032,1635,970,142,1493,3668
15000US060371066041,300,44,256,44,3669
15000US060371066042,2382,250,2011,371,3670
15000US060371066043,1061,31,1030,31,3671
15000US060371066044,1127,49,984,143,3672
15000US060371066411,2196,1364,292,1904,3673
15000US060371066421,1138,500,170,968,3674
15000US060371066422,869,516,290,579,3675
15000US060371066423,1223,523,502,721,3676
15000US060371066431,3173,1747,278,2895,3677
15000US060371066432,876,659,110,766,3678
15000US060371066433,690,481,105,585,3679
15000US060371066451,1369,1076,224,1145,3680
15000US060371066452,1967,1287,192,1775,3681
15000US060371066461,2010,1272,149,1861,3682
15000US060371066462,1596,429,912,684,3683
15000US060371066481,3064,60,2978,86,3684
15000US060371066482,1126,77,1049,77,3685
15000US060371066491,1092,41,857,235,3686
15000US060371066492,1613,219,891,722,3687
15000US060371070101,3165,108,2992,173,3688
15000US060371070201,4615,139,4094,521,3689
15000US060371070202,1003,15,846,157,3690
15000US060371081011,2462,1472,321,2141,3691
15000US060371081021,3686,2128,288,3398,3692
15000US060371081031,1503,972,39,1464,3693
15000US060371081032,1442,986,61,1381,3694
15000US060371081041,1992,1301,99,1893,3695
15000US060371082011,2581,1033,136,2445,3696
15000US060371082012,3246,940,202,3044,3697
15000US060371082021,6270,2364,568,5702,3698
15000US060371091001,909,255,505,404,3699
15000US060371091002,1848,328,1218,630,3700
15000US060371092001,801,220,546,255,3701
15000US060371092002,991,354,316,675,3702
15000US060371092003,1012,497,189,823,3703
15000US060371093001,1015,229,493,522,3704
15000US060371093002,1581,563,670,911,3705
15000US060371093003,879,238,405,474,3706
15000US060371094001,1066,28,915,151,3707
15000US060371094002,892,170,591,301,3708
15000US060371094003,1476,271,1179,297,3709
15000US060371095001,1395,134,1246,149,3710
15000US060371095002,1765,34,1605,160,3711
15000US060371095003,1632,98,1515,117,3712
15000US060371096011,1106,181,795,311,3713
15000US060371096012,1015,209,583,432,3714
15000US060371096013,1747,180,1423,324,3715
15000US060371096014,1520,132,1184,336,3716
15000US060371096031,1156,188,856,300,3717
15000US060371096032,1721,238,1303,418,3718
15000US060371096033,1217,422,519,698,3719
15000US060371096041,878,187,492,386,3720
15000US060371096042,1239,324,765,474,3721
15000US060371096043,973,222,677,296,3722
15000US060371097001,1548,183,1207,341,3723
15000US060371097002,1806,725,635,1171,3724
15000US060371097003,1008,414,444,564,3725
15000US060371098001,1328,406,718,610,3726
15000US060371098002,1069,188,795,274,3727
15000US060371098003,1391,477,689,702,3728
15000US060371098004,1312,230,825,487,3729
15000US060371111001,1843,719,763,1080,3730
15000US060371111002,1212,518,495,717,3731
15000US060371112011,981,382,476,505,3732
15000US060371112012,1635,579,598,1037,3733
15000US060371112013,690,380,276,414,3734
15000US060371112021,1656,669,541,1115,3735
15000US060371112022,1613,880,292,1321,3736
15000US060371112023,2182,826,780,1402,3737
15000US060371112041,2454,1575,359,2095,3738
15000US060371112042,2305,1280,122,2183,3739
15000US060371112043,1549,919,485,1064,3740
15000US060371112051,1895,362,321,1574,3741
15000US060371112052,866,305,255,611,3742
15000US060371112053,1508,536,356,1152,3743
15000US060371112061,927,550,214,713,3744
15000US060371112062,1003,674,156,847,3745
15000US060371112063,823,453,89,734,3746
15000US060371112064,783,487,162,621,3747
15000US060371112065,1206,410,106,1100,3748
15000US060371113011,1197,517,388,809,3749
15000US060371113012,1694,287,643,1051,3750
15000US060371113013,2916,906,1183,1733,3751
15000US060371113014,1366,272,671,695,3752
15000US060371113021,1616,1042,141,1475,3753
15000US060371113022,3697,1848,848,2849,3754
15000US060371114001,2708,849,868,1840,3755
15000US060371114002,2432,925,1098,1334,3756
15000US060371114003,2799,1002,960,1839,3757
15000US060371131011,1719,997,220,1499,3758
15000US060371131012,1963,1224,475,1488,3759
15000US060371131021,1669,969,261,1408,3760
15000US060371131022,1436,1064,216,1220,3761
15000US060371132111,1895,1137,411,1484,3762
15000US060371132112,1993,1482,144,1849,3763
15000US060371132121,1260,653,295,965,3764
15000US060371132122,2089,922,506,1583,3765
15000US060371132131,2755,1273,511,2244,3766
15000US060371132132,1990,695,751,1239,3767
15000US060371132311,1602,1124,153,1449,3768
15000US060371132312,637,295,69,568,3769
15000US060371132321,2059,1506,248,1811,3770
15000US060371132322,2033,889,288,1745,3771
15000US060371132331,1679,126,1041,638,3772
15000US060371132332,3122,719,1943,1179,3773
15000US060371132333,3305,840,1837,1468,3774
15000US060371132341,1058,560,265,793,3775
15000US060371132342,3596,633,1974,1622,3776
15000US060371132351,1815,1094,430,1385,3777
15000US060371132371,2646,1440,701,1945,3778
15000US060371132372,1191,536,257,934,3779
15000US060371133011,607,502,44,563,3780
15000US060371133012,1790,935,382,1408,3781
15000US060371133031,2223,1172,337,1886,3782
15000US060371133032,1887,774,850,1037,3783
15000US060371133211,3989,1091,1528,2461,3784
15000US060371133212,1672,764,248,1424,3785
15000US060371133221,1962,780,663,1299,3786
15000US060371133222,2214,1186,427,1787,3787
15000US060371134011,1927,693,708,1219,3788
15000US060371134012,1685,586,974,711,3789
15000US060371134013,2083,681,868,1215,3790
15000US060371134211,1967,306,1355,612,3791
15000US060371134212,2154,767,901,1253,3792
15000US060371134213,2497,552,1362,1135,3793
15000US060371134221,1658,560,638,1020,3794
15000US060371134222,2291,388,1546,745,3795
15000US060371134223,1407,495,701,706,3796
15000US060371134224,1160,403,494,666,3797
15000US060371151011,1911,886,466,1445,3798
15000US060371151012,2031,1225,265,1766,3799
15000US060371151013,1268,721,313,955,3800
15000US060371151031,3530,1148,1195,2335,3801
15000US060371151041,769,587,139,630,3802
15000US060371151042,3526,825,1138,2388,3803
15000US060371152011,2621,1041,773,1848,3804
15000US060371152012,1650,911,385,1265,3805
15000US060371152013,2563,1008,687,1876,3806
15000US060371152021,1756,818,380,1376,3807
15000US060371152022,2013,547,834,1179,3808
15000US060371152023,1283,506,430,853,3809
15000US060371153011,1362,562,320,1042,3810
15000US060371153012,2841,1616,584,2257,3811
15000US060371153021,4357,604,3111,1246,3812
15000US060371154011,2793,1004,1009,1784,3813
15000US060371154012,3192,1085,1675,1517,3814
15000US060371154031,3644,875,1967,1677,3815
15000US060371154041,1453,254,875,578,3816
15000US060371154042,1552,451,830,722,3817
15000US060371171011,2032,191,573,1459,3818
15000US060371171012,3099,302,1706,1393,3819
15000US060371171021,1244,244,809,435,3820
15000US060371171022,1582,431,905,677,3821
15000US060371172011,3319,349,2514,805,3822
15000US060371172012,1307,387,619,688,3823
15000US060371172021,1574,455,515,1059,3824
15000US060371172022,1020,261,482,538,3825
15000US060371173011,1665,797,473,1192,3826
15000US060371173012,1379,521,658,721,3827
15000US060371173013,900,417,277,623,3828
15000US060371173021,953,473,124,829,3829
15000US060371173022,1418,678,536,882,3830
15000US060371173023,783,469,163,620,3831
15000US060371173024,2136,769,531,1605,3832
15000US060371173031,2003,846,751,1252,3833
15000US060371173032,1517,547,724,793,3834
15000US060371174041,1697,707,715,982,3835
15000US060371174042,1104,534,341,763,3836
15000US060371174043,1725,505,794,931,3837
15000US060371174051,3615,145,3338,277,3838
15000US060371174071,3829,56,3656,173,3839
15000US060371174081,3270,155,2575,695,3840
15000US060371175101,3834,138,3357,477,3841
15000US060371175201,4102,138,3460,642,3842
15000US060371175301,2551,110,2085,466,3843
15000US060371175302,3918,234,2985,933,3844
15000US060371190011,1964,272,1237,727,3845
15000US060371190012,926,111,591,335,3846
15000US060371190013,1295,43,1105,190,3847
15000US060371190021,1321,12,1252,69,3848
15000US060371190022,1572,67,1397,175,3849
15000US060371190023,1016,107,707,309,3850
15000US060371190024,1504,136,1105,399,3851
15000US060371190025,1381,82,1265,116,3852
15000US060371192011,807,74,670,137,3853
15000US060371192012,1316,61,1111,205,3854
15000US060371192013,1984,83,1792,192,3855
15000US060371192021,712,24,503,209,3856
15000US060371192022,1012,153,809,203,3857
15000US060371192023,969,33,826,143,3858
15000US060371192024,1673,130,1369,304,3859
15000US060371193101,2213,204,1594,619,3860
15000US060371193102,1874,367,1272,602,3861
15000US060371193201,4824,142,3490,1334,3862
15000US060371193401,3965,20,3789,176,3863
15000US060371193411,2767,229,1618,1149,3864
15000US060371193421,3275,72,2636,639,3865
15000US060371194001,787,54,687,100,3866
15000US060371194002,1712,25,1574,138,3867
15000US060371194003,1062,136,872,190,3868
15000US060371194004,1714,148,1446,268,3869
15000US060371197001,1322,638,289,1033,3870
15000US060371197002,1679,233,712,967,3871
15000US060371197003,1865,255,1323,542,3872
15000US060371198001,1016,57,893,123,3873
15000US060371198002,1551,63,1234,317,3874
15000US060371198003,1119,27,934,185,3875
15000US060371198004,1897,128,1387,510,3876
15000US060371198005,557,73,409,148,3877
15000US060371199001,1468,90,1262,206,3878
15000US060371199002,2130,175,1357,773,3879
15000US060371199003,491,151,206,285,3880
15000US060371199004,1011,71,727,284,3881
15000US060371200101,1720,149,1355,365,3882
15000US060371200102,1023,90,660,363,3883
15000US060371200201,2864,106,2350,514,3884
15000US060371200202,1597,0,1063,534,3885
15000US060371200301,2520,59,2136,384,3886
15000US060371201031,3356,44,3211,145,3887
15000US060371201041,2384,184,1618,766,3888
15000US060371201051,2066,112,1781,285,3889
15000US060371201052,883,87,424,459,3890
15000US060371201061,4785,83,3997,788,3891
15000US060371201071,3863,99,3437,426,3892
15000US060371201081,1989,192,1500,489,3893
15000US060371201082,2792,198,2339,453,3894
15000US060371203001,722,197,214,508,3895
15000US060371203002,1631,212,946,685,3896
15000US060371203003,1212,195,796,416,3897
15000US060371203004,2033,147,1420,613,3898
15000US060371204001,3356,704,1924,1432,3899
15000US060371204002,826,25,444,382,3900
15000US060371204003,1693,78,1288,405,3901
15000US060371204004,1291,224,721,570,3902
15000US060371210101,1148,303,845,303,3903
15000US060371210102,1197,407,386,811,3904
15000US060371210103,1275,399,781,494,3905
15000US060371210104,801,143,547,254,3906
15000US060371210201,1168,213,946,222,3907
15000US060371210202,1700,494,1031,669,3908
15000US060371210203,941,220,588,353,3909
15000US060371211011,1223,244,759,464,3910
15000US060371211012,1861,343,1418,443,3911
15000US060371211021,721,252,444,277,3912
15000US060371211022,600,518,46,554,3913
15000US060371211023,1300,174,990,310,3914
15000US060371212101,2132,241,1512,620,3915
15000US060371212102,867,45,554,313,3916
15000US060371212211,708,37,640,68,3917
15000US060371212212,1584,205,1329,255,3918
15000US060371212221,4118,126,3622,496,3919
15000US060371212222,539,43,477,62,3920
15000US060371212223,850,75,696,154,3921
15000US060371216001,1872,664,778,1094,3922
15000US060371216002,886,436,145,741,3923
15000US060371218011,2256,334,1528,728,3924
15000US060371218012,1128,287,622,506,3925
15000US060371218021,1089,84,899,190,3926
15000US060371218022,1254,380,694,560,3927
15000US060371218023,1180,367,536,644,3928
15000US060371219001,1717,225,1354,363,3929
15000US060371219002,1311,154,1093,218,3930
15000US060371219003,976,374,539,437,3931
15000US060371220001,2229,1216,804,1425,3932
15000US060371220002,2630,999,1254,1376,3933
15000US060371220003,1287,405,638,649,3934
15000US060371221201,2277,265,1835,442,3935
15000US060371221202,2259,145,1996,263,3936
15000US060371221211,1712,158,1331,381,3937
15000US060371221212,1079,97,861,218,3938
15000US060371221221,475,13,462,13,3939
15000US060371221222,864,208,656,208,3940
15000US060371221223,1044,27,1017,27,3941
15000US060371222001,1503,82,1249,254,3942
15000US060371222002,2023,204,1608,415,3943
15000US060371222003,489,39,445,44,3944
15000US060371224101,2665,494,1946,719,3945
15000US060371224102,1102,29,986,116,3946
15000US060371224201,1150,222,776,374,3947
15000US060371224202,3462,424,2814,648,3948
15000US060371230101,2394,277,1977,417,3949
15000US060371230102,1703,54,1640,63,3950
15000US060371230201,2062,168,1706,356,3951
15000US060371230202,1653,64,1548,105,3952
15000US060371231031,1731,505,749,982,3953
15000US060371231032,2530,338,1818,712,3954
15000US060371231041,1210,208,886,324,3955
15000US060371231042,1914,254,1546,368,3956
15000US060371231043,1477,241,933,544,3957
15000US060371232031,1748,57,1575,173,3958
15000US060371232032,1260,286,760,500,3959
15000US060371232033,916,215,668,248,3960
15000US060371232041,2433,333,1934,499,3961
15000US060371232042,911,261,591,320,3962
15000US060371232051,1681,118,1404,277,3963
15000US060371232052,966,272,599,367,3964
15000US060371232061,3041,258,2623,418,3965
15000US060371233011,1516,330,956,560,3966
15000US060371233012,2126,770,462,1664,3967
15000US060371233013,654,221,349,305,3968
15000US060371233031,711,284,298,413,3969
15000US060371233032,2413,844,1246,1167,3970
15000US060371233041,2428,746,1486,942,3971
15000US060371233042,675,403,135,540,3972
15000US060371233043,1390,1052,250,1140,3973
15000US060371234101,3148,987,2014,1134,3974
15000US060371234102,1300,544,635,665,3975
15000US060371234201,2435,680,1519,916,3976
15000US060371234202,1107,453,464,643,3977
15000US060371234203,870,318,480,390,3978
15000US060371235101,3102,1340,1401,1701,3979
15000US060371235102,1979,854,806,1173,3980
15000US060371235201,2650,1009,1211,1439,3981
15000US060371236011,1071,506,493,578,3982
15000US060371236012,1740,1221,438,1302,3983
15000US060371236013,2445,1122,975,1470,3984
15000US060371236021,1977,971,737,1240,3985
15000US060371236022,572,332,183,389,3986
15000US060371236023,772,602,165,607,3987
15000US060371237001,481,317,109,372,3988
15000US060371237002,1365,1125,65,1300,3989
15000US060371237003,1278,715,168,1110,3990
15000US060371237004,905,809,12,893,3991
15000US060371238001,1742,801,745,997,3992
15000US060371238002,1996,1174,361,1635,3993
15000US060371238003,2113,1219,610,1503,3994
15000US060371239011,2963,570,2134,829,3995
15000US060371239012,404,324,80,324,3996
15000US060371239013,1064,774,267,797,3997
15000US060371239021,514,304,191,323,3998
15000US060371239022,2187,1100,495,1692,3999
15000US060371240001,1659,1324,131,1528,4000
15000US060371240002,1242,886,250,992,4001
15000US060371240003,1428,776,450,978,4002
15000US060371240004,932,630,97,835,4003
15000US060371241021,1815,340,1357,458,4004
15000US060371241022,959,294,351,608,4005
15000US060371241023,947,680,153,794,4006
15000US060371241031,722,182,486,236,4007
15000US060371241032,1333,136,961,372,4008
15000US060371241041,1865,440,1148,717,4009
15000US060371241042,718,149,537,181,4010
15000US060371241051,1263,422,707,556,4011
15000US060371241052,1221,401,705,516,4012
15000US060371242011,1101,334,610,491,4013
15000US060371242012,1128,513,483,645,4014
15000US060371242013,815,153,662,153,4015
15000US060371242031,974,273,645,329,4016
15000US060371242032,1677,432,1123,554,4017
15000US060371242041,1427,592,546,881,4018
15000US060371242042,1422,290,901,521,4019
15000US060371243001,963,237,633,330,4020
15000US060371243002,1500,361,1107,393,4021
15000US060371243003,1275,301,691,584,4022
15000US060371244001,1283,707,546,737,4023
15000US060371244002,1057,770,123,934,4024
15000US060371244003,2063,1472,276,1787,4025
15000US060371245001,1629,836,430,1199,4026
15000US060371245002,1506,745,516,990,4027
15000US060371246001,703,491,15,688,4028
15000US060371246002,1340,846,194,1146,4029
15000US060371246003,1186,884,159,1027,4030
15000US060371247001,763,568,152,611,4031
15000US060371247002,1345,974,194,1151,4032
15000US060371247003,1996,1441,361,1635,4033
15000US060371247004,1273,888,178,1095,4034
15000US060371249021,3018,1523,920,2098,4035
15000US060371249031,2497,1459,903,1594,4036
15000US060371249032,911,564,176,735,4037
15000US060371251001,1172,587,494,678,4038
15000US060371251002,3502,1666,892,2610,4039
15000US060371251003,801,540,198,603,4040
15000US060371251004,785,661,54,731,4041
15000US060371252001,1728,563,1068,660,4042
15000US060371252002,1264,527,253,1011,4043
15000US060371252003,973,592,145,828,4044
15000US060371253101,1150,450,481,669,4045
15000US060371253102,1253,495,426,827,4046
15000US060371253103,2505,812,1131,1374,4047
15000US060371253201,2504,1402,487,2017,4048
15000US060371253202,3068,1377,1138,1930,4049
15000US060371254011,1637,832,477,1160,4050
15000US060371254012,2712,1188,430,2282,4051
15000US060371254021,1695,1031,267,1428,4052
15000US060371254022,576,323,164,412,4053
15000US060371254023,1963,932,598,1365,4054
15000US060371255011,1684,850,376,1308,4055
15000US060371255012,1664,918,541,1123,4056
15000US060371255021,2591,1631,469,2122,4057
15000US060371255022,723,488,118,605,4058
15000US060371256001,716,458,157,559,4059
15000US060371256002,855,527,63,792,4060
15000US060371256003,1011,715,171,840,4061
15000US060371271021,1841,547,1201,640,4062
15000US060371271022,3621,929,2327,1294,4063
15000US060371271031,3429,690,2205,1224,4064
15000US060371271041,1880,527,866,1014,4065
15000US060371271042,1891,549,1149,742,4066
15000US060371272101,1160,90,903,257,4067
15000US060371272102,2021,270,1592,429,4068
15000US060371272103,2869,871,1539,1330,4069
15000US060371272201,1320,116,1112,208,4070
15000US060371272202,3351,678,2108,1243,4071
15000US060371273001,2288,522,1235,1053,4072
15000US060371273002,2187,757,795,1392,4073
15000US060371274001,1061,111,886,175,4074
15000US060371274002,1844,557,1181,663,4075
15000US060371274003,1945,357,1255,690,4076
15000US060371274004,1559,86,1306,253,4077
15000US060371275201,2720,98,2287,433,4078
15000US060371275202,1445,43,1066,379,4079
15000US060371276031,1817,235,1505,312,4080
15000US060371276032,1335,198,1016,319,4081
15000US060371276041,3028,847,1735,1293,4082
15000US060371276051,757,226,503,254,4083
15000US060371276052,3405,167,2508,897,4084
15000US060371276061,1058,374,684,374,4085
15000US060371276062,2548,473,1569,979,4086
15000US060371277111,2789,616,1667,1122,4087
15000US060371277112,893,316,492,401,4088
15000US060371277121,1079,535,454,625,4089
15000US060371277122,1920,420,1355,565,4090
15000US060371278031,1848,500,1069,779,4091
15000US060371278032,2321,520,1608,713,4092
15000US060371278041,4105,1171,2126,1979,4093
15000US060371278051,1287,242,662,625,4094
15000US060371278052,1376,274,1048,328,4095
15000US060371278053,1324,120,967,357,4096
15000US060371278061,1588,254,1236,352,4097
15000US060371278062,762,292,376,386,4098
15000US060371278063,1042,479,397,645,4099
15000US060371279101,1873,366,1071,802,4100
15000US060371279102,3216,422,2246,970,4101
15000US060371279201,2261,843,1245,1016,4102
15000US060371279202,1940,584,1225,715,4103
15000US060371281011,2226,1013,827,1399,4104
15000US060371281012,1232,463,752,480,4105
15000US060371281021,3196,484,2159,1037,4106
15000US060371281022,1733,265,1259,474,4107
15000US060371282101,3148,279,2632,516,4108
15000US060371282102,2128,102,1879,249,4109
15000US060371282201,1326,503,585,741,4110
15000US060371282202,1758,742,792,966,4111
15000US060371283021,2810,491,2120,690,4112
15000US060371283022,2347,294,1831,516,4113
15000US060371283031,1028,82,792,236,4114
15000US060371283032,2523,241,2222,301,4115
15000US060371284001,900,486,313,587,4116
15000US060371284002,1127,563,306,821,4117
15000US060371284003,947,555,251,696,4118
15000US060371284004,1063,507,371,692,4119
15000US060371285001,1650,946,390,1260,4120
15000US060371285002,2895,1609,781,2114,4121
15000US060371286011,3423,1224,1887,1536,4122
15000US060371286012,1405,492,577,828,4123
15000US060371286021,890,630,210,680,4124
15000US060371286022,1096,648,387,709,4125
15000US060371286023,1275,1000,75,1200,4126
15000US060371287021,1183,746,140,1043,4127
15000US060371287022,1495,988,175,1320,4128
15000US060371287023,1981,1313,223,1758,4129
15000US060371287024,1099,606,301,798,4130
15000US060371288011,1374,611,350,1024,4131
15000US060371288012,1893,1204,138,1755,4132
15000US060371288021,1890,1201,329,1561,4133
15000US060371288022,2052,1432,353,1699,4134
15000US060371288023,847,503,206,641,4135
15000US060371289101,1294,950,86,1208,4136
15000US060371289102,1559,1038,102,1457,4137
15000US060371289103,1446,1021,132,1314,4138
15000US060371310101,2478,580,1490,988,4139
15000US060371310102,3817,600,2244,1573,4140
15000US060371310201,2873,458,1802,1071,4141
15000US060371310202,1582,331,1201,381,4142
15000US060371310203,1594,422,751,843,4143
15000US060371311001,1507,530,607,900,4144
15000US060371311002,924,529,303,621,4145
15000US060371311003,892,397,302,590,4146
15000US060371312001,1376,471,685,691,4147
15000US060371312002,1021,427,257,764,4148
15000US060371312003,809,303,299,510,4149
15000US060371313001,1053,178,774,279,4150
15000US060371313002,1304,496,424,880,4151
15000US060371313003,1443,303,875,568,4152
15000US060371313004,1389,408,926,463,4153
15000US060371314001,3219,837,1631,1588,4154
15000US060371314002,3093,792,1189,1904,4155
15000US060371316001,2081,550,1177,904,4156
15000US060371316002,988,238,563,425,4157
15000US060371316003,1055,238,607,448,4158
15000US060371316004,1038,505,435,603,4159
15000US060371317011,2838,935,1282,1556,4160
15000US060371317012,2004,506,661,1343,4161
15000US060371317021,3290,729,1877,1413,4162
15000US060371317022,774,329,222,552,4163
15000US060371318001,1810,535,881,929,4164
15000US060371318002,4334,664,3032,1302,4165
15000US060371319001,1077,266,686,391,4166
15000US060371319002,1329,530,754,575,4167
15000US060371319003,1247,417,558,689,4168
15000US060371319004,1215,367,647,568,4169
15000US060371320011,652,431,119,533,4170
15000US060371320012,860,637,114,746,4171
15000US060371320013,1869,512,1021,848,4172
15000US060371320021,1156,292,737,419,4173
15000US060371320022,438,153,258,180,4174
15000US060371320023,1941,1025,789,1152,4175
15000US060371321011,1874,453,873,1001,4176
15000US060371321012,1445,306,888,557,4177
15000US060371321013,1405,441,598,807,4178
15000US060371321021,697,176,521,176,4179
15000US060371321022,1750,519,962,788,4180
15000US060371321023,2790,1094,1019,1771,4181
15000US060371323001,3199,943,1722,1477,4182
15000US060371323002,1581,683,596,985,4183
15000US060371323003,2747,318,2261,486,4184
15000US060371325011,2507,617,1370,1137,4185
15000US060371325012,1623,904,624,999,4186
15000US060371325021,2839,933,1354,1485,4187
15000US060371325022,1223,487,508,715,4188
15000US060371327001,601,300,241,360,4189
15000US060371327002,602,527,54,548,4190
15000US060371327003,950,518,332,618,4191
15000US060371327004,3241,405,2594,647,4192
15000US060371329001,1001,686,175,826,4193
15000US060371329002,2837,1824,664,2173,4194
15000US060371330001,1267,541,546,721,4195
15000US060371330002,1544,627,394,1150,4196
15000US060371330003,1700,347,1146,554,4197
15000US060371331001,2156,1063,746,1410,4198
15000US060371331002,1382,247,999,383,4199
15000US060371331003,1205,807,315,890,4200
15000US060371331004,1028,531,351,677,4201
15000US060371340011,2807,117,2490,317,4202
15000US060371340012,1071,67,852,219,4203
15000US060371340021,1179,263,678,501,4204
15000US060371340022,2660,478,1728,932,4205
15000US060371341011,3202,499,1727,1475,4206
15000US060371341012,2430,593,787,1643,4207
15000US060371341031,2946,473,1961,985,4208
15000US060371341032,1726,546,794,932,4209
15000US060371341041,2109,458,952,1157,4210
15000US060371341042,2135,422,658,1477,4211
15000US060371342011,1448,594,527,921,4212
15000US060371342012,1184,447,521,663,4213
15000US060371342013,1515,355,830,685,4214
15000US060371343021,863,484,282,581,4215
15000US060371343022,1383,644,438,945,4216
15000US060371343023,1410,885,233,1177,4217
15000US060371343031,1433,107,1195,238,4218
15000US060371343032,1336,611,573,763,4219
15000US060371343033,1321,453,510,811,4220
15000US060371343034,1864,1165,219,1645,4221
15000US060371343041,994,305,250,744,4222
15000US060371343042,1934,933,570,1364,4223
15000US060371343051,4451,368,3812,639,4224
15000US060371343061,3830,1142,1728,2102,4225
15000US060371344211,3860,2637,235,3625,4226
15000US060371344221,1835,1157,171,1664,4227
15000US060371344222,3106,2000,438,2668,4228
15000US060371344231,1778,1172,29,1749,4229
15000US060371344232,1694,1019,342,1352,4230
15000US060371344241,1612,1190,163,1449,4231
15000US060371344242,1072,722,36,1036,4232
15000US060371345201,3325,492,2404,921,4233
15000US060371345202,2176,88,1723,453,4234
15000US060371345211,3319,82,2889,430,4235
15000US060371345221,3757,518,2883,874,4236
15000US060371347101,3683,248,3258,425,4237
15000US060371347102,2262,561,1087,1175,4238
15000US060371347201,1533,397,776,757,4239
15000US060371347202,1859,489,929,930,4240
15000US060371347203,1184,279,466,718,4241
15000US060371348001,1861,483,1135,726,4242
15000US060371348002,1772,383,1100,672,4243
15000US060371348003,1228,321,619,609,4244
15000US060371348004,1079,354,538,541,4245
15000US060371348005,674,39,589,85,4246
15000US060371349011,1573,638,780,793,4247
15000US060371349012,705,510,20,685,4248
15000US060371349013,793,520,99,694,4249
15000US060371349031,6088,1640,2568,3520,4250
15000US060371349041,2834,967,1394,1440,4251
15000US060371349042,1642,316,958,684,4252
15000US060371349051,3684,2281,424,3260,4253
15000US060371351021,1656,908,345,1311,4254
15000US060371351022,1227,698,147,1080,4255
15000US060371351023,1241,846,145,1096,4256
15000US060371351111,986,447,503,483,4257
15000US060371351112,1298,769,142,1156,4258
15000US060371351113,970,385,96,874,4259
15000US060371351131,2880,1617,322,2558,4260
15000US060371351141,3520,1850,82,3438,4261
15000US060371351142,1178,520,450,728,4262
15000US060371352011,2078,1103,348,1730,4263
15000US060371352012,744,586,66,678,4264
15000US060371352021,1183,695,226,957,4265
15000US060371352022,1680,1021,236,1444,4266
15000US060371352023,1709,1097,238,1471,4267
15000US060371352031,2640,1689,400,2240,4268
15000US060371352032,1081,638,233,848,4269
15000US060371352033,1499,932,447,1052,4270
15000US060371352034,665,555,33,632,4271
15000US060371352035,796,493,239,557,4272
15000US060371352036,664,489,17,647,4273
15000US060371370001,2188,1672,189,1999,4274
15000US060371370002,2755,1958,275,2480,4275
15000US060371371031,2352,1144,627,1725,4276
15000US060371371032,2873,2119,340,2533,4277
15000US060371371041,1687,1351,205,1482,4278
15000US060371371042,1226,693,64,1162,4279
15000US060371372011,2943,1568,554,2389,4280
15000US060371372012,1624,391,434,1190,4281
15000US060371372013,1436,1190,142,1294,4282
15000US060371373011,2356,1555,284,2072,4283
15000US060371373021,1825,1526,88,1737,4284
15000US060371373022,2564,1945,144,2420,4285
15000US060371374011,657,389,169,488,4286
15000US060371374012,1552,1070,208,1344,4287
15000US060371374013,2081,1458,122,1959,4288
15000US060371374021,2224,1669,190,2034,4289
15000US060371374022,1685,1384,301,1384,4290
15000US060371374023,1416,921,219,1197,4291
15000US060371375011,3715,2217,734,2981,4292
15000US060371375012,785,587,105,680,4293
15000US060371375021,807,663,67,740,4294
15000US060371375022,1689,1261,313,1376,4295
15000US060371375023,1798,1048,281,1517,4296
15000US060371375041,2032,1864,49,1983,4297
15000US060371380001,2199,1734,230,1969,4298
15000US060371380002,704,634,60,644,4299
15000US060371380003,1684,1209,208,1476,4300
15000US060371390011,1704,1294,128,1576,4301
15000US060371390012,1749,913,433,1316,4302
15000US060371390013,587,548,39,548,4303
15000US060371390014,1003,601,305,698,4304
15000US060371392001,868,780,57,811,4305
15000US060371392002,1360,844,416,944,4306
15000US060371392003,3622,1797,1226,2396,4307
15000US060371393011,1489,1164,77,1412,4308
15000US060371393012,791,687,78,713,4309
15000US060371393013,2430,1598,551,1879,4310
15000US060371393021,2332,1139,558,1774,4311
15000US060371393022,2649,1086,1059,1590,4312
15000US060371393031,2936,1619,655,2281,4313
15000US060371393032,1356,845,402,954,4314
15000US060371394011,827,650,112,715,4315
15000US060371394012,1810,1099,465,1345,4316
15000US060371394021,1314,1093,11,1303,4317
15000US060371394022,1011,888,23,988,4318
15000US060371394023,592,512,29,563,4319
15000US060371395021,1683,1207,382,1301,4320
15000US060371395022,1391,977,14,1377,4321
15000US060371395031,3297,2448,539,2758,4322
15000US060371395032,2726,1568,467,2259,4323
15000US060371395041,2326,1707,223,2103,4324
15000US060371395042,1345,1032,142,1203,4325
15000US060371396001,2079,1466,263,1816,4326
15000US060371396002,2774,2520,93,2681,4327
15000US060371397011,778,721,0,778,4328
15000US060371397012,2239,2043,105,2134,4329
15000US060371397013,1135,727,109,1026,4330
15000US060371397014,726,644,18,708,4331
15000US060371397015,379,231,36,343,4332
15000US060371397021,1298,1171,44,1254,4333
15000US060371397022,747,606,39,708,4334
15000US060371397023,1407,1274,56,1351,4335
15000US060371397024,2416,1964,50,2366,4336
15000US060371397031,2907,2304,97,2810,4337
15000US060371398011,3310,2719,251,3059,4338
15000US060371398021,4014,3312,209,3805,4339
15000US060371411011,1767,1314,286,1481,4340
15000US060371411012,3149,2056,278,2871,4341
15000US060371411021,1086,810,30,1056,4342
15000US060371411022,1951,1531,156,1795,4343
15000US060371412011,1904,1225,388,1516,4344
15000US060371412012,1618,857,324,1294,4345
15000US060371412013,662,526,97,565,4346
15000US060371412021,644,644,0,644,4347
15000US060371412022,1277,983,93,1184,4348
15000US060371412023,1041,725,186,855,4349
15000US060371413021,1518,868,370,1148,4350
15000US060371413022,1233,1003,183,1050,4351
15000US060371413023,3181,2098,293,2888,4352
15000US060371413031,3338,2467,280,3058,4353
15000US060371413041,2122,1718,106,2016,4354
15000US060371413042,851,607,94,757,4355
15000US060371414001,1578,1112,68,1510,4356
15000US060371414002,1131,1024,81,1050,4357
15000US060371414003,1927,1527,52,1875,4358
15000US060371415001,2985,2400,267,2718,4359
15000US060371416001,1799,1538,106,1693,4360
15000US060371416002,1072,759,174,898,4361
15000US060371416003,1205,1011,16,1189,4362
15000US060371417001,571,491,0,571,4363
15000US060371417002,1998,1570,54,1944,4364
15000US060371417003,489,435,30,459,4365
15000US060371431001,970,915,19,951,4366
15000US060371431002,1180,868,149,1031,4367
15000US060371431003,2203,1349,386,1817,4368
15000US060371432001,2199,1354,435,1764,4369
15000US060371432002,1154,770,109,1045,4370
15000US060371432003,986,674,214,772,4371
15000US060371433001,982,701,254,728,4372
15000US060371433002,2487,1456,425,2062,4373
15000US060371433003,1137,809,199,938,4374
15000US060371433004,985,432,110,875,4375
15000US060371433005,1233,934,102,1131,4376
15000US060371434001,2208,1457,397,1811,4377
15000US060371434002,1840,1439,218,1622,4378
15000US060371434003,736,502,0,736,4379
15000US060371434004,1713,1246,240,1473,4380
15000US060371435001,1150,832,89,1061,4381
15000US060371435002,1032,808,148,884,4382
15000US060371435003,1535,1022,89,1446,4383
15000US060371435004,1011,616,126,885,4384
15000US060371436021,1118,933,0,1118,4385
15000US060371436022,1603,1257,102,1501,4386
15000US060371436023,1871,1279,366,1505,4387
15000US060371436031,2284,1690,219,2065,4388
15000US060371436041,1107,882,59,1048,4389
15000US060371436042,2298,1285,270,2028,4390
15000US060371437001,2127,1649,134,1993,4391
15000US060371437002,1592,1121,38,1554,4392
15000US060371438001,1125,679,153,972,4393
15000US060371438002,1415,1170,143,1272,4394
15000US060371438003,1995,1632,211,1784,4395
15000US060371438004,1197,553,436,761,4396
15000US060371439011,3201,2834,156,3045,4397
15000US060371439012,1038,879,37,1001,4398
15000US060371439021,1498,1127,114,1384,4399
15000US060371439022,1638,1489,86,1552,4400
15000US060371810001,602,303,140,462,4401
15000US060371810002,1479,493,534,945,4402
15000US060371810003,759,354,175,584,4403
15000US060371810004,1331,419,592,739,4404
15000US060371810005,2310,1069,702,1608,4405
15000US060371813001,1269,495,384,885,4406
15000US060371813002,909,343,374,535,4407
15000US060371813003,1800,442,771,1029,4408
15000US060371814001,1576,319,752,824,4409
15000US060371814002,824,254,434,390,4410
15000US060371814003,2043,533,692,1351,4411
15000US060371815001,1068,377,310,758,4412
15000US060371815002,1532,368,924,608,4413
15000US060371815003,1199,469,663,536,4414
15000US060371816001,2745,1058,1034,1711,4415
15000US060371816002,1888,387,703,1185,4416
15000US060371831011,983,143,785,198,4417
15000US060371831012,1194,350,658,536,4418
15000US060371831013,1631,352,1122,509,4419
15000US060371831031,1667,232,1075,592,4420
15000US060371831032,2557,64,2086,471,4421
15000US060371831041,2298,554,1295,1003,4422
15000US060371832201,1338,257,864,474,4423
15000US060371832202,1315,125,933,382,4424
15000US060371832203,1528,215,1066,462,4425
15000US060371832211,745,178,498,247,4426
15000US060371832212,2573,558,1801,772,4427
15000US060371832221,692,240,224,468,4428
15000US060371832222,1347,528,429,918,4429
15000US060371832223,1430,331,890,540,4430
15000US060371833001,559,100,319,240,4431
15000US060371833002,1176,206,793,383,4432
15000US060371833003,1571,154,888,683,4433
15000US060371834011,1287,284,689,598,4434
15000US060371834012,1034,152,661,373,4435
15000US060371834021,1321,200,685,636,4436
15000US060371834022,1748,560,638,1110,4437
15000US060371835101,414,80,257,157,4438
15000US060371835102,843,116,717,126,4439
15000US060371835103,1303,209,923,380,4440
15000US060371835201,1944,311,1257,687,4441
15000US060371835202,1774,142,1525,249,4442
15000US060371836101,853,50,686,167,4443
15000US060371836102,2549,267,2086,463,4444
15000US060371836201,2792,451,1982,810,4445
15000US060371836202,640,54,544,96,4446
15000US060371837011,1290,157,876,414,4447
15000US060371837012,999,108,758,241,4448
15000US060371837013,1445,45,1312,133,4449
15000US060371837021,1153,214,380,773,4450
15000US060371837022,1869,250,1395,474,4451
15000US060371838101,2005,146,1756,249,4452
15000US060371838102,2356,256,1836,520,4453
15000US060371838201,1570,140,1233,337,4454
15000US060371838202,2479,64,2357,122,4455
15000US060371851001,1375,669,546,829,4456
15000US060371851002,3824,754,2501,1323,4457
15000US060371851003,1137,722,166,971,4458
15000US060371852021,1553,424,972,581,4459
15000US060371852022,1440,515,793,647,4460
15000US060371852023,995,168,698,297,4461
15000US060371852031,2158,78,1908,250,4462
15000US060371852032,693,57,599,94,4463
15000US060371852033,500,102,291,209,4464
15000US060371852041,1219,380,347,872,4465
15000US060371852042,668,163,359,309,4466
15000US060371853101,1985,195,1607,378,4467
15000US060371853102,1194,51,1040,154,4468
15000US060371853201,1795,66,1588,207,4469
15000US060371853202,1280,49,1157,123,4470
15000US060371861001,1232,513,190,1042,4471
15000US060371861002,1149,380,477,672,4472
15000US060371861003,1737,377,620,1117,4473
15000US060371861004,746,244,184,562,4474
15000US060371862011,3287,660,1490,1797,4475
15000US060371862021,560,117,286,274,4476
15000US060371862022,1477,276,634,843,4477
15000US060371862031,1781,916,468,1313,4478
15000US060371862032,1010,176,616,394,4479
15000US060371863011,767,345,269,498,4480
15000US060371863012,1243,62,1064,179,4481
15000US060371863013,1104,74,811,293,4482
15000US060371863021,1419,464,490,929,4483
15000US060371863022,1823,407,809,1014,4484
15000US060371863023,1771,279,1386,385,4485
15000US060371864011,2565,56,2262,303,4486
15000US060371864012,1053,66,771,282,4487
15000US060371864031,1047,122,663,384,4488
15000US060371864032,1888,198,1286,602,4489
15000US060371864041,1736,81,1359,377,4490
15000US060371864042,903,109,705,198,4491
15000US060371871011,1234,480,350,884,4492
15000US060371871012,1803,608,618,1185,4493
15000US060371871021,1060,247,692,368,4494
15000US060371871022,2188,310,1236,952,4495
15000US060371872001,1564,158,1172,392,4496
15000US060371872002,1315,129,1066,249,4497
15000US060371873001,1830,930,345,1485,4498
15000US060371873002,1495,933,276,1219,4499
15000US060371881001,1896,587,1020,876,4500
15000US060371881002,760,244,336,424,4501
15000US060371881003,1139,134,773,366,4502
15000US060371882011,1668,911,167,1501,4503
15000US060371882012,815,601,100,715,4504
15000US060371882013,935,571,173,762,4505
15000US060371882021,785,593,16,769,4506
15000US060371882022,924,507,143,781,4507
15000US060371882023,545,322,29,516,4508
15000US060371883001,1374,203,743,631,4509
15000US060371883002,1119,643,99,1020,4510
15000US060371883003,1034,422,205,829,4511
15000US060371891011,974,737,145,829,4512
15000US060371891012,909,756,53,856,4513
15000US060371891013,639,438,46,593,4514
15000US060371891021,1160,794,175,985,4515
15000US060371891022,1002,594,263,739,4516
15000US060371891023,1024,698,137,887,4517
15000US060371892011,2033,1522,295,1738,4518
15000US060371892012,1446,986,139,1307,4519
15000US060371892021,813,720,23,790,4520
15000US060371892022,593,335,58,535,4521
15000US060371892023,1120,1003,33,1087,4522
15000US060371893001,1191,931,82,1109,4523
15000US060371893002,1240,909,93,1147,4524
15000US060371893003,672,439,22,650,4525
15000US060371894001,1522,1221,60,1462,4526
15000US060371894002,636,535,9,627,4527
15000US060371894003,1291,1048,92,1199,4528
15000US060371895001,2180,1855,186,1994,4529
15000US060371895002,1768,1352,293,1475,4530
15000US060371896001,1484,1007,314,1170,4531
15000US060371896002,1247,843,175,1072,4532
15000US060371896003,818,449,74,744,4533
15000US060371897011,873,604,105,768,4534
15000US060371897012,921,535,105,816,4535
15000US060371897013,1989,1579,254,1735,4536
15000US060371897021,2088,1570,153,1935,4537
15000US060371898001,1930,1079,447,1483,4538
15000US060371898002,673,466,74,599,4539
15000US060371898003,1311,786,283,1028,4540
15000US060371899021,1628,1399,158,1470,4541
15000US060371899022,2393,1204,539,1854,4542
15000US060371899023,1002,748,114,888,4543
15000US060371899031,2147,1416,194,1953,4544
15000US060371899041,2502,1752,164,2338,4545
15000US060371899051,848,614,149,699,4546
15000US060371899052,1357,1046,93,1264,4547
15000US060371901001,1824,1285,311,1513,4548
15000US060371901002,1858,1018,295,1563,4549
15000US060371901003,1351,1043,166,1185,4550
15000US060371902011,1365,867,368,997,4551
15000US060371902012,1129,559,382,747,4552
15000US060371902021,1251,607,304,947,4553
15000US060371902022,1910,1125,297,1613,4554
15000US060371903011,2195,1144,480,1715,4555
15000US060371903012,1607,904,472,1135,4556
15000US060371903013,1617,912,403,1214,4557
15000US060371904011,2337,1600,409,1928,4558
15000US060371904012,963,533,148,815,4559
15000US060371904021,2473,1502,443,2030,4560
15000US060371905101,3387,1296,1687,1700,4561
15000US060371905102,1533,400,461,1072,4562
15000US060371905201,1397,407,676,721,4563
15000US060371905202,2468,995,928,1540,4564
15000US060371907001,1141,556,316,825,4565
15000US060371907002,947,222,675,272,4566
15000US060371907003,1204,790,367,837,4567
15000US060371908011,1515,386,722,793,4568
15000US060371908012,1136,634,371,765,4569
15000US060371908021,1309,400,663,646,4570
15000US060371908022,607,237,353,254,4571
15000US060371908023,789,321,364,425,4572
15000US060371909011,581,15,558,23,4573
15000US060371909012,2499,225,2006,493,4574
15000US060371909013,1582,330,781,801,4575
15000US060371909021,1742,575,919,823,4576
15000US060371909022,1412,389,846,566,4577
15000US060371909023,1005,178,614,391,4578
15000US060371910001,976,346,133,843,4579
15000US060371910002,2129,358,1643,486,4580
15000US060371910003,973,549,145,828,4581
15000US060371911101,2749,1635,568,2181,4582
15000US060371911102,779,251,394,385,4583
15000US060371911201,2677,669,1425,1252,4584
15000US060371911202,1997,693,1040,957,4585
15000US060371912011,2133,576,1127,1006,4586
15000US060371912012,2230,1341,346,1884,4587
15000US060371912031,1815,302,976,839,4588
15000US060371912032,781,424,131,650,4589
15000US060371912041,2162,711,1010,1152,4590
15000US060371913011,576,186,283,293,4591
15000US060371913012,1855,234,1107,748,4592
15000US060371913021,2080,490,927,1153,4593
15000US060371913022,310,63,113,197,4594
15000US060371914101,1973,214,1230,743,4595
15000US060371914102,3177,328,2297,880,4596
15000US060371914201,2545,320,1675,870,4597
15000US060371914202,1186,206,832,354,4598
15000US060371915001,996,258,230,766,4599
15000US060371915002,1880,466,801,1079,4600
15000US060371915003,2794,346,2055,739,4601
15000US060371916101,2475,318,1672,803,4602
15000US060371916102,1806,365,1282,524,4603
15000US060371916201,3003,413,2068,935,4604
15000US060371917101,839,354,400,439,4605
15000US060371917102,1988,239,1340,648,4606
15000US060371917201,2108,500,1534,574,4607
15000US060371917202,1561,185,1221,340,4608
15000US060371918101,1787,158,1413,374,4609
15000US060371918102,1234,453,637,597,4610
15000US060371918103,625,185,373,252,4611
15000US060371918201,915,650,175,740,4612
15000US060371918202,1201,179,772,429,4613
15000US060371918203,733,421,231,502,4614
15000US060371919011,1199,768,299,900,4615
15000US060371919012,2122,1103,689,1433,4616
15000US060371919021,1382,924,226,1156,4617
15000US060371919022,1423,1061,193,1230,4618
15000US060371920011,1115,846,65,1050,4619
15000US060371920012,1257,829,136,1121,4620
15000US060371920021,641,515,49,592,4621
15000US060371920022,828,556,63,765,4622
15000US060371920023,1115,781,190,925,4623
15000US060371923001,317,228,8,309,4624
15000US060371923002,780,487,85,695,4625
15000US060371923003,1512,926,307,1205,4626
15000US060371924101,1154,555,157,997,4627
15000US060371924102,1063,144,389,674,4628
15000US060371924103,875,582,95,780,4629
15000US060371924104,950,575,150,800,4630
15000US060371924201,1496,215,770,726,4631
15000US060371924202,2540,180,1402,1138,4632
15000US060371925101,1438,145,466,972,4633
15000US060371925102,2428,73,1719,709,4634
15000US060371925201,2755,228,2139,616,4635
15000US060371925202,2069,155,1521,548,4636
15000US060371926101,1380,67,1161,219,4637
15000US060371926102,697,53,480,217,4638
15000US060371926103,2532,359,1701,831,4639
15000US060371926201,1964,116,1294,670,4640
15000US060371926202,1668,121,978,690,4641
15000US060371927001,3103,262,2008,1095,4642
15000US060371927002,699,225,287,412,4643
15000US060371941011,3166,2498,255,2911,4644
15000US060371941021,1195,861,38,1157,4645
15000US060371941022,1579,1343,120,1459,4646
15000US060371941023,904,782,66,838,4647
15000US060371942001,2534,2161,120,2414,4648
15000US060371942002,1125,885,85,1040,4649
15000US060371943001,1288,940,223,1065,4650
15000US060371943002,910,759,95,815,4651
15000US060371943003,1517,1154,164,1353,4652
15000US060371944011,1472,1069,88,1384,4653
15000US060371944012,1146,804,285,861,4654
15000US060371944021,1224,828,110,1114,4655
15000US060371944022,1008,741,45,963,4656
15000US060371944023,1226,1038,53,1173,4657
15000US060371945001,977,807,41,936,4658
15000US060371945002,916,683,43,873,4659
15000US060371951001,1646,1068,143,1503,4660
15000US060371951002,735,471,98,637,4661
15000US060371951003,1196,582,440,756,4662
15000US060371951004,1386,945,100,1286,4663
15000US060371952011,2235,1326,463,1772,4664
15000US060371952012,929,675,76,853,4665
15000US060371952021,838,614,103,735,4666
15000US060371952022,1026,781,114,912,4667
15000US060371952023,1593,1117,183,1410,4668
15000US060371953001,1281,424,661,620,4669
15000US060371953002,628,287,312,316,4670
15000US060371953003,1649,966,294,1355,4671
15000US060371954001,958,603,222,736,4672
15000US060371954002,1498,710,381,1117,4673
15000US060371954003,1157,952,142,1015,4674
15000US060371954004,930,694,125,805,4675
15000US060371955001,2262,1197,912,1350,4676
15000US060371955002,998,282,543,455,4677
15000US060371955003,955,329,204,751,4678
15000US060371955004,945,374,185,760,4679
15000US060371956001,822,116,661,161,4680
15000US060371956002,1280,185,792,488,4681
15000US060371956003,466,218,165,301,4682
15000US060371956004,736,343,259,477,4683
15000US060371957101,1650,251,1096,554,4684
15000US060371957102,1259,275,795,464,4685
15000US060371957103,1781,242,1407,374,4686
15000US060371957201,1531,357,983,548,4687
15000US060371957202,596,101,421,175,4688
15000US060371958021,1121,155,533,588,4689
15000US060371958022,1644,130,1039,605,4690
15000US060371958031,1508,583,614,894,4691
15000US060371958032,1196,317,719,477,4692
15000US060371958041,1161,220,707,454,4693
15000US060371958042,1209,446,528,681,4694
15000US060371959011,2306,964,987,1319,4695
15000US060371959021,832,539,95,737,4696
15000US060371959022,1069,516,363,706,4697
15000US060371959031,1497,282,640,857,4698
15000US060371959032,848,167,516,332,4699
15000US060371972001,1156,101,807,349,4700
15000US060371972002,1502,214,761,741,4701
15000US060371972003,1215,47,833,382,4702
15000US060371973001,1307,502,506,801,4703
15000US060371973002,993,353,549,444,4704
15000US060371973003,1543,678,418,1125,4705
15000US060371974101,1456,712,432,1024,4706
15000US060371974102,1643,846,472,1171,4707
15000US060371974103,1233,567,517,716,4708
15000US060371974201,1498,334,873,625,4709
15000US060371974202,2008,536,1025,983,4710
15000US060371975001,2221,483,1224,997,4711
15000US060371975002,1214,398,605,609,4712
15000US060371975003,434,184,170,264,4713
15000US060371976001,597,98,221,376,4714
15000US060371976002,1804,513,903,901,4715
15000US060371977001,2292,470,757,1535,4716
15000US060371977002,1032,107,197,835,4717
15000US060371977003,1654,252,492,1162,4718
15000US060371990001,1134,23,937,197,4719
15000US060371990002,2130,169,1290,840,4720
15000US060371990003,2506,102,1587,919,4721
15000US060371991101,1140,147,854,286,4722
15000US060371991102,1381,66,1274,107,4723
15000US060371991201,2687,86,1900,787,4724
15000US060371991202,1705,57,1402,303,4725
15000US060371992011,1431,10,811,620,4726
15000US060371992012,2601,44,1642,959,4727
15000US060371992021,1432,132,1165,267,4728
15000US060371992022,1504,97,1171,333,4729
15000US060371993001,1317,560,641,676,4730
15000US060371993002,2142,348,1402,740,4731
15000US060371994001,1115,50,797,318,4732
15000US060371994002,1665,51,1104,561,4733
15000US060371994003,1605,121,1195,410,4734
15000US060371997001,1628,367,988,640,4735
15000US060371997002,1541,49,1223,318,4736
15000US060371998001,1089,7,495,594,4737
15000US060371998002,1587,9,933,654,4738
15000US060371998003,1196,0,873,323,4739
15000US060371998004,1086,15,912,174,4740
15000US060371999001,1604,28,1395,209,4741
15000US060371999002,1038,24,689,349,4742
15000US060372011101,950,65,848,102,4743
15000US060372011102,741,137,463,278,4744
15000US060372011103,724,9,673,51,4745
15000US060372011201,1979,91,1833,146,4746
15000US060372011202,1221,107,943,278,4747
15000US060372011203,936,51,773,163,4748
15000US060372012001,2592,68,2381,211,4749
15000US060372013011,1389,97,1172,217,4750
15000US060372013012,2279,94,1845,434,4751
15000US060372013021,911,116,491,420,4752
15000US060372013022,963,185,333,630,4753
15000US060372013023,373,52,166,207,4754
15000US060372013024,1769,370,137,1632,4755
15000US060372014011,3277,167,2489,788,4756
15000US060372014012,1802,99,1579,223,4757
15000US060372014021,2400,231,1760,640,4758
15000US060372014022,1401,119,1025,376,4759
15000US060372014023,948,58,684,264,4760
15000US060372015011,1589,119,1408,181,4761
15000US060372015012,947,73,795,152,4762
15000US060372015013,2797,103,2301,496,4763
15000US060372015031,2032,86,1834,198,4764
15000US060372015032,1288,48,1197,91,4765
15000US060372015041,2230,145,1861,369,4766
15000US060372016011,2112,127,1707,405,4767
15000US060372016021,1304,60,1150,154,4768
15000US060372016022,542,81,382,160,4769
15000US060372016023,1028,81,815,213,4770
15000US060372017001,2517,537,1471,1046,4771
15000US060372017002,2249,125,1959,290,4772
15000US060372017003,1240,177,570,670,4773
15000US060372031001,415,0,415,0,4774
15000US060372031002,2180,84,2095,85,4775
15000US060372031003,2089,0,2018,71,4776
15000US060372032001,3654,50,3500,154,4777
15000US060372032002,1255,24,1219,36,4778
15000US060372033001,2082,63,1459,623,4779
15000US060372035001,721,43,489,232,4780
15000US060372035002,1369,74,1138,231,4781
15000US060372035003,1019,27,903,116,4782
15000US060372036001,956,9,924,32,4783
15000US060372036002,1752,16,1736,16,4784
15000US060372036003,2520,44,2423,97,4785
15000US060372037101,1629,6,1609,20,4786
15000US060372037102,1865,25,1796,69,4787
15000US060372037201,2241,0,2199,42,4788
15000US060372037202,926,22,890,36,4789
15000US060372037203,716,12,704,12,4790
15000US060372038001,1468,0,1439,29,4791
15000US060372038002,1064,0,1008,56,4792
15000US060372038003,1509,98,1369,140,4793
15000US060372038004,981,0,981,0,4794
15000US060372039001,1129,0,1129,0,4795
15000US060372039002,850,25,801,49,4796
15000US060372039003,1092,24,1068,24,4797
15000US060372041101,1482,0,1446,36,4798
15000US060372041102,907,1,906,1,4799
15000US060372041103,744,2,734,10,4800
15000US060372041201,1649,85,1563,86,4801
15000US060372041202,1172,26,1146,26,4802
15000US060372042001,1728,108,1590,138,4803
15000US060372042002,1874,0,1839,35,4804
15000US060372043001,549,0,508,41,4805
15000US060372043002,2163,20,2140,23,4806
15000US060372043003,839,0,825,14,4807
15000US060372043004,1433,81,1300,133,4808
15000US060372044101,1129,24,1084,45,4809
15000US060372044102,1161,0,1127,34,4810
15000US060372044201,2111,74,1805,306,4811
15000US060372044202,985,7,970,15,4812
15000US060372046001,2598,46,2490,108,4813
15000US060372046002,1724,32,1655,69,4814
15000US060372047001,2251,35,2155,96,4815
15000US060372047002,1067,65,1002,65,4816
15000US060372047003,1622,99,1512,110,4817
15000US060372048101,2082,0,2004,78,4818
15000US060372048102,1270,0,1270,0,4819
15000US060372048103,1416,58,1348,68,4820
15000US060372048201,1110,0,1110,0,4821
15000US060372048202,1161,25,1136,25,4822
15000US060372049101,3367,151,3200,167,4823
15000US060372049201,2071,25,2040,31,4824
15000US060372049202,626,58,568,58,4825
15000US060372051101,3994,63,3789,205,4826
15000US060372051201,2204,33,2059,145,4827
15000US060372051202,1350,0,1341,9,4828
15000US060372060101,1921,132,637,1284,4829
15000US060372060102,1384,0,1189,195,4830
15000US060372060201,7941,1516,3260,4681,4831
15000US060372060311,2661,1019,170,2491,4832
15000US060372060312,720,437,93,627,4833
15000US060372060321,771,60,643,128,4834
15000US060372060322,1810,89,1461,349,4835
15000US060372060323,2920,156,1814,1106,4836
15000US060372060501,2342,146,1891,451,4837
15000US060372062001,670,134,206,464,4838
15000US060372062002,2665,272,572,2093,4839
15000US060372063001,1768,246,344,1424,4840
15000US060372063002,2173,387,440,1733,4841
15000US060372063003,1617,474,212,1405,4842
15000US060372071011,3630,552,738,2892,4843
15000US060372071021,2366,72,331,2035,4844
15000US060372071031,849,64,150,699,4845
15000US060372071032,1518,84,41,1477,4846
15000US060372073011,849,299,243,606,4847
15000US060372073012,3998,1891,724,3274,4848
15000US060372073021,2769,1534,291,2478,4849
15000US060372073022,1595,528,261,1334,4850
15000US060372074001,1064,156,657,407,4851
15000US060372075011,2263,857,419,1844,4852
15000US060372075021,2610,620,87,2523,4853
15000US060372077101,3587,1335,564,3023,4854
15000US060372079001,1242,541,421,821,4855
15000US060372079002,3455,915,368,3087,4856
15000US060372080001,3130,273,1479,1651,4857
15000US060372080002,3229,245,2248,981,4858
15000US060372080003,889,75,697,192,4859
15000US060372083011,2089,14,1976,113,4860
15000US060372083021,672,71,515,157,4861
15000US060372083022,961,138,715,246,4862
15000US060372083023,2468,33,1919,549,4863
15000US060372084011,2183,49,1800,383,4864
15000US060372084012,2324,38,1654,670,4865
15000US060372084021,1246,49,851,395,4866
15000US060372084022,1662,218,1145,517,4867
15000US060372085011,1090,67,541,549,4868
15000US060372085012,1122,93,417,705,4869
15000US060372085021,1668,133,1281,387,4870
15000US060372085022,1228,8,949,279,4871
15000US060372085023,858,79,463,395,4872
15000US060372086101,1732,64,639,1093,4873
15000US060372086102,2730,51,1394,1336,4874
15000US060372086201,994,22,473,521,4875
15000US060372086202,1912,92,846,1066,4876
15000US060372086203,1563,97,873,690,4877
15000US060372087101,4515,327,1293,3222,4878
15000US060372087201,3261,168,2873,388,4879
15000US060372087202,1315,123,602,713,4880
15000US060372088011,1879,236,995,884,4881
15000US060372088012,1258,50,1050,208,4882
15000US060372088021,2112,224,1205,907,4883
15000US060372088022,1229,143,797,432,4884
15000US060372089021,1704,17,1570,134,4885
15000US060372089022,1093,5,1071,22,4886
15000US060372089031,2422,129,2109,313,4887
15000US060372089032,1880,95,1488,392,4888
15000US060372089041,2140,69,1801,339,4889
15000US060372089042,1654,42,1578,76,4890
15000US060372091021,3180,30,2920,260,4891
15000US060372091022,2101,186,1265,836,4892
15000US060372091031,3513,36,3253,260,4893
15000US060372091041,2499,154,2108,391,4894
15000US060372092001,3584,1019,1459,2125,4895
15000US060372093001,2229,76,1897,332,4896
15000US060372093002,2597,542,1333,1264,4897
15000US060372094011,2221,169,1529,692,4898
15000US060372094012,1838,53,1391,447,4899
15000US060372094021,1784,150,1577,207,4900
15000US060372094022,1909,6,1888,21,4901
15000US060372094031,1574,182,645,929,4902
15000US060372094032,2096,102,1788,308,4903
15000US060372095101,1025,73,671,354,4904
15000US060372095102,1695,59,1111,584,4905
15000US060372095201,1699,37,1508,191,4906
15000US060372095202,875,11,682,193,4907
15000US060372098101,1345,50,968,377,4908
15000US060372098102,1361,175,968,393,4909
15000US060372098201,2096,21,1851,245,4910
15000US060372098202,1212,6,1103,109,4911
15000US060372100101,1176,13,984,192,4912
15000US060372100102,1129,0,1060,69,4913
15000US060372100103,1321,84,1039,282,4914
15000US060372110001,671,441,18,653,4915
15000US060372110002,614,300,0,614,4916
15000US060372110003,659,499,27,632,4917
15000US060372110004,505,351,8,497,4918
15000US060372110005,867,523,132,735,4919
15000US060372110006,1450,452,128,1322,4920
15000US060372111201,1363,111,414,949,4921
15000US060372111202,2339,277,506,1833,4922
15000US060372111203,1571,58,627,944,4923
15000US060372111211,742,106,298,444,4924
15000US060372111212,1549,233,738,811,4925
15000US060372111221,946,219,520,426,4926
15000US060372111222,2220,326,755,1465,4927
15000US060372112011,886,72,634,252,4928
15000US060372112012,1856,76,1400,456,4929
15000US060372112021,2516,196,1565,951,4930
15000US060372113101,1622,28,1108,514,4931
15000US060372113102,2705,84,2075,630,4932
15000US060372113201,1585,86,1042,543,4933
15000US060372113202,1532,197,972,560,4934
15000US060372114101,1983,229,677,1306,4935
15000US060372114102,749,46,128,621,4936
15000US060372114201,2475,264,1451,1024,4937
15000US060372114202,1159,109,325,834,4938
15000US060372115001,1319,352,207,1112,4939
15000US060372115002,2297,429,684,1613,4940
15000US060372115003,882,559,87,795,4941
15000US060372117011,1032,150,1,1031,4942
15000US060372117012,1221,524,9,1212,4943
15000US060372117013,766,117,125,641,4944
15000US060372117031,2917,149,1601,1316,4945
15000US060372117032,2035,314,318,1717,4946
15000US060372117041,1325,233,319,1006,4947
15000US060372117042,1593,200,304,1289,4948
15000US060372118021,2657,377,769,1888,4949
15000US060372118022,1530,255,473,1057,4950
15000US060372118031,1940,80,69,1871,4951
15000US060372118032,2114,95,787,1327,4952
15000US060372118041,880,25,29,851,4953
15000US060372118042,2313,247,509,1804,4954
15000US060372119101,1778,123,1145,633,4955
15000US060372119102,1182,40,767,415,4956
15000US060372119103,1880,136,1126,754,4957
15000US060372119211,2364,210,1025,1339,4958
15000US060372119221,1791,104,765,1026,4959
15000US060372119222,1801,116,1094,707,4960
15000US060372121011,1779,103,690,1089,4961
15000US060372121012,1237,122,178,1059,4962
15000US060372121021,637,195,151,486,4963
15000US060372121022,1687,100,659,1028,4964
15000US060372122021,2624,87,2090,534,4965
15000US060372122022,1090,16,692,398,4966
15000US060372122031,1259,48,997,262,4967
15000US060372122032,1806,30,1305,501,4968
15000US060372122041,1663,86,1072,591,4969
15000US060372122042,1964,17,1682,282,4970
15000US060372123031,3420,168,2602,818,4971
15000US060372123041,1791,249,1221,570,4972
15000US060372123051,3058,95,2311,747,4973
15000US060372123061,1432,47,324,1108,4974
15000US060372123062,1700,31,764,936,4975
15000US060372124101,1527,134,342,1185,4976
15000US060372124102,2666,213,1481,1185,4977
15000US060372124201,1922,7,1105,817,4978
15000US060372124202,1467,85,744,723,4979
15000US060372125011,2149,344,974,1175,4980
15000US060372125021,1415,31,364,1051,4981
15000US060372125022,1556,331,732,824,4982
15000US060372126101,2372,81,485,1887,4983
15000US060372126102,1558,338,711,847,4984
15000US060372126201,2283,118,1162,1121,4985
15000US060372126202,2078,104,779,1299,4986
15000US060372127011,2528,239,819,1709,4987
15000US060372127021,1471,363,247,1224,4988
15000US060372127022,1747,263,300,1447,4989
15000US060372127023,514,67,27,487,4990
15000US060372128001,2005,255,901,1104,4991
15000US060372128002,846,260,312,534,4992
15000US060372128003,1177,67,794,383,4993
15000US060372129001,1718,181,607,1111,4994
15000US060372129002,3209,125,2460,749,4995
15000US060372131001,1676,41,822,854,4996
15000US060372131002,1355,287,232,1123,4997
15000US060372132011,2576,26,1209,1367,4998
15000US060372132012,1383,19,710,673,4999
15000US060372132013,503,24,221,282,5000
15000US060372132021,1592,20,1227,365,5001
15000US060372132022,2320,76,1306,1014,5002
15000US060372133101,1828,11,1202,626,5003
15000US060372133102,1832,16,1388,444,5004
15000US060372133201,1135,8,702,433,5005
15000US060372133202,1149,41,726,423,5006
15000US060372134011,2132,31,1482,650,5007
15000US060372134012,3158,26,2543,615,5008
15000US060372134021,1552,35,1076,476,5009
15000US060372134022,947,62,665,282,5010
15000US060372134023,2029,44,1537,492,5011
15000US060372140001,724,626,28,696,5012
15000US060372140002,1106,942,73,1033,5013
15000US060372140003,963,846,27,936,5014
15000US060372140004,932,747,104,828,5015
15000US060372141001,1032,972,42,990,5016
15000US060372141002,1033,855,113,920,5017
15000US060372141003,576,473,33,543,5018
15000US060372141004,1614,1427,33,1581,5019
15000US060372144001,881,739,37,844,5020
15000US060372144002,1067,746,151,916,5021
15000US060372144003,1004,699,133,871,5022
15000US060372145011,1344,776,102,1242,5023
15000US060372145012,488,416,9,479,5024
15000US060372145013,976,494,31,945,5025
15000US060372145021,2135,960,325,1810,5026
15000US060372145022,1540,1216,134,1406,5027
15000US060372145023,1810,575,77,1733,5028
15000US060372145031,1084,346,102,982,5029
15000US060372145032,1112,533,13,1099,5030
15000US060372145033,554,334,21,533,5031
15000US060372145034,567,225,33,534,5032
15000US060372146001,934,576,104,830,5033
15000US060372146002,732,625,19,713,5034
15000US060372146003,1067,769,207,860,5035
15000US060372147001,1074,821,122,952,5036
15000US060372147002,720,520,54,666,5037
15000US060372147003,835,700,56,779,5038
15000US060372148001,1385,1100,80,1305,5039
15000US060372148002,860,685,87,773,5040
15000US060372148003,741,526,120,621,5041
15000US060372149011,2032,1540,86,1946,5042
15000US060372149012,993,637,165,828,5043
15000US060372149021,1211,799,127,1084,5044
15000US060372149022,1705,1199,86,1619,5045
15000US060372151011,1892,1066,316,1576,5046
15000US060372151012,861,492,96,765,5047
15000US060372151021,1363,784,63,1300,5048
15000US060372151022,1689,1136,246,1443,5049
15000US060372161001,881,539,51,830,5050
15000US060372161002,1206,344,143,1063,5051
15000US060372161003,717,310,95,622,5052
15000US060372162001,588,126,216,372,5053
15000US060372162002,1286,328,148,1138,5054
15000US060372162003,607,354,78,529,5055
15000US060372162004,1370,720,73,1297,5056
15000US060372162005,1518,442,560,958,5057
15000US060372163001,1716,878,120,1596,5058
15000US060372163002,1297,695,25,1272,5059
15000US060372163003,785,412,116,669,5060
15000US060372163004,1024,688,295,729,5061
15000US060372164011,2111,1729,118,1993,5062
15000US060372164012,2315,1729,314,2001,5063
15000US060372164021,1611,1254,198,1413,5064
15000US060372164022,1416,1004,83,1333,5065
15000US060372167001,1451,266,424,1027,5066
15000US060372167002,1209,528,239,970,5067
15000US060372167003,1253,480,220,1033,5068
15000US060372168001,744,492,114,630,5069
15000US060372168002,888,559,164,724,5070
15000US060372168003,867,472,163,704,5071
15000US060372168004,690,554,52,638,5072
15000US060372169001,900,363,15,885,5073
15000US060372169002,617,217,357,260,5074
15000US060372169003,1678,649,524,1154,5075
15000US060372169004,1026,239,384,642,5076
15000US060372169005,714,237,137,577,5077
15000US060372170011,1554,1320,35,1519,5078
15000US060372170012,982,828,28,954,5079
15000US060372170013,626,508,30,596,5080
15000US060372170021,2143,1334,314,1829,5081
15000US060372170022,1340,809,232,1108,5082
15000US060372170023,1632,1010,189,1443,5083
15000US060372171001,1208,334,211,997,5084
15000US060372171002,1797,236,975,822,5085
15000US060372171003,352,132,99,253,5086
15000US060372171004,1298,354,310,988,5087
15000US060372171005,1086,380,235,851,5088
15000US060372172001,1479,411,658,821,5089
15000US060372172002,637,74,325,312,5090
15000US060372172003,1124,289,402,722,5091
15000US060372172004,813,128,79,734,5092
15000US060372181101,2038,102,930,1108,5093
15000US060372181102,1296,83,773,523,5094
15000US060372181201,3432,23,2499,933,5095
15000US060372181202,978,56,627,351,5096
15000US060372181203,798,79,328,470,5097
15000US060372182101,965,0,750,215,5098
15000US060372182102,1788,224,1287,501,5099
15000US060372182103,1320,61,909,411,5100
15000US060372182201,1001,146,39,962,5101
15000US060372182202,2749,254,1785,964,5102
15000US060372182203,916,96,606,310,5103
15000US060372183001,1372,19,822,550,5104
15000US060372183002,883,72,403,480,5105
15000US060372183003,1046,178,318,728,5106
15000US060372183004,1352,274,637,715,5107
15000US060372183005,1202,108,629,573,5108
15000US060372184001,1844,17,1328,516,5109
15000US060372184002,1100,177,631,469,5110
15000US060372184003,699,24,442,257,5111
15000US060372184004,933,106,672,261,5112
15000US060372185001,1427,75,911,516,5113
15000US060372185002,1320,44,582,738,5114
15000US060372186001,1057,60,622,435,5115
15000US060372186002,532,29,325,207,5116
15000US060372186003,1667,87,1031,636,5117
15000US060372187011,1084,24,329,755,5118
15000US060372187012,1294,129,446,848,5119
15000US060372187021,980,0,383,597,5120
15000US060372187022,1338,53,848,490,5121
15000US060372188001,1145,36,597,548,5122
15000US060372188002,1879,75,1131,748,5123
15000US060372189001,2058,202,590,1468,5124
15000US060372189002,1548,58,897,651,5125
15000US060372189003,2032,129,790,1242,5126
15000US060372190101,1357,116,645,712,5127
15000US060372190102,1688,46,1184,504,5128
15000US060372190201,1853,79,1180,673,5129
15000US060372190202,1662,57,993,669,5130
15000US060372190203,987,9,537,450,5131
15000US060372193001,1018,106,420,598,5132
15000US060372193002,1672,50,834,838,5133
15000US060372193003,2049,43,1503,546,5134
15000US060372195001,491,12,49,442,5135
15000US060372195002,1298,51,433,865,5136
15000US060372197001,984,75,527,457,5137
15000US060372197002,1162,8,786,376,5138
15000US060372197003,1953,109,1418,535,5139
15000US060372198001,797,25,511,286,5140
15000US060372198002,1149,40,820,329,5141
15000US060372198003,1109,1,913,196,5142
15000US060372199011,1335,78,974,361,5143
15000US060372199012,1518,33,1229,289,5144
15000US060372199013,1591,96,1274,317,5145
15000US060372199021,1850,122,1327,523,5146
15000US060372199022,1074,0,639,435,5147
15000US060372199023,977,128,665,312,5148
15000US060372200001,1765,70,792,973,5149
15000US060372200002,1049,63,444,605,5150
15000US060372200003,982,36,596,386,5151
15000US060372200004,525,128,183,342,5152
15000US060372200005,991,113,539,452,5153
15000US060372201001,787,43,368,419,5154
15000US060372201002,823,0,74,749,5155
15000US060372201003,765,154,248,517,5156
15000US060372211101,1019,65,925,94,5157
15000US060372211102,2640,23,2285,355,5158
15000US060372211201,1452,16,1403,49,5159
15000US060372211202,1801,22,1706,95,5160
15000US060372212101,1121,65,922,199,5161
15000US060372212102,1943,120,1452,491,5162
15000US060372212201,1255,44,1126,129,5163
15000US060372212202,2281,0,1994,287,5164
15000US060372213021,2583,113,2065,518,5165
15000US060372213022,2646,228,1791,855,5166
15000US060372213031,1560,77,1248,312,5167
15000US060372213032,1150,111,730,420,5168
15000US060372213041,2261,55,1616,645,5169
15000US060372213042,1693,31,1016,677,5170
15000US060372214011,1400,57,658,742,5171
15000US060372214012,2053,159,789,1264,5172
15000US060372214021,1670,59,986,684,5173
15000US060372214022,1070,157,496,574,5174
15000US060372215001,2567,49,1442,1125,5175
15000US060372215002,1444,8,1019,425,5176
15000US060372216011,1746,31,1401,345,5177
15000US060372216012,1591,148,1148,443,5178
15000US060372216021,1494,14,1363,131,5179
15000US060372216022,570,34,454,116,5180
15000US060372216023,801,0,719,82,5181
15000US060372217101,1669,93,1186,483,5182
15000US060372217102,954,118,513,441,5183
15000US060372218101,1237,48,885,352,5184
15000US060372218102,1430,470,224,1206,5185
15000US060372218201,941,368,218,723,5186
15000US060372218202,1969,501,96,1873,5187
15000US060372219001,2444,760,264,2180,5188
15000US060372219002,1099,10,808,291,5189
15000US060372220011,1670,129,1113,557,5190
15000US060372220012,1398,169,857,541,5191
15000US060372220021,1078,15,836,242,5192
15000US060372220022,1328,0,1106,222,5193
15000US060372220023,975,23,696,279,5194
15000US060372220024,1501,0,905,596,5195
15000US060372221001,1730,180,1058,672,5196
15000US060372221002,1574,20,980,594,5197
15000US060372221003,448,12,238,210,5198
15000US060372222001,2099,98,1483,616,5199
15000US060372222002,1666,79,1158,508,5200
15000US060372225001,1472,12,721,751,5201
15000US060372225002,2189,61,1517,672,5202
15000US060372225003,1614,9,1214,400,5203
15000US060372226001,1685,104,781,904,5204
15000US060372226002,2484,297,960,1524,5205
15000US060372226003,1327,50,957,370,5206
15000US060372227001,4056,1744,423,3633,5207
15000US060372240101,1152,89,839,313,5208
15000US060372240102,1319,182,627,692,5209
15000US060372240201,938,84,646,292,5210
15000US060372240202,1591,36,1524,67,5211
15000US060372242001,1680,41,1582,98,5212
15000US060372242002,819,52,716,103,5213
15000US060372243101,1292,46,1154,138,5214
15000US060372243102,825,12,723,102,5215
15000US060372243201,2057,82,1799,258,5216
15000US060372243202,1397,10,1281,116,5217
15000US060372244101,1565,496,518,1047,5218
15000US060372244102,1717,108,1247,470,5219
15000US060372244201,1828,54,1694,134,5220
15000US060372244202,581,89,275,306,5221
15000US060372246001,1951,14,1910,41,5222
15000US060372246002,1245,93,977,268,5223
15000US060372247001,2886,1486,298,2588,5224
15000US060372247002,2838,1197,509,2329,5225
15000US060372247003,817,379,224,593,5226
15000US060372260011,1643,0,1556,87,5227
15000US060372260012,742,0,660,82,5228
15000US060372260021,1475,408,837,638,5229
15000US060372260022,286,44,106,180,5230
15000US060372264101,2474,7,2440,34,5231
15000US060372264102,1157,0,1109,48,5232
15000US060372264201,1902,0,1826,76,5233
15000US060372264202,1523,0,1351,172,5234
15000US060372264203,1971,33,1674,297,5235
15000US060372267001,2270,0,2187,83,5236
15000US060372267002,1826,0,1789,37,5237
15000US060372267003,1714,0,1714,0,5238
15000US060372267004,966,0,932,34,5239
15000US060372270101,3390,0,3048,342,5240
15000US060372270102,1403,0,1403,0,5241
15000US060372270201,1961,0,1750,211,5242
15000US060372270202,1578,10,1518,60,5243
15000US060372281001,881,0,829,52,5244
15000US060372281002,2748,17,2262,486,5245
15000US060372281003,1430,0,1421,9,5246
15000US060372282101,1693,15,1367,326,5247
15000US060372282102,2270,0,2121,149,5248
15000US060372282201,1046,37,797,249,5249
15000US060372282202,1459,0,1255,204,5250
15000US060372282203,1795,5,1563,232,5251
15000US060372283101,940,0,779,161,5252
15000US060372283102,1412,6,1341,71,5253
15000US060372283103,1652,0,1640,12,5254
15000US060372283104,512,0,508,4,5255
15000US060372283201,652,0,652,0,5256
15000US060372283202,1517,0,1479,38,5257
15000US060372283203,924,0,770,154,5258
15000US060372284101,813,0,813,0,5259
15000US060372284102,785,45,708,77,5260
15000US060372284103,1832,0,1799,33,5261
15000US060372284201,753,0,696,57,5262
15000US060372284202,2649,36,2454,195,5263
15000US060372285001,1628,0,1209,419,5264
15000US060372285002,1966,0,1628,338,5265
15000US060372285003,987,0,827,160,5266
15000US060372286001,2943,102,2610,333,5267
15000US060372286002,2052,0,1835,217,5268
15000US060372287101,2241,0,1921,320,5269
15000US060372287102,1389,10,1172,217,5270
15000US060372287201,1086,0,984,102,5271
15000US060372287202,1823,23,1610,213,5272
15000US060372287203,1595,17,1429,166,5273
15000US060372288001,706,0,670,36,5274
15000US060372288002,610,0,492,118,5275
15000US060372288003,1892,0,1745,147,5276
15000US060372288004,2148,17,1871,277,5277
15000US060372289001,1621,0,1454,167,5278
15000US060372289002,1011,0,877,134,5279
15000US060372291001,3055,9,2912,143,5280
15000US060372291002,1837,30,1610,227,5281
15000US060372292001,1364,0,955,409,5282
15000US060372292002,3050,1,2662,388,5283
15000US060372293001,2337,24,2125,212,5284
15000US060372293002,1788,0,1616,172,5285
15000US060372293003,1671,0,1410,261,5286
15000US060372294101,2007,29,1786,221,5287
15000US060372294102,1433,13,1281,152,5288
15000US060372294201,2618,0,2324,294,5289
15000US060372294202,2168,19,1934,234,5290
15000US060372311001,1083,145,569,514,5291
15000US060372311002,1239,61,745,494,5292
15000US060372311003,1194,16,905,289,5293
15000US060372312101,1405,7,1155,250,5294
15000US060372312102,2104,0,1530,574,5295
15000US060372312201,2443,15,1820,623,5296
15000US060372312202,1929,228,1415,514,5297
15000US060372313001,2564,1,1796,768,5298
15000US060372313002,962,31,590,372,5299
15000US060372313003,969,36,588,381,5300
15000US060372313004,647,32,510,137,5301
15000US060372314001,1535,35,1141,394,5302
15000US060372314002,1894,8,1468,426,5303
15000US060372314003,1769,0,1359,410,5304
15000US060372315001,1556,0,660,896,5305
15000US060372315002,2152,11,1200,952,5306
15000US060372315003,1284,0,845,439,5307
15000US060372316001,779,85,450,329,5308
15000US060372316002,1411,80,924,487,5309
15000US060372316003,1370,15,894,476,5310
15000US060372316004,1613,9,743,870,5311
15000US060372316005,1784,0,1348,436,5312
15000US060372317101,752,14,693,59,5313
15000US060372317102,1374,0,1094,280,5314
15000US060372317103,1955,3,1460,495,5315
15000US060372317201,3043,68,2410,633,5316
15000US060372317202,494,0,398,96,5317
15000US060372317203,1252,40,905,347,5318
15000US060372318001,1176,0,1060,116,5319
15000US060372318002,2732,17,2432,300,5320
15000US060372318003,1036,0,954,82,5321
15000US060372319001,2189,7,1930,259,5322
15000US060372319002,3265,88,2762,503,5323
15000US060372321101,1414,4,1152,262,5324
15000US060372321102,1426,29,980,446,5325
15000US060372321201,1518,0,1051,467,5326
15000US060372321202,1586,20,1255,331,5327
15000US060372321203,2611,10,2203,408,5328
15000US060372322001,565,0,388,177,5329
15000US060372322002,1054,13,686,368,5330
15000US060372322003,1306,37,672,634,5331
15000US060372323001,2180,4,1796,384,5332
15000US060372323002,1008,29,614,394,5333
15000US060372323003,1149,0,747,402,5334
15000US060372324001,1094,6,658,436,5335
15000US060372324002,1412,2,938,474,5336
15000US060372324003,1344,7,463,881,5337
15000US060372324004,2047,0,1018,1029,5338
15000US060372324005,1383,78,862,521,5339
15000US060372325001,1864,0,1580,284,5340
15000US060372325002,1000,0,481,519,5341
15000US060372325003,1170,0,765,405,5342
15000US060372325004,728,0,572,156,5343
15000US060372326001,2120,28,1617,503,5344
15000US060372326002,1970,29,1358,612,5345
15000US060372326003,1983,0,1378,605,5346
15000US060372327001,2845,0,2181,664,5347
15000US060372327002,2048,48,1544,504,5348
15000US060372327003,1075,7,713,362,5349
15000US060372328001,1428,7,1162,266,5350
15000US060372328002,2503,36,2159,344,5351
15000US060372340001,2247,6,1084,1163,5352
15000US060372340002,583,50,49,534,5353
15000US060372340003,536,27,7,529,5354
15000US060372340004,1079,118,242,837,5355
15000US060372340005,888,0,524,364,5356
15000US060372342001,643,36,30,613,5357
15000US060372342002,682,24,0,682,5358
15000US060372342003,912,105,104,808,5359
15000US060372343001,1423,73,142,1281,5360
15000US060372343002,1002,0,0,1002,5361
15000US060372343003,928,46,155,773,5362
15000US060372343004,866,4,11,855,5363
15000US060372345011,1502,36,725,777,5364
15000US060372345012,1094,77,244,850,5365
15000US060372345021,910,0,442,468,5366
15000US060372345022,656,15,230,426,5367
15000US060372345023,1155,22,226,929,5368
15000US060372346001,1268,0,650,618,5369
15000US060372346002,757,0,279,478,5370
15000US060372346003,1374,157,548,826,5371
15000US060372346004,1652,54,383,1269,5372
15000US060372347001,1033,90,609,424,5373
15000US060372347002,772,0,390,382,5374
15000US060372347003,1231,14,675,556,5375
15000US060372347004,720,3,252,468,5376
15000US060372348001,796,11,444,352,5377
15000US060372348002,735,11,165,570,5378
15000US060372348003,863,1,405,458,5379
15000US060372348004,723,32,345,378,5380
15000US060372349011,849,5,569,280,5381
15000US060372349012,1650,0,819,831,5382
15000US060372349021,1042,16,511,531,5383
15000US060372349022,1244,22,599,645,5384
15000US060372349023,1589,7,771,818,5385
15000US060372351001,1234,29,386,848,5386
15000US060372351002,1190,34,223,967,5387
15000US060372351003,1167,119,68,1099,5388
15000US060372351004,1096,32,59,1037,5389
15000US060372352011,792,26,289,503,5390
15000US060372352012,789,20,76,713,5391
15000US060372352013,1096,0,461,635,5392
15000US060372352021,2440,16,1213,1227,5393
15000US060372352022,1145,15,352,793,5394
15000US060372352023,803,63,53,750,5395
15000US060372360001,1929,508,344,1585,5396
15000US060372360002,1172,52,266,906,5397
15000US060372360003,555,114,226,329,5398
15000US060372360004,971,191,48,923,5399
15000US060372361001,466,15,83,383,5400
15000US060372361002,1093,56,321,772,5401
15000US060372361003,1972,46,220,1752,5402
15000US060372361004,1571,17,625,946,5403
15000US060372361005,550,51,100,450,5404
15000US060372362021,2070,18,1367,703,5405
15000US060372362022,2076,55,873,1203,5406
15000US060372362023,1437,116,429,1008,5407
15000US060372362031,2386,62,626,1760,5408
15000US060372362032,1013,9,296,717,5409
15000US060372362041,1956,86,823,1133,5410
15000US060372362042,1131,22,305,826,5411
15000US060372364001,1107,48,118,989,5412
15000US060372364002,1834,115,199,1635,5413
15000US060372364003,1352,70,55,1297,5414
15000US060372371011,565,0,445,120,5415
15000US060372371012,992,0,729,263,5416
15000US060372371013,301,0,249,52,5417
15000US060372371014,798,0,708,90,5418
15000US060372371015,997,5,625,372,5419
15000US060372371021,1318,0,1080,238,5420
15000US060372371022,1921,9,1538,383,5421
15000US060372372011,1057,0,803,254,5422
15000US060372372012,1801,6,1360,441,5423
15000US060372372013,714,5,300,414,5424
15000US060372372021,1419,25,1142,277,5425
15000US060372372022,764,0,386,378,5426
15000US060372372023,1433,0,958,475,5427
15000US060372372024,1098,76,636,462,5428
15000US060372373001,1013,29,136,877,5429
15000US060372373002,1168,10,560,608,5430
15000US060372373003,1382,6,535,847,5431
15000US060372373004,1082,0,212,870,5432
15000US060372373005,581,80,186,395,5433
15000US060372374011,1139,0,971,168,5434
15000US060372374012,1378,0,948,430,5435
15000US060372374013,1220,33,751,469,5436
15000US060372374021,1043,10,538,505,5437
15000US060372374022,933,11,631,302,5438
15000US060372374023,1054,0,767,287,5439
15000US060372375001,1737,15,1384,353,5440
15000US060372375002,979,5,642,337,5441
15000US060372376001,1232,14,1051,181,5442
15000US060372376002,990,0,714,276,5443
15000US060372376003,762,5,415,347,5444
15000US060372376004,714,0,502,212,5445
15000US060372377101,1538,0,1065,473,5446
15000US060372377102,1743,8,1236,507,5447
15000US060372377201,746,3,519,227,5448
15000US060372377202,2388,0,1966,422,5449
15000US060372378001,1025,12,342,683,5450
15000US060372378002,1125,9,569,556,5451
15000US060372378003,515,0,134,381,5452
15000US060372378004,859,33,206,653,5453
15000US060372379001,737,0,46,691,5454
15000US060372379002,1217,10,238,979,5455
15000US060372379003,1156,8,290,866,5456
15000US060372379004,946,0,274,672,5457
15000US060372380001,603,0,307,296,5458
15000US060372380002,452,0,198,254,5459
15000US060372380003,737,11,239,498,5460
15000US060372380004,1291,0,125,1166,5461
15000US060372380005,790,17,87,703,5462
15000US060372380006,1519,20,309,1210,5463
15000US060372381001,1236,14,289,947,5464
15000US060372381002,1576,12,385,1191,5465
15000US060372381003,693,0,152,541,5466
15000US060372381004,1005,46,227,778,5467
15000US060372382001,1434,6,0,1434,5468
15000US060372382002,1356,0,198,1158,5469
15000US060372382003,1081,19,186,895,5470
15000US060372382004,1723,62,289,1434,5471
15000US060372383101,2619,34,2215,404,5472
15000US060372383102,2308,42,1411,897,5473
15000US060372383201,2333,11,1740,593,5474
15000US060372383202,971,0,591,380,5475
15000US060372383203,829,0,564,265,5476
15000US060372384001,1185,31,309,876,5477
15000US060372384002,1355,13,347,1008,5478
15000US060372384003,1391,0,37,1354,5479
15000US060372384004,1403,0,151,1252,5480
15000US060372392011,1723,0,1164,559,5481
15000US060372392012,1318,15,1114,204,5482
15000US060372392013,767,0,586,181,5483
15000US060372392021,2793,6,2339,454,5484
15000US060372392022,1160,0,1015,145,5485
15000US060372392023,1394,7,1131,263,5486
15000US060372393101,1168,0,1103,65,5487
15000US060372393102,2029,102,1724,305,5488
15000US060372393103,1015,2,909,106,5489
15000US060372393201,2319,14,1895,424,5490
15000US060372393202,1936,15,1713,223,5491
15000US060372393301,1776,0,1481,295,5492
15000US060372393302,1372,0,1206,166,5493
15000US060372395011,1231,13,883,348,5494
15000US060372395012,945,19,786,159,5495
15000US060372395013,1423,44,1133,290,5496
15000US060372395021,1234,2,1144,90,5497
15000US060372395022,1295,0,1227,68,5498
15000US060372395023,1275,0,982,293,5499
15000US060372396011,1429,14,1072,357,5500
15000US060372396012,2215,12,1767,448,5501
15000US060372396021,1743,12,1508,235,5502
15000US060372396022,1843,20,1359,484,5503
15000US060372397011,2835,0,2242,593,5504
15000US060372397012,1933,5,1589,344,5505
15000US060372397021,1235,0,802,433,5506
15000US060372397022,681,0,521,160,5507
15000US060372397023,1046,0,738,308,5508
15000US060372397024,715,6,363,352,5509
15000US060372398011,689,6,616,73,5510
15000US060372398012,1766,0,1508,258,5511
15000US060372398013,1069,0,848,221,5512
15000US060372398021,1067,0,532,535,5513
15000US060372398022,1253,0,796,457,5514
15000US060372398023,1525,33,1210,315,5515
15000US060372398024,1257,0,1014,243,5516
15000US060372400101,959,0,831,128,5517
15000US060372400102,905,0,531,374,5518
15000US060372400103,1761,0,1360,401,5519
15000US060372400201,1973,11,1543,430,5520
15000US060372400202,1636,8,1019,617,5521
15000US060372400203,1843,0,1501,342,5522
15000US060372402001,686,0,347,339,5523
15000US060372402002,2235,30,1630,605,5524
15000US060372402003,2338,15,1768,570,5525
15000US060372403001,1376,12,1075,301,5526
15000US060372403002,1436,102,1059,377,5527
15000US060372403003,1474,34,1043,431,5528
15000US060372403004,585,0,464,121,5529
15000US060372404011,1783,0,1236,547,5530
15000US060372404012,2007,0,1444,563,5531
15000US060372404013,1772,0,1380,392,5532
15000US060372404021,1405,0,905,500,5533
15000US060372404022,1297,0,840,457,5534
15000US060372404023,1212,2,858,354,5535
15000US060372405001,1768,0,1164,604,5536
15000US060372405002,1959,0,1636,323,5537
15000US060372405003,1182,12,862,320,5538
15000US060372405004,1600,0,870,730,5539
15000US060372406001,1458,0,1160,298,5540
15000US060372406002,1432,53,1114,318,5541
15000US060372406003,1416,0,925,491,5542
15000US060372406004,1379,8,953,426,5543
15000US060372407001,973,82,475,498,5544
15000US060372407002,1001,7,721,280,5545
15000US060372407003,2010,28,1572,438,5546
15000US060372407004,1137,33,810,327,5547
15000US060372407005,1061,0,503,558,5548
15000US060372408001,1473,73,812,661,5549
15000US060372408002,1580,16,1075,505,5550
15000US060372408003,1572,0,1164,408,5551
15000US060372409001,787,0,347,440,5552
15000US060372409002,1431,26,1134,297,5553
15000US060372409003,1288,0,1008,280,5554
15000US060372409004,1106,0,806,300,5555
15000US060372409005,1133,7,803,330,5556
15000US060372410011,1908,0,1160,748,5557
15000US060372410012,1054,0,774,280,5558
15000US060372410013,1618,18,758,860,5559
15000US060372410021,1366,0,963,403,5560
15000US060372410022,1136,0,489,647,5561
15000US060372410023,1412,5,925,487,5562
15000US060372411101,2019,10,1192,827,5563
15000US060372411102,1133,12,857,276,5564
15000US060372411201,1547,0,1302,245,5565
15000US060372411202,1747,16,920,827,5566
15000US060372411203,866,0,424,442,5567
15000US060372411204,922,13,704,218,5568
15000US060372412011,1040,0,547,493,5569
15000US060372412012,987,0,546,441,5570
15000US060372412013,857,0,667,190,5571
15000US060372412021,1423,20,727,696,5572
15000US060372412022,773,0,467,306,5573
15000US060372412023,787,0,558,229,5574
15000US060372412024,877,0,466,411,5575
15000US060372412025,947,17,624,323,5576
15000US060372413001,845,50,474,371,5577
15000US060372413002,1265,7,611,654,5578
15000US060372414001,1709,0,1226,483,5579
15000US060372414002,1668,17,1356,312,5580
15000US060372420001,1524,14,677,847,5581
15000US060372420002,1958,0,1400,558,5582
15000US060372420003,677,31,591,86,5583
15000US060372421001,2911,0,2143,768,5584
15000US060372422001,1535,0,1505,30,5585
15000US060372422002,714,0,563,151,5586
15000US060372422003,2187,5,1602,585,5587
15000US060372422004,1930,0,1473,457,5588
15000US060372423001,2081,0,1543,538,5589
15000US060372423002,1023,0,1023,0,5590
15000US060372423003,1473,108,880,593,5591
15000US060372426001,1328,0,894,434,5592
15000US060372426002,2289,5,1501,788,5593
15000US060372426003,1363,0,858,505,5594
15000US060372427001,1015,0,652,363,5595
15000US060372427002,525,0,445,80,5596
15000US060372427003,1391,0,1202,189,5597
15000US060372427004,2402,5,1815,587,5598
15000US060372427005,636,0,234,402,5599
15000US060372430001,1534,0,1239,295,5600
15000US060372430002,2208,1,1613,595,5601
15000US060372430003,1730,21,1370,360,5602
15000US060372430004,1675,0,1487,188,5603
15000US060372431001,3313,118,2273,1040,5604
15000US060372431002,1847,0,1260,587,5605
15000US060372431003,1299,0,1092,207,5606
15000US060372611011,1975,1621,134,1841,5607
15000US060372611012,1810,1603,57,1753,5608
15000US060372611021,520,392,64,456,5609
15000US060372611022,3449,2842,205,3244,5610
15000US060372612001,2607,2136,202,2405,5611
15000US060372612002,1533,1221,75,1458,5612
15000US060372621001,506,355,43,463,5613
15000US060372621002,573,412,41,532,5614
15000US060372621003,1880,1526,94,1786,5615
15000US060372622001,3880,2735,349,3531,5616
15000US060372622002,976,805,69,907,5617
15000US060372623011,3048,2263,285,2763,5618
15000US060372623021,1625,1320,150,1475,5619
15000US060372623022,1415,1189,55,1360,5620
15000US060372623031,1324,1176,75,1249,5621
15000US060372623032,826,765,25,801,5622
15000US060372623033,844,693,0,844,5623
15000US060372624001,915,881,3,912,5624
15000US060372624002,2034,1572,112,1922,5625
15000US060372625011,1291,1135,9,1282,5626
15000US060372625012,822,762,36,786,5627
15000US060372625013,2009,1802,124,1885,5628
15000US060372626011,3497,2679,238,3259,5629
15000US060372626041,567,480,25,542,5630
15000US060372626042,1453,1051,48,1405,5631
15000US060372626043,1196,1146,14,1182,5632
15000US060372626044,3261,2695,25,3236,5633
15000US060372627041,3427,2727,303,3124,5634
15000US060372627061,1706,1415,99,1607,5635
15000US060372627062,1163,1035,116,1047,5636
15000US060372627063,861,651,22,839,5637
15000US060372628021,1375,1262,23,1352,5638
15000US060372628022,587,479,65,522,5639
15000US060372628023,1491,1163,170,1321,5640
15000US060372640001,498,458,28,470,5641
15000US060372640002,1090,973,69,1021,5642
15000US060372640003,1414,1318,19,1395,5643
15000US060372641021,2630,2118,206,2424,5644
15000US060372641031,2750,2165,135,2615,5645
15000US060372643011,1078,889,98,980,5646
15000US060372643012,1901,1536,140,1761,5647
15000US060372643013,2158,1529,127,2031,5648
15000US060372643021,1871,1680,41,1830,5649
15000US060372643022,2099,1375,248,1851,5650
15000US060372643023,1408,1213,0,1408,5651
15000US060372651001,1324,1129,47,1277,5652
15000US060372651002,1278,1207,35,1243,5653
15000US060372652011,2115,1610,125,1990,5654
15000US060372652012,715,413,44,671,5655
15000US060372652021,600,336,72,528,5656
15000US060372652022,563,245,252,311,5657
15000US060372652023,621,403,41,580,5658
15000US060372652024,1906,1463,66,1840,5659
15000US060372653011,10384,2720,2220,8164,5660
15000US060372653031,1826,738,243,1583,5661
15000US060372653032,2912,1037,615,2297,5662
15000US060372653041,1921,754,322,1599,5663
15000US060372653042,1191,619,140,1051,5664
15000US060372653051,4069,1997,370,3699,5665
15000US060372654101,711,553,5,706,5666
15000US060372654102,824,572,62,762,5667
15000US060372654201,789,689,35,754,5668
15000US060372654202,1171,713,20,1151,5669
15000US060372655101,3176,1637,202,2974,5670
15000US060372655102,1156,495,116,1040,5671
15000US060372655201,866,657,75,791,5672
15000US060372655202,854,610,0,854,5673
15000US060372655203,2926,1809,118,2808,5674
15000US060372656011,1279,1071,18,1261,5675
15000US060372656012,1973,1311,63,1910,5676
15000US060372656021,893,717,128,765,5677
15000US060372656022,2011,1496,21,1990,5678
15000US060372657001,2272,1826,101,2171,5679
15000US060372657002,1698,1378,40,1658,5680
15000US060372657003,1410,705,96,1314,5681
15000US060372671001,2689,1599,234,2455,5682
15000US060372671002,889,658,33,856,5683
15000US060372671003,2657,1406,622,2035,5684
15000US060372671004,717,636,15,702,5685
15000US060372672001,3063,2070,153,2910,5686
15000US060372672002,1694,1254,126,1568,5687
15000US060372672003,899,550,100,799,5688
15000US060372673001,1271,578,283,988,5689
15000US060372673002,3169,1674,435,2734,5690
15000US060372674021,1835,1143,363,1472,5691
15000US060372674022,2955,1721,369,2586,5692
15000US060372674031,2165,995,337,1828,5693
15000US060372674032,997,624,73,924,5694
15000US060372674041,3099,1963,420,2679,5695
15000US060372675011,2323,727,900,1423,5696
15000US060372675012,2491,668,1265,1226,5697
15000US060372675013,1968,874,632,1336,5698
15000US060372675021,1505,1097,124,1381,5699
15000US060372675022,2009,749,665,1344,5700
15000US060372676001,1099,609,148,951,5701
15000US060372676002,767,318,266,501,5702
15000US060372676003,1097,318,495,602,5703
15000US060372677001,1739,605,533,1206,5704
15000US060372677002,1575,663,240,1335,5705
15000US060372678001,744,460,10,734,5706
15000US060372678002,897,429,82,815,5707
15000US060372678003,1434,1145,161,1273,5708
15000US060372679011,1440,1025,0,1440,5709
15000US060372679012,915,776,39,876,5710
15000US060372679021,1098,917,11,1087,5711
15000US060372679022,1545,1198,56,1489,5712
15000US060372679023,953,671,49,904,5713
15000US060372690001,606,493,33,573,5714
15000US060372690002,1001,754,135,866,5715
15000US060372690003,907,636,171,736,5716
15000US060372690004,2220,1763,130,2090,5717
15000US060372690005,860,651,121,739,5718
15000US060372691001,1241,924,102,1139,5719
15000US060372691002,495,460,17,478,5720
15000US060372691003,692,657,35,657,5721
15000US060372691004,1584,1233,51,1533,5722
15000US060372693001,794,682,0,794,5723
15000US060372693002,846,719,116,730,5724
15000US060372693003,808,585,0,808,5725
15000US060372693004,962,742,68,894,5726
15000US060372693005,760,696,24,736,5727
15000US060372695001,694,528,52,642,5728
15000US060372695002,947,692,0,947,5729
15000US060372695003,1300,1089,34,1266,5730
15000US060372695004,1274,1242,8,1266,5731
15000US060372696011,896,110,519,377,5732
15000US060372696012,728,104,509,219,5733
15000US060372696013,1626,285,850,776,5734
15000US060372696021,1725,433,723,1002,5735
15000US060372696022,1060,480,420,640,5736
15000US060372697001,1329,308,650,679,5737
15000US060372697002,1141,307,407,734,5738
15000US060372697003,675,365,210,465,5739
15000US060372697004,711,321,151,560,5740
15000US060372698001,1168,537,272,896,5741
15000US060372698002,2095,1018,380,1715,5742
15000US060372699031,3782,1518,903,2879,5743
15000US060372699041,538,155,85,453,5744
15000US060372699042,2149,1034,281,1868,5745
15000US060372699043,1183,570,349,834,5746
15000US060372699051,406,221,31,375,5747
15000US060372699052,2334,580,1012,1322,5748
15000US060372699061,3007,1291,570,2437,5749
15000US060372699071,2970,1084,903,2067,5750
15000US060372701001,2113,636,423,1690,5751
15000US060372701002,599,388,150,449,5752
15000US060372701003,1898,882,225,1673,5753
15000US060372702001,1189,206,587,602,5754
15000US060372702002,868,303,427,441,5755
15000US060372702003,1519,225,1137,382,5756
15000US060372703001,476,100,194,282,5757
15000US060372703002,963,182,291,672,5758
15000US060372703003,1103,92,526,577,5759
15000US060372711001,757,404,87,670,5760
15000US060372711002,1030,505,263,767,5761
15000US060372711003,784,293,180,604,5762
15000US060372712001,1581,689,346,1235,5763
15000US060372712002,1091,316,483,608,5764
15000US060372713001,658,175,177,481,5765
15000US060372713002,1200,780,160,1040,5766
15000US060372713003,1468,902,259,1209,5767
15000US060372713004,608,407,48,560,5768
15000US060372713005,884,367,86,798,5769
15000US060372714001,450,353,19,431,5770
15000US060372714002,1168,649,166,1002,5771
15000US060372714003,1968,1559,259,1709,5772
15000US060372715001,949,545,198,751,5773
15000US060372715002,580,336,63,517,5774
15000US060372715003,1629,1126,259,1370,5775
15000US060372716001,1311,362,138,1173,5776
15000US060372716002,916,759,10,906,5777
15000US060372716003,691,458,0,691,5778
15000US060372716004,1705,551,271,1434,5779
15000US060372717011,1113,682,103,1010,5780
15000US060372717012,770,494,103,667,5781
15000US060372717013,2208,983,245,1963,5782
15000US060372717014,1883,888,551,1332,5783
15000US060372717021,1419,647,183,1236,5784
15000US060372717022,955,245,290,665,5785
15000US060372717023,2016,595,229,1787,5786
15000US060372718011,1108,475,423,685,5787
15000US060372718012,1893,459,339,1554,5788
15000US060372718013,452,130,203,249,5789
15000US060372718021,1165,604,130,1035,5790
15000US060372718022,2982,1186,805,2177,5791
15000US060372718023,1850,475,762,1088,5792
15000US060372719011,861,389,214,647,5793
15000US060372719012,1404,903,112,1292,5794
15000US060372719013,1104,315,732,372,5795
15000US060372719021,606,513,46,560,5796
15000US060372719022,1117,714,196,921,5797
15000US060372719023,2542,1096,839,1703,5798
15000US060372721001,1293,696,283,1010,5799
15000US060372721002,719,528,147,572,5800
15000US060372721003,695,317,247,448,5801
15000US060372721004,1026,815,127,899,5802
15000US060372721005,771,375,251,520,5803
15000US060372722011,1505,550,687,818,5804
15000US060372722012,1190,435,523,667,5805
15000US060372722021,1104,691,216,888,5806
15000US060372722022,2669,1008,1198,1471,5807
15000US060372723011,1069,433,439,630,5808
15000US060372723012,1237,593,323,914,5809
15000US060372723013,855,415,183,672,5810
15000US060372723021,2483,740,1422,1061,5811
15000US060372723022,1932,699,913,1019,5812
15000US060372731001,610,384,172,438,5813
15000US060372731002,1008,789,104,904,5814
15000US060372731003,855,577,243,612,5815
15000US060372732001,733,441,175,558,5816
15000US060372732002,1307,397,785,522,5817
15000US060372732003,600,386,100,500,5818
15000US060372732004,958,527,290,668,5819
15000US060372733001,1589,823,596,993,5820
15000US060372733002,871,321,156,715,5821
15000US060372733003,744,501,135,609,5822
15000US060372734021,414,309,71,343,5823
15000US060372734022,868,662,110,758,5824
15000US060372734023,617,484,26,591,5825
15000US060372734024,829,672,77,752,5826
15000US060372735021,511,412,28,483,5827
15000US060372735022,256,195,38,218,5828
15000US060372735023,1207,854,114,1093,5829
15000US060372735024,940,765,79,861,5830
15000US060372736001,397,260,124,273,5831
15000US060372736002,405,367,28,377,5832
15000US060372736003,373,236,30,343,5833
15000US060372736004,1159,924,93,1066,5834
15000US060372737001,1095,703,272,823,5835
15000US060372737002,906,581,143,763,5836
15000US060372737003,827,547,203,624,5837
15000US060372738001,1667,958,308,1359,5838
15000US060372738002,982,763,61,921,5839
15000US060372738003,600,413,109,491,5840
15000US060372739021,1120,704,385,735,5841
15000US060372739022,733,562,141,592,5842
15000US060372739023,676,575,0,676,5843
15000US060372739024,884,778,40,844,5844
15000US060372739025,426,405,13,413,5845
15000US060372741001,3364,2108,301,3063,5846
15000US060372741002,880,679,166,714,5847
15000US060372742021,1612,1277,126,1486,5848
15000US060372742022,1133,880,90,1043,5849
15000US060372742023,778,762,0,778,5850
15000US060372742024,971,843,53,918,5851
15000US060372751011,1235,474,371,864,5852
15000US060372751021,3206,537,2331,875,5853
15000US060372751022,804,328,293,511,5854
15000US060372752001,1192,370,598,594,5855
15000US060372752002,1488,357,807,681,5856
15000US060372752003,1317,298,726,591,5857
15000US060372753021,1243,530,417,826,5858
15000US060372753022,2250,1464,201,2049,5859
15000US060372753023,1497,1149,13,1484,5860
15000US060372753111,952,466,449,503,5861
15000US060372753112,1696,966,343,1353,5862
15000US060372753113,1052,362,172,880,5863
15000US060372753114,2000,831,220,1780,5864
15000US060372754001,1158,448,345,813,5865
15000US060372754002,2433,1449,247,2186,5866
15000US060372755001,1218,284,794,424,5867
15000US060372755002,789,234,280,509,5868
15000US060372755003,699,174,336,363,5869
15000US060372755004,2860,71,2504,356,5870
15000US060372756021,8905,4012,1145,7760,5871
15000US060372756031,959,365,393,566,5872
15000US060372756032,658,207,234,424,5873
15000US060372756033,1176,546,171,1005,5874
15000US060372760001,941,749,50,891,5875
15000US060372760002,969,651,90,879,5876
15000US060372760003,1392,621,401,991,5877
15000US060372760004,1446,520,532,914,5878
15000US060372760005,760,691,31,729,5879
15000US060372761001,1780,383,332,1448,5880
15000US060372761002,3174,776,245,2929,5881
15000US060372761003,879,42,116,763,5882
15000US060372764001,877,632,97,780,5883
15000US060372764002,865,597,74,791,5884
15000US060372764003,1091,807,101,990,5885
15000US060372764004,749,434,160,589,5886
15000US060372764005,577,513,11,566,5887
15000US060372765001,3339,1905,534,2805,5888
15000US060372765002,2104,1106,444,1660,5889
15000US060372766011,1063,573,104,959,5890
15000US060372766012,925,544,119,806,5891
15000US060372766013,752,359,206,546,5892
15000US060372766014,1379,942,50,1329,5893
15000US060372766031,2253,1430,494,1759,5894
15000US060372766032,2985,1550,463,2522,5895
15000US060372766041,2280,1121,109,2171,5896
15000US060372766042,1826,1029,303,1523,5897
15000US060372770001,1185,888,142,1043,5898
15000US060372770002,815,558,130,685,5899
15000US060372770003,1356,916,34,1322,5900
15000US060372770004,1023,615,270,753,5901
15000US060372770005,1103,947,105,998,5902
15000US060372771001,1156,625,222,934,5903
15000US060372771002,725,447,139,586,5904
15000US060372771003,1367,680,365,1002,5905
15000US060372772001,2370,497,939,1431,5906
15000US060372772002,67,0,0,67,5907
15000US060372774001,1104,32,232,872,5908
15000US060372774002,540,25,200,340,5909
15000US060372780011,1116,532,375,741,5910
15000US060372780012,1451,863,332,1119,5911
15000US060372781021,722,432,177,545,5912
15000US060372781022,1334,1092,48,1286,5913
15000US060372781023,1078,896,62,1016,5914
15000US060372911101,2316,19,848,1468,5915
15000US060372911102,1433,7,814,619,5916
15000US060372911201,2155,8,1365,790,5917
15000US060372911301,991,53,734,257,5918
15000US060372911302,1650,68,977,673,5919
15000US060372911303,881,21,573,308,5920
15000US060372912101,1622,22,877,745,5921
15000US060372912102,2881,233,1555,1326,5922
15000US060372912103,1294,47,1190,104,5923
15000US060372912201,727,19,612,115,5924
15000US060372912202,2295,141,1503,792,5925
15000US060372912203,803,41,611,192,5926
15000US060372913001,983,196,370,613,5927
15000US060372913002,753,116,221,532,5928
15000US060372913003,821,174,70,751,5929
15000US060372920001,861,199,374,487,5930
15000US060372920002,1465,99,929,536,5931
15000US060372920003,3284,105,2118,1166,5932
15000US060372920004,953,360,256,697,5933
15000US060372932011,1866,41,1058,808,5934
15000US060372932012,2074,615,886,1188,5935
15000US060372932013,2679,390,1193,1486,5936
15000US060372932021,857,208,374,483,5937
15000US060372932022,2710,22,1677,1033,5938
15000US060372932023,2960,86,2193,767,5939
15000US060372933011,2877,911,539,2338,5940
15000US060372933021,2614,768,611,2003,5941
15000US060372933022,2841,256,1934,907,5942
15000US060372933041,2318,396,1416,902,5943
15000US060372933042,1896,211,1254,642,5944
15000US060372933061,829,294,474,355,5945
15000US060372933062,1585,574,475,1110,5946
15000US060372933071,1537,179,788,749,5947
15000US060372933072,1131,68,860,271,5948
15000US060372941101,1804,224,1481,323,5949
15000US060372941102,1688,19,1525,163,5950
15000US060372941103,955,132,763,192,5951
15000US060372941201,528,10,482,46,5952
15000US060372941202,1247,96,1122,125,5953
15000US060372941203,665,45,534,131,5954
15000US060372942001,1248,190,1058,190,5955
15000US060372942002,2563,106,2355,208,5956
15000US060372942003,1670,175,1377,293,5957
15000US060372943011,1576,141,1388,188,5958
15000US060372943012,980,64,739,241,5959
15000US060372943021,2222,51,2110,112,5960
15000US060372943022,2528,200,2143,385,5961
15000US060372944101,2088,90,729,1359,5962
15000US060372944102,2920,695,1152,1768,5963
15000US060372944211,1258,258,514,744,5964
15000US060372944212,933,0,747,186,5965
15000US060372944213,857,7,758,99,5966
15000US060372945101,2300,60,2216,84,5967
15000US060372945102,2723,225,2498,225,5968
15000US060372945201,1566,28,1498,68,5969
15000US060372945202,2230,93,2120,110,5970
15000US060372946101,1010,2,1004,6,5971
15000US060372946102,3301,40,3107,194,5972
15000US060372946201,1720,28,1675,45,5973
15000US060372946202,1653,43,1554,99,5974
15000US060372946203,1285,98,1175,110,5975
15000US060372947011,604,14,590,14,5976
15000US060372947012,989,20,885,104,5977
15000US060372947013,1555,66,1355,200,5978
15000US060372948101,2275,42,2233,42,5979
15000US060372948102,2040,21,1948,92,5980
15000US060372948201,2324,16,2265,59,5981
15000US060372948202,1418,26,1327,91,5982
15000US060372948301,2879,16,2715,164,5983
15000US060372948302,1029,5,987,42,5984
15000US060372949001,1974,78,1739,235,5985
15000US060372949002,1687,90,1567,120,5986
15000US060372951031,3157,1763,749,2408,5987
15000US060372951032,1733,1224,258,1475,5988
15000US060372962101,666,31,563,103,5989
15000US060372962102,725,97,520,205,5990
15000US060372962103,1314,82,991,323,5991
15000US060372962201,582,15,382,200,5992
15000US060372962202,2628,138,1953,675,5993
15000US060372962203,1016,324,284,732,5994
15000US060372963001,1596,346,863,733,5995
15000US060372963002,3196,1509,751,2445,5996
15000US060372964011,2146,1228,394,1752,5997
15000US060372964012,1134,628,346,788,5998
15000US060372964021,1182,410,607,575,5999
15000US060372964022,803,325,375,428,6000
15000US060372964023,1114,438,466,648,6001
15000US060372965001,1262,81,1018,244,6002
15000US060372965002,1441,210,1004,437,6003
15000US060372965003,1410,77,1096,314,6004
15000US060372966001,1077,110,965,112,6005
15000US060372966002,1080,294,680,400,6006
15000US060372966003,855,323,377,478,6007
15000US060372966004,2003,241,1500,503,6008
15000US060372969011,1697,216,1134,563,6009
15000US060372969012,1776,236,1238,538,6010
15000US060372969013,514,270,171,343,6011
15000US060372969021,1364,197,963,401,6012
15000US060372969022,2374,738,1487,887,6013
15000US060372969023,508,164,312,196,6014
15000US060372970001,986,669,76,910,6015
15000US060372970002,621,335,203,418,6016
15000US060372970003,1573,663,719,854,6017
15000US060372970004,1110,618,413,697,6018
15000US060372970005,925,554,371,554,6019
15000US060372971101,1846,521,809,1037,6020
15000US060372971102,3004,363,1826,1178,6021
15000US060372971201,1270,223,1008,262,6022
15000US060372971202,2290,398,1800,490,6023
15000US060372972011,2611,357,1922,689,6024
15000US060372972012,1392,402,550,842,6025
15000US060372972021,1654,825,468,1186,6026
15000US060372972022,1828,835,734,1094,6027
15000US060372972023,625,243,357,268,6028
15000US060372973001,1019,622,246,773,6029
15000US060372973002,551,271,152,399,6030
15000US060372973003,640,379,178,462,6031
15000US060372974001,779,521,226,553,6032
15000US060372974002,2338,1570,499,1839,6033
15000US060372974003,586,390,142,444,6034
15000US060372975001,1341,612,292,1049,6035
15000US060372975002,968,426,542,426,6036
15000US060372975003,937,413,438,499,6037
15000US060372975004,1092,727,232,860,6038
15000US060372975005,855,487,259,596,6039
15000US060372976011,999,629,249,750,6040
15000US060372976012,547,280,166,381,6041
15000US060372976013,1013,439,252,761,6042
15000US060372976021,924,440,377,547,6043
15000US060372976022,1637,760,672,965,6044
15000US060372976023,1368,836,257,1111,6045
15000US060373001001,1726,1359,112,1614,6046
15000US060373001002,978,583,74,904,6047
15000US060373001003,1546,790,175,1371,6048
15000US060373001004,1667,1212,207,1460,6049
15000US060373002001,1167,593,204,963,6050
15000US060373002002,1047,769,11,1036,6051
15000US060373002003,837,293,84,753,6052
15000US060373002004,803,395,72,731,6053
15000US060373002005,1775,790,236,1539,6054
15000US060373003011,1456,921,37,1419,6055
15000US060373003012,899,775,38,861,6056
15000US060373003013,885,510,200,685,6057
15000US060373003014,693,380,0,693,6058
15000US060373003015,720,513,59,661,6059
15000US060373003016,1546,717,228,1318,6060
15000US060373004001,1374,662,408,966,6061
15000US060373004002,933,447,225,708,6062
15000US060373004003,1096,603,114,982,6063
15000US060373004004,664,335,173,491,6064
15000US060373004005,718,335,81,637,6065
15000US060373004006,982,498,241,741,6066
15000US060373005011,1338,660,346,992,6067
15000US060373005012,603,169,37,566,6068
15000US060373005013,1211,879,46,1165,6069
15000US060373005021,2730,1125,902,1828,6070
15000US060373005022,1699,955,181,1518,6071
15000US060373005023,1398,668,263,1135,6072
15000US060373006001,897,753,60,837,6073
15000US060373006002,619,440,0,619,6074
15000US060373006003,3446,1442,461,2985,6075
15000US060373006004,1822,1261,299,1523,6076
15000US060373006005,2413,787,136,2277,6077
15000US060373007011,644,537,35,609,6078
15000US060373007012,1004,759,197,807,6079
15000US060373007013,789,723,33,756,6080
15000US060373007014,1592,919,200,1392,6081
15000US060373007015,2240,1976,115,2125,6082
15000US060373007021,2296,2197,15,2281,6083
15000US060373007022,2695,1920,243,2452,6084
15000US060373008001,3035,2074,372,2663,6085
15000US060373008002,1240,621,118,1122,6086
15000US060373008003,1390,1110,60,1330,6087
15000US060373008004,1352,860,310,1042,6088
15000US060373008005,819,356,0,819,6089
15000US060373009011,1425,1094,0,1425,6090
15000US060373009012,1347,812,176,1171,6091
15000US060373009013,3594,2279,247,3347,6092
15000US060373009021,654,348,119,535,6093
15000US060373009022,1421,933,198,1223,6094
15000US060373010001,1043,727,122,921,6095
15000US060373010002,1604,1055,237,1367,6096
15000US060373010003,1218,418,426,792,6097
15000US060373010004,1080,715,136,944,6098
15000US060373011001,602,463,120,482,6099
15000US060373011002,1038,749,58,980,6100
15000US060373011003,1053,829,115,938,6101
15000US060373011004,833,703,120,713,6102
15000US060373011005,1115,806,157,958,6103
15000US060373011006,1906,1272,118,1788,6104
15000US060373012031,1885,736,460,1425,6105
15000US060373012032,2527,2048,204,2323,6106
15000US060373012041,1568,823,383,1185,6107
15000US060373012042,1739,1092,302,1437,6108
15000US060373012043,1789,1561,21,1768,6109
15000US060373012051,974,761,86,888,6110
15000US060373012052,383,254,67,316,6111
15000US060373012053,853,513,46,807,6112
15000US060373012061,2465,1800,137,2328,6113
15000US060373012062,886,511,224,662,6114
15000US060373012063,859,586,51,808,6115
15000US060373012064,1264,933,77,1187,6116
15000US060373013001,665,531,39,626,6117
15000US060373013002,1267,1026,112,1155,6118
15000US060373014001,1103,912,35,1068,6119
15000US060373014002,1468,1427,10,1458,6120
15000US060373014003,520,459,9,511,6121
15000US060373014004,643,517,13,630,6122
15000US060373015011,742,647,73,669,6123
15000US060373015012,1122,928,93,1029,6124
15000US060373015021,1747,893,359,1388,6125
15000US060373015022,2896,2031,581,2315,6126
15000US060373015023,2278,1965,86,2192,6127
15000US060373016011,1926,889,829,1097,6128
15000US060373016012,1246,928,195,1051,6129
15000US060373016013,1811,1047,307,1504,6130
15000US060373016014,1698,1388,103,1595,6131
15000US060373016021,2621,898,1357,1264,6132
15000US060373016022,633,337,224,409,6133
15000US060373016023,1036,397,395,641,6134
15000US060373017011,1387,810,314,1073,6135
15000US060373017012,1736,765,754,982,6136
15000US060373017021,2206,1401,409,1797,6137
15000US060373017022,1627,1315,104,1523,6138
15000US060373017023,1279,661,475,804,6139
15000US060373017024,750,428,134,616,6140
15000US060373018011,1302,795,206,1096,6141
15000US060373018012,2224,1021,387,1837,6142
15000US060373018013,1051,356,351,700,6143
15000US060373018021,2314,1383,343,1971,6144
15000US060373018022,1414,875,197,1217,6145
15000US060373019001,2493,1689,231,2262,6146
15000US060373019002,1987,1188,486,1501,6147
15000US060373019003,855,566,161,694,6148
15000US060373019004,2764,1818,314,2450,6149
15000US060373020021,1100,616,184,916,6150
15000US060373020022,2086,1495,285,1801,6151
15000US060373020023,776,445,192,584,6152
15000US060373020031,3838,2852,388,3450,6153
15000US060373020041,4453,2424,974,3479,6154
15000US060373021021,1493,860,247,1246,6155
15000US060373021022,971,599,254,717,6156
15000US060373021023,1796,1054,614,1182,6157
15000US060373021024,832,762,49,783,6158
15000US060373021025,832,501,58,774,6159
15000US060373021031,1791,879,585,1206,6160
15000US060373021032,2447,1586,403,2044,6161
15000US060373021033,1712,1200,271,1441,6162
15000US060373021041,906,319,352,554,6163
15000US060373021042,1343,480,385,958,6164
15000US060373021043,1917,890,340,1577,6165
15000US060373022011,933,637,136,797,6166
15000US060373022012,1587,1198,136,1451,6167
15000US060373022013,1274,819,152,1122,6168
15000US060373022021,1606,1135,414,1192,6169
15000US060373022022,2061,1348,370,1691,6170
15000US060373022023,811,247,355,456,6171
15000US060373022024,679,431,217,462,6172
15000US060373023011,1484,709,404,1080,6173
15000US060373023012,2863,1713,408,2455,6174
15000US060373023021,1541,368,915,626,6175
15000US060373023022,1574,475,854,720,6176
15000US060373023023,1223,570,428,795,6177
15000US060373023024,874,223,405,469,6178
15000US060373024011,1840,1234,277,1563,6179
15000US060373024012,1499,625,387,1112,6180
15000US060373024013,968,430,413,555,6181
15000US060373024014,841,323,330,511,6182
15000US060373024015,1283,542,601,682,6183
15000US060373025031,2033,1258,495,1538,6184
15000US060373025032,1401,898,341,1060,6185
15000US060373025033,1009,292,175,834,6186
15000US060373025041,2668,1498,726,1942,6187
15000US060373025042,749,499,143,606,6188
15000US060373025043,907,271,553,354,6189
15000US060373025051,1387,637,523,864,6190
15000US060373025052,893,202,545,348,6191
15000US060373025053,1966,807,511,1455,6192
15000US060373025061,489,259,56,433,6193
15000US060373025062,1212,721,288,924,6194
15000US060373025063,1752,885,506,1246,6195
15000US060373101001,1159,784,214,945,6196
15000US060373101002,1831,1517,166,1665,6197
15000US060373101003,1779,1273,183,1596,6198
15000US060373101004,1213,872,107,1106,6199
15000US060373102011,706,531,117,589,6200
15000US060373102012,1082,993,12,1070,6201
15000US060373102013,1411,1015,204,1207,6202
15000US060373102014,2334,1463,206,2128,6203
15000US060373102021,1820,1325,262,1558,6204
15000US060373102022,2562,1388,557,2005,6205
15000US060373102023,641,527,16,625,6206
15000US060373103001,790,569,149,641,6207
15000US060373103002,548,315,35,513,6208
15000US060373103003,620,383,48,572,6209
15000US060373103004,866,670,34,832,6210
15000US060373104001,644,365,17,627,6211
15000US060373104002,1308,837,253,1055,6212
15000US060373104003,1286,737,393,893,6213
15000US060373105011,866,249,378,488,6214
15000US060373105012,1574,541,837,737,6215
15000US060373105013,1468,416,461,1007,6216
15000US060373106011,2383,808,602,1781,6217
15000US060373106012,2382,1388,530,1852,6218
15000US060373106013,2081,505,978,1103,6219
15000US060373106021,1099,523,403,696,6220
15000US060373106022,1495,879,241,1254,6221
15000US060373107011,1777,1168,428,1349,6222
15000US060373107012,597,510,69,528,6223
15000US060373107021,1961,1198,309,1652,6224
15000US060373107022,2954,1892,628,2326,6225
15000US060373107023,2327,1593,244,2083,6226
15000US060373107031,3176,1981,601,2575,6227
15000US060373107032,1857,1286,234,1623,6228
15000US060373108001,785,256,355,430,6229
15000US060373108002,675,375,154,521,6230
15000US060373108003,1496,688,532,964,6231
15000US060373108004,1099,678,301,798,6232
15000US060373108005,1233,947,222,1011,6233
15000US060373109001,1127,287,676,451,6234
15000US060373109002,1272,823,152,1120,6235
15000US060373109003,533,179,275,258,6236
15000US060373109004,1151,603,410,741,6237
15000US060373109005,916,630,69,847,6238
15000US060373109006,991,491,349,642,6239
15000US060373110001,676,235,376,300,6240
15000US060373110002,772,389,220,552,6241
15000US060373110003,1943,996,797,1146,6242
15000US060373110004,562,353,68,494,6243
15000US060373111001,1500,507,611,889,6244
15000US060373111002,1828,816,797,1031,6245
15000US060373111003,858,499,202,656,6246
15000US060373112001,1169,828,210,959,6247
15000US060373112002,1271,697,426,845,6248
15000US060373112003,804,668,64,740,6249
15000US060373113001,820,421,360,460,6250
15000US060373113002,1354,779,402,952,6251
15000US060373113003,1770,979,338,1432,6252
15000US060373114001,1058,748,109,949,6253
15000US060373114002,1237,889,203,1034,6254
15000US060373115001,1956,1031,746,1210,6255
15000US060373115002,1552,898,293,1259,6256
15000US060373115003,1984,1357,209,1775,6257
15000US060373116001,900,763,70,830,6258
15000US060373116002,3416,1838,582,2834,6259
15000US060373116003,712,377,64,648,6260
15000US060373116004,1152,679,267,885,6261
15000US060373116005,451,243,149,302,6262
15000US060373117001,1737,1089,433,1304,6263
15000US060373117002,834,767,26,808,6264
15000US060373117003,794,394,242,552,6265
15000US060373117004,773,350,223,550,6266
15000US060373117005,823,618,133,690,6267
15000US060373117006,1108,686,189,919,6268
15000US060373118011,1808,333,1236,572,6269
15000US060373118012,1331,717,443,888,6270
15000US060373118021,1813,475,1045,768,6271
15000US060373118022,1942,475,1132,810,6272
15000US060373200001,0,0,0,0,6273
15000US060373201001,2423,129,2147,276,6274
15000US060373201002,1272,69,1143,129,6275
15000US060373201003,2442,182,2112,330,6276
15000US060373201004,1468,68,1393,75,6277
15000US060373202011,1546,0,1546,0,6278
15000US060373202012,1484,78,1347,137,6279
15000US060373202013,1130,0,1028,102,6280
15000US060373202021,2296,119,1948,348,6281
15000US060373202022,1835,87,1721,114,6282
15000US060373202023,810,39,771,39,6283
15000US060373202024,1025,98,921,104,6284
15000US060373203001,1876,29,1812,64,6285
15000US060373203002,1018,18,996,22,6286
15000US060373203003,869,0,852,17,6287
15000US060373203004,547,28,519,28,6288
15000US060373203005,783,17,766,17,6289
15000US060373203006,1572,162,1316,256,6290
15000US060374002041,2831,1694,636,2195,6291
15000US060374002042,1292,827,410,882,6292
15000US060374002043,2129,1189,415,1714,6293
15000US060374002051,2972,1490,331,2641,6294
15000US060374002061,2930,1566,713,2217,6295
15000US060374002062,2472,1588,506,1966,6296
15000US060374002071,1224,983,129,1095,6297
15000US060374002072,2279,1539,359,1920,6298
15000US060374002073,1290,755,449,841,6299
15000US060374002074,0,0,0,0,6300
15000US060374003021,1433,585,595,838,6301
15000US060374003022,1683,757,569,1114,6302
15000US060374003041,2629,1391,853,1776,6303
15000US060374003042,1320,537,379,941,6304
15000US060374003043,1223,727,353,870,6305
15000US060374003044,1999,832,563,1436,6306
15000US060374004021,2522,1616,472,2050,6307
15000US060374004022,1773,930,720,1053,6308
15000US060374004031,1775,900,605,1170,6309
15000US060374004032,2396,1270,775,1621,6310
15000US060374004041,2041,1374,399,1642,6311
15000US060374004042,1192,1010,101,1091,6312
15000US060374004043,1284,953,128,1156,6313
15000US060374005011,2110,1338,490,1620,6314
15000US060374006021,1080,360,551,529,6315
15000US060374006022,1502,212,1258,244,6316
15000US060374006023,1497,494,941,556,6317
15000US060374006031,4095,905,2061,2034,6318
15000US060374006032,1318,349,766,552,6319
15000US060374006041,1254,631,428,826,6320
15000US060374006042,1951,393,1115,836,6321
15000US060374008001,6216,3393,1201,5015,6322
15000US060374009001,678,472,115,563,6323
15000US060374009002,2177,1004,820,1357,6324
15000US060374009003,1300,481,487,813,6325
15000US060374010011,1443,885,385,1058,6326
15000US060374010012,710,630,55,655,6327
15000US060374010013,1112,678,202,910,6328
15000US060374010021,766,420,248,518,6329
15000US060374010022,1740,1024,482,1258,6330
15000US060374010023,1452,907,347,1105,6331
15000US060374011011,1037,486,161,876,6332
15000US060374011012,1495,598,631,864,6333
15000US060374011013,954,613,341,613,6334
15000US060374011014,1930,1355,446,1484,6335
15000US060374011021,1128,341,279,849,6336
15000US060374011022,1068,827,219,849,6337
15000US060374011023,829,475,147,682,6338
15000US060374012011,1529,931,515,1014,6339
15000US060374012012,1849,833,613,1236,6340
15000US060374012021,1422,698,591,831,6341
15000US060374012022,1214,360,547,667,6342
15000US060374012023,2111,1087,773,1338,6343
15000US060374012031,2204,1106,754,1450,6344
15000US060374012032,3250,1227,1210,2040,6345
15000US060374013031,2454,1201,564,1890,6346
15000US060374013041,3088,1620,1160,1928,6347
15000US060374013042,243,129,114,129,6348
15000US060374013043,1737,521,284,1453,6349
15000US060374013044,732,494,28,704,6350
15000US060374013111,1505,809,316,1189,6351
15000US060374013112,1247,393,605,642,6352
15000US060374013113,1781,480,846,935,6353
15000US060374013114,1575,802,496,1079,6354
15000US060374013121,2597,1341,1087,1510,6355
15000US060374013122,3046,1308,1167,1879,6356
15000US060374015001,2509,1403,809,1700,6357
15000US060374015002,2629,827,1213,1416,6358
15000US060374015003,962,242,628,334,6359
15000US060374016011,843,581,203,640,6360
15000US060374016012,2407,1191,1070,1337,6361
15000US060374016013,1997,804,659,1338,6362
15000US060374016021,3432,1319,1665,1767,6363
15000US060374016022,1296,775,450,846,6364
15000US060374016023,1305,341,681,624,6365
15000US060374016031,1595,1198,276,1319,6366
15000US060374016032,1076,461,526,550,6367
15000US060374017011,1308,788,303,1005,6368
15000US060374017012,2903,1438,972,1931,6369
15000US060374017031,2171,799,865,1306,6370
15000US060374017032,2388,447,1306,1082,6371
15000US060374017041,2616,287,2048,568,6372
15000US060374017042,1290,143,775,515,6373
15000US060374017043,2095,815,682,1413,6374
15000US060374018001,2225,1341,754,1471,6375
15000US060374018002,2548,1452,639,1909,6376
15000US060374018003,3243,2140,589,2654,6377
15000US060374019011,1587,769,299,1288,6378
15000US060374019012,2467,1100,456,2011,6379
15000US060374019021,986,753,95,891,6380
15000US060374019022,2212,884,235,1977,6381
15000US060374019023,1077,631,314,763,6382
15000US060374019024,1626,933,471,1155,6383
15000US060374020011,2029,708,539,1490,6384
15000US060374020012,1263,359,705,558,6385
15000US060374020021,2054,728,945,1109,6386
15000US060374020022,1074,500,468,606,6387
15000US060374020023,1230,786,211,1019,6388
15000US060374021011,2255,114,1514,741,6389
15000US060374021012,1487,11,1256,231,6390
15000US060374021013,1524,9,1250,274,6391
15000US060374021021,2473,284,1265,1208,6392
15000US060374021022,2031,254,1305,726,6393
15000US060374021023,506,91,255,251,6394
15000US060374022001,2618,279,1571,1047,6395
15000US060374022002,2647,438,1817,830,6396
15000US060374022003,2046,505,1110,936,6397
15000US060374023011,3206,336,2563,643,6398
15000US060374023012,2642,215,2049,593,6399
15000US060374023031,1555,193,1197,358,6400
15000US060374023032,800,147,622,178,6401
15000US060374023033,934,168,736,198,6402
15000US060374023034,840,197,635,205,6403
15000US060374023041,2361,151,1980,381,6404
15000US060374023042,1745,67,1664,81,6405
15000US060374024021,849,42,728,121,6406
15000US060374024022,1394,27,1350,44,6407
15000US060374024023,2263,226,1758,505,6408
15000US060374024024,1984,644,639,1345,6409
15000US060374024031,942,26,799,143,6410
15000US060374024032,4455,1132,2385,2070,6411
15000US060374024041,2011,630,526,1485,6412
15000US060374024051,885,0,759,126,6413
15000US060374024052,749,5,656,93,6414
15000US060374024053,1318,6,937,381,6415
15000US060374024061,2118,0,1807,311,6416
15000US060374024062,2967,157,2484,483,6417
15000US060374025011,2549,73,2246,303,6418
15000US060374025012,3137,152,2780,357,6419
15000US060374025021,1317,108,1122,195,6420
15000US060374025022,5235,343,4067,1168,6421
15000US060374026001,499,29,344,155,6422
15000US060374026002,2198,243,1695,503,6423
15000US060374026003,1865,383,1374,491,6424
15000US060374026004,1494,392,821,673,6425
15000US060374026005,1097,713,271,826,6426
15000US060374027021,2631,80,2389,242,6427
15000US060374027022,1116,35,942,174,6428
15000US060374027023,571,72,392,179,6429
15000US060374027024,1880,157,1515,365,6430
15000US060374027031,2385,322,1469,916,6431
15000US060374027032,2358,308,1735,623,6432
15000US060374027051,1002,193,731,271,6433
15000US060374027052,2563,486,1790,773,6434
15000US060374027061,1591,96,1245,346,6435
15000US060374027062,1368,123,971,397,6436
15000US060374027063,1157,25,781,376,6437
15000US060374028011,2514,57,2375,139,6438
15000US060374028012,1471,59,1351,120,6439
15000US060374028013,1207,40,1096,111,6440
15000US060374028031,1464,60,1283,181,6441
15000US060374028032,1707,35,1526,181,6442
15000US060374028041,1747,86,1528,219,6443
15000US060374028042,2494,71,1860,634,6444
15000US060374029021,2792,136,2071,721,6445
15000US060374029022,3912,138,3164,748,6446
15000US060374029031,4601,176,3663,938,6447
15000US060374029041,1407,50,1282,125,6448
15000US060374029042,2240,277,1885,355,6449
15000US060374030001,3161,56,2836,325,6450
15000US060374030002,1752,25,1666,86,6451
15000US060374030003,1936,71,1414,522,6452
15000US060374032001,724,329,131,593,6453
15000US060374033031,2820,509,871,1949,6454
15000US060374033041,2166,478,508,1658,6455
15000US060374033042,2872,332,329,2543,6456
15000US060374033051,2297,284,263,2034,6457
15000US060374033121,2105,451,862,1243,6458
15000US060374033122,1786,227,535,1251,6459
15000US060374033123,1008,438,195,813,6460
15000US060374033161,2377,663,562,1815,6461
15000US060374033162,2872,848,575,2297,6462
15000US060374033163,1587,427,142,1445,6463
15000US060374033171,2585,621,821,1764,6464
15000US060374033172,1409,131,306,1103,6465
15000US060374033173,665,142,253,412,6466
15000US060374033181,1341,234,316,1025,6467
15000US060374033182,2152,522,646,1506,6468
15000US060374033183,1828,475,580,1248,6469
15000US060374033184,1113,236,561,552,6470
15000US060374033191,1783,554,481,1302,6471
15000US060374033192,2617,127,465,2152,6472
15000US060374033201,2478,228,452,2026,6473
15000US060374033202,2693,364,421,2272,6474
15000US060374033211,3672,573,1249,2423,6475
15000US060374033212,1954,426,600,1354,6476
15000US060374033213,868,230,246,622,6477
15000US060374033221,2035,450,510,1525,6478
15000US060374033222,1967,634,295,1672,6479
15000US060374033231,1876,169,98,1778,6480
15000US060374033232,1957,573,306,1651,6481
15000US060374033233,1562,233,95,1467,6482
15000US060374033241,1125,453,54,1071,6483
15000US060374033242,2026,82,337,1689,6484
15000US060374033243,2877,663,433,2444,6485
15000US060374033244,805,139,15,790,6486
15000US060374033251,2971,542,579,2392,6487
15000US060374033252,1332,469,328,1004,6488
15000US060374033253,695,242,78,617,6489
15000US060374034011,1457,96,591,866,6490
15000US060374034012,1426,134,631,795,6491
15000US060374034013,2679,281,654,2025,6492
15000US060374034021,2292,309,591,1701,6493
15000US060374034022,1270,246,223,1047,6494
15000US060374034031,2005,229,304,1701,6495
15000US060374034032,1454,160,145,1309,6496
15000US060374034033,1403,26,285,1118,6497
15000US060374034041,1012,148,105,907,6498
15000US060374034042,1628,185,186,1442,6499
15000US060374034051,1696,259,248,1448,6500
15000US060374034061,2964,516,740,2224,6501
15000US060374034071,972,180,167,805,6502
15000US060374034072,1156,26,88,1068,6503
15000US060374034081,1019,77,19,1000,6504
15000US060374034082,988,108,89,899,6505
15000US060374034083,2051,75,218,1833,6506
15000US060374034084,1341,102,666,675,6507
15000US060374034085,1213,103,234,979,6508
15000US060374035001,1829,512,540,1289,6509
15000US060374036001,2887,453,1776,1111,6510
15000US060374036002,630,193,373,257,6511
15000US060374036003,1243,602,410,833,6512
15000US060374036004,2313,1016,750,1563,6513
15000US060374037021,1602,525,883,719,6514
15000US060374037022,2082,789,899,1183,6515
15000US060374037031,2152,524,1250,902,6516
15000US060374037032,2146,845,797,1349,6517
15000US060374037033,555,426,114,441,6518
15000US060374037211,1209,510,597,612,6519
15000US060374037212,1996,692,1003,993,6520
15000US060374037213,984,357,489,495,6521
15000US060374037214,640,132,333,307,6522
15000US060374037221,2658,448,1850,808,6523
15000US060374037222,730,168,532,198,6524
15000US060374037223,2518,442,1688,830,6525
15000US060374038011,2692,817,1368,1324,6526
15000US060374038012,1644,407,822,822,6527
15000US060374038013,618,176,247,371,6528
15000US060374038014,1439,204,965,474,6529
15000US060374038021,1766,354,1162,604,6530
15000US060374038022,832,260,437,395,6531
15000US060374038023,3580,914,1964,1616,6532
15000US060374039011,1007,366,512,495,6533
15000US060374039012,1338,284,875,463,6534
15000US060374039013,1055,465,455,600,6535
15000US060374039021,2186,961,956,1230,6536
15000US060374039022,647,181,272,375,6537
15000US060374039023,2053,1086,644,1409,6538
15000US060374040001,737,164,510,227,6539
15000US060374040002,1435,187,1040,395,6540
15000US060374040003,905,247,537,368,6541
15000US060374040004,1811,389,1053,758,6542
15000US060374041001,909,134,668,241,6543
15000US060374041002,2899,98,2532,367,6544
15000US060374041003,2197,137,1859,338,6545
15000US060374041004,1163,146,990,173,6546
15000US060374042011,2291,258,1725,566,6547
15000US060374042012,1440,319,969,471,6548
15000US060374042021,2278,999,715,1563,6549
15000US060374042022,1699,162,1439,260,6550
15000US060374043011,1854,51,1478,376,6551
15000US060374043012,1306,42,1182,124,6552
15000US060374043013,1407,175,1130,277,6553
15000US060374043014,1128,202,828,300,6554
15000US060374043021,1409,185,1044,365,6555
15000US060374043022,794,63,622,172,6556
15000US060374044011,1120,73,1023,97,6557
15000US060374044012,1606,113,1430,176,6558
15000US060374044013,1191,239,870,321,6559
15000US060374044021,1874,161,1302,572,6560
15000US060374044022,1410,176,1109,301,6561
15000US060374044023,662,92,510,152,6562
15000US060374044024,794,86,601,193,6563
15000US060374045011,2475,172,2051,424,6564
15000US060374045031,3015,220,2366,649,6565
15000US060374045041,2753,175,2235,518,6566
15000US060374045042,1978,88,1649,329,6567
15000US060374046001,1072,57,1007,65,6568
15000US060374046002,247,4,243,4,6569
15000US060374047011,3073,35,2169,904,6570
15000US060374047012,1350,37,1227,123,6571
15000US060374047013,660,20,602,58,6572
15000US060374047014,751,11,654,97,6573
15000US060374047021,3149,67,2369,780,6574
15000US060374047022,2117,40,1296,821,6575
15000US060374047023,788,14,330,458,6576
15000US060374047031,610,13,597,13,6577
15000US060374047032,2858,91,2505,353,6578
15000US060374048011,2087,40,1433,654,6579
15000US060374048012,1669,47,1418,251,6580
15000US060374048013,2082,202,1566,516,6581
15000US060374048014,2013,51,1428,585,6582
15000US060374048021,2186,4,1470,716,6583
15000US060374048022,2380,75,1408,972,6584
15000US060374048031,1753,153,1401,352,6585
15000US060374049011,1343,43,1026,317,6586
15000US060374049012,2251,25,2077,174,6587
15000US060374049013,2118,35,1303,815,6588
15000US060374049021,1938,38,1470,468,6589
15000US060374049022,2350,108,1557,793,6590
15000US060374049031,1182,23,958,224,6591
15000US060374049032,1766,99,1148,618,6592
15000US060374050011,3401,66,3095,306,6593
15000US060374050012,1297,101,1007,290,6594
15000US060374050013,1447,1,1170,277,6595
15000US060374050021,2361,45,2223,138,6596
15000US060374050022,876,45,595,281,6597
15000US060374051011,2885,113,2463,422,6598
15000US060374051012,1648,202,1129,519,6599
15000US060374051013,749,108,422,327,6600
15000US060374051021,2313,138,1659,654,6601
15000US060374051022,2144,175,1314,830,6602
15000US060374052011,1431,64,994,437,6603
15000US060374052012,1729,48,1250,479,6604
15000US060374052013,1795,20,1536,259,6605
15000US060374052021,1218,33,1110,108,6606
15000US060374052022,3962,89,2921,1041,6607
15000US060374052031,3851,332,2690,1161,6608
15000US060374053011,1653,109,1150,503,6609
15000US060374053012,2191,184,1797,394,6610
15000US060374053021,1390,169,633,757,6611
15000US060374053022,1802,171,1560,242,6612
15000US060374053023,849,51,390,459,6613
15000US060374053024,1551,203,1236,315,6614
15000US060374053025,543,109,302,241,6615
15000US060374054001,1343,307,989,354,6616
15000US060374054002,1808,67,1692,116,6617
15000US060374054003,946,259,615,331,6618
15000US060374054004,1263,78,1007,256,6619
15000US060374055001,572,102,359,213,6620
15000US060374055002,1811,225,1387,424,6621
15000US060374055003,1134,202,678,456,6622
15000US060374055004,946,171,368,578,6623
15000US060374055005,1264,250,660,604,6624
15000US060374055006,1034,163,502,532,6625
15000US060374056001,1568,390,964,604,6626
15000US060374056002,1116,191,641,475,6627
15000US060374056003,1205,69,991,214,6628
15000US060374056004,715,64,560,155,6629
15000US060374056005,1075,214,519,556,6630
15000US060374057011,1406,213,1025,381,6631
15000US060374057012,1033,191,637,396,6632
15000US060374057013,1099,287,754,345,6633
15000US060374057021,1840,153,1254,586,6634
15000US060374057022,3237,478,1867,1370,6635
15000US060374058001,1435,213,825,610,6636
15000US060374058002,1938,439,1377,561,6637
15000US060374058003,2308,669,1479,829,6638
15000US060374059001,1815,290,1135,680,6639
15000US060374059002,1994,253,1402,592,6640
15000US060374060001,1598,264,1230,368,6641
15000US060374060002,1733,334,1236,497,6642
15000US060374060003,933,283,559,374,6643
15000US060374060004,848,396,304,544,6644
15000US060374061011,1059,137,598,461,6645
15000US060374061012,1338,334,747,591,6646
15000US060374061013,1024,232,647,377,6647
15000US060374061021,1921,415,1192,729,6648
15000US060374061022,680,286,330,350,6649
15000US060374061023,1540,315,1082,458,6650
15000US060374061024,1616,452,828,788,6651
15000US060374062001,1533,350,897,636,6652
15000US060374062002,1841,213,1285,556,6653
15000US060374062003,2418,426,1254,1164,6654
15000US060374063001,2026,430,783,1243,6655
15000US060374063002,3449,600,1205,2244,6656
15000US060374064021,901,171,643,258,6657
15000US060374064022,737,178,483,254,6658
15000US060374064023,693,130,509,184,6659
15000US060374064111,1021,162,673,348,6660
15000US060374064112,1066,178,558,508,6661
15000US060374064121,944,242,536,408,6662
15000US060374064122,1550,328,763,787,6663
15000US060374065001,1294,195,630,664,6664
15000US060374065002,1804,346,1207,597,6665
15000US060374065003,1419,236,795,624,6666
15000US060374065004,801,109,501,300,6667
15000US060374065005,1147,119,652,495,6668
15000US060374066011,1995,471,786,1209,6669
15000US060374066012,1824,365,1085,739,6670
15000US060374066013,1637,233,1197,440,6671
15000US060374066021,948,104,586,362,6672
15000US060374066022,961,194,755,206,6673
15000US060374066023,1180,113,469,711,6674
15000US060374066024,2685,177,2102,583,6675
15000US060374067011,1444,112,874,570,6676
15000US060374067012,1262,64,800,462,6677
15000US060374067013,648,128,304,344,6678
15000US060374067021,1196,237,758,438,6679
15000US060374067022,2267,291,1242,1025,6680
15000US060374067023,1719,153,1195,524,6681
15000US060374067024,724,63,344,380,6682
15000US060374068001,1323,178,796,527,6683
15000US060374068002,1766,226,813,953,6684
15000US060374068003,1751,233,1106,645,6685
15000US060374069011,1040,82,677,363,6686
15000US060374069012,1858,93,1525,333,6687
15000US060374069013,2076,109,1827,249,6688
15000US060374069021,1901,63,1529,372,6689
15000US060374069022,962,80,798,164,6690
15000US060374069023,820,68,535,285,6691
15000US060374070011,1142,79,978,164,6692
15000US060374070012,2428,159,2069,359,6693
15000US060374070013,2901,44,2606,295,6694
15000US060374070021,2085,22,1612,473,6695
15000US060374070022,1550,22,1435,115,6696
15000US060374071011,1122,69,892,230,6697
15000US060374071012,670,0,601,69,6698
15000US060374071013,1073,38,1007,66,6699
15000US060374071014,2052,9,1683,369,6700
15000US060374071021,1503,19,1304,199,6701
15000US060374071022,2512,9,2058,454,6702
15000US060374071023,1515,66,1332,183,6703
15000US060374072001,1608,68,1475,133,6704
15000US060374072002,1920,57,1835,85,6705
15000US060374072003,1513,186,1230,283,6706
15000US060374072004,1002,7,847,155,6707
15000US060374072005,1162,28,1012,150,6708
15000US060374073011,1506,73,1074,432,6709
15000US060374073012,1187,176,901,286,6710
15000US060374073013,976,80,849,127,6711
15000US060374073014,988,35,941,47,6712
15000US060374073021,1598,108,1410,188,6713
15000US060374073022,946,60,790,156,6714
15000US060374073023,1345,28,1203,142,6715
15000US060374074001,2142,201,1068,1074,6716
15000US060374075011,2157,18,1692,465,6717
15000US060374075012,1261,55,1069,192,6718
15000US060374075013,1076,87,823,253,6719
15000US060374075021,1380,36,1174,206,6720
15000US060374075022,1280,72,1017,263,6721
15000US060374075023,1324,71,1168,156,6722
15000US060374076011,2047,19,1685,362,6723
15000US060374076012,1343,0,1183,160,6724
15000US060374076013,826,0,696,130,6725
15000US060374076021,1255,9,1018,237,6726
15000US060374076022,994,28,869,125,6727
15000US060374076023,812,60,671,141,6728
15000US060374076024,929,21,856,73,6729
15000US060374077011,1898,7,1671,227,6730
15000US060374077012,2137,9,1697,440,6731
15000US060374077013,1301,38,1217,84,6732
15000US060374077021,3295,341,2390,905,6733
15000US060374077022,1973,83,1734,239,6734
15000US060374077023,1550,102,1089,461,6735
15000US060374078011,1548,27,1301,247,6736
15000US060374078012,2137,79,1850,287,6737
15000US060374078013,1987,200,1065,922,6738
15000US060374078021,2107,121,1781,326,6739
15000US060374078022,2103,52,1855,248,6740
15000US060374079001,5107,375,3293,1814,6741
15000US060374079002,1338,39,860,478,6742
15000US060374080031,2140,82,1907,233,6743
15000US060374080032,2251,319,714,1537,6744
15000US060374080041,2563,301,1090,1473,6745
15000US060374080051,1453,422,547,906,6746
15000US060374080052,1775,165,898,877,6747
15000US060374080053,1594,142,636,958,6748
15000US060374080061,3667,105,1594,2073,6749
15000US060374081331,1350,138,523,827,6750
15000US060374081332,3073,68,2291,782,6751
15000US060374081333,1294,55,396,898,6752
15000US060374081341,2760,157,583,2177,6753
15000US060374081351,3007,229,1085,1922,6754
15000US060374081352,844,38,228,616,6755
15000US060374081361,1744,165,744,1000,6756
15000US060374081362,2048,143,1224,824,6757
15000US060374081371,2551,225,1208,1343,6758
15000US060374081372,1407,269,675,732,6759
15000US060374081381,1699,7,1680,19,6760
15000US060374081382,4347,345,3563,784,6761
15000US060374081391,1974,15,1959,15,6762
15000US060374081392,2010,32,1833,177,6763
15000US060374081401,2115,97,1757,358,6764
15000US060374081402,1484,30,1411,73,6765
15000US060374081411,4252,108,3386,866,6766
15000US060374081412,978,9,872,106,6767
15000US060374082021,1219,61,906,313,6768
15000US060374082022,779,48,649,130,6769
15000US060374082111,1273,72,800,473,6770
15000US060374082112,2950,208,901,2049,6771
15000US060374082113,1364,147,193,1171,6772
15000US060374082121,2805,359,508,2297,6773
15000US060374082122,2307,427,868,1439,6774
15000US060374083011,4934,177,4339,595,6775
15000US060374083012,855,72,592,263,6776
15000US060374083021,4236,285,3344,892,6777
15000US060374083031,4334,424,3525,809,6778
15000US060374084011,1819,412,890,929,6779
15000US060374084012,2298,275,1625,673,6780
15000US060374084021,1804,125,1161,643,6781
15000US060374084022,1121,225,311,810,6782
15000US060374084023,2667,489,1725,942,6783
15000US060374085011,3178,170,2321,857,6784
15000US060374085031,1572,315,454,1118,6785
15000US060374085032,1120,422,361,759,6786
15000US060374085033,3880,578,1314,2566,6787
15000US060374085041,1645,108,1080,565,6788
15000US060374085042,2255,297,1056,1199,6789
15000US060374085043,1268,84,766,502,6790
15000US060374085051,1220,289,522,698,6791
15000US060374085052,1413,314,623,790,6792
15000US060374086231,3210,471,1079,2131,6793
15000US060374086241,2326,293,528,1798,6794
15000US060374086242,995,204,356,639,6795
15000US060374086251,1440,188,599,841,6796
15000US060374086252,1146,130,381,765,6797
15000US060374086253,1459,231,423,1036,6798
15000US060374086261,1374,66,371,1003,6799
15000US060374086262,1258,92,304,954,6800
15000US060374086263,1926,42,494,1432,6801
15000US060374086271,2158,167,401,1757,6802
15000US060374086272,999,216,272,727,6803
15000US060374086281,1625,105,460,1165,6804
15000US060374086282,2081,151,515,1566,6805
15000US060374086283,1710,51,297,1413,6806
15000US060374086291,1406,281,274,1132,6807
15000US060374086292,1318,187,188,1130,6808
15000US060374086301,929,34,713,216,6809
15000US060374086302,1714,65,1325,389,6810
15000US060374086311,3090,204,1508,1582,6811
15000US060374086312,1365,188,772,593,6812
15000US060374086313,814,70,604,210,6813
15000US060374087031,2257,387,156,2101,6814
15000US060374087032,4203,223,261,3942,6815
15000US060374087041,3173,326,1108,2065,6816
15000US060374087051,1454,219,348,1106,6817
15000US060374087052,2220,283,385,1835,6818
15000US060374087053,1789,146,538,1251,6819
15000US060374087061,1944,290,258,1686,6820
15000US060374087221,2219,269,611,1608,6821
15000US060374087222,2435,427,691,1744,6822
15000US060374087231,2943,342,859,2084,6823
15000US060374087241,1796,228,1026,770,6824
15000US060374087242,3726,175,2051,1675,6825
15000US060374088001,1076,149,712,364,6826
15000US060374088002,1822,229,1400,422,6827
15000US060374088003,1055,285,328,727,6828
15000US060374300021,1247,94,912,335,6829
15000US060374300022,941,288,193,748,6830
15000US060374300023,1249,575,392,857,6831
15000US060374300024,1232,214,334,898,6832
15000US060374300025,2379,589,998,1381,6833
15000US060374300031,984,342,335,649,6834
15000US060374300032,2861,1061,550,2311,6835
15000US060374300033,0,0,0,0,6836
15000US060374300034,649,301,196,453,6837
15000US060374301011,1906,667,671,1235,6838
15000US060374301012,1172,257,207,965,6839
15000US060374301013,675,53,524,151,6840
15000US060374301014,1611,371,1105,506,6841
15000US060374301021,1882,137,1341,541,6842
15000US060374301022,1195,172,888,307,6843
15000US060374301023,1809,174,1503,306,6844
15000US060374302001,1145,624,151,994,6845
15000US060374303011,1200,813,277,923,6846
15000US060374303012,0,0,0,0,6847
15000US060374303013,1271,852,171,1100,6848
15000US060374303014,2137,1394,345,1792,6849
15000US060374303021,1214,393,774,440,6850
15000US060374303022,1128,763,120,1008,6851
15000US060374303023,1302,1017,57,1245,6852
15000US060374303024,1097,533,403,694,6853
15000US060374303025,1100,485,377,723,6854
15000US060374304001,1682,479,139,1543,6855
15000US060374304002,865,370,127,738,6856
15000US060374304003,804,247,151,653,6857
15000US060374304004,1252,311,94,1158,6858
15000US060374305011,974,652,158,816,6859
15000US060374305012,1170,924,169,1001,6860
15000US060374305013,487,458,8,479,6861
15000US060374305014,1529,952,273,1256,6862
15000US060374305021,590,506,64,526,6863
15000US060374305022,1770,964,268,1502,6864
15000US060374305023,1369,807,410,959,6865
15000US060374305024,852,623,113,739,6866
15000US060374305025,714,441,122,592,6867
15000US060374305026,1612,1366,112,1500,6868
15000US060374306001,827,211,72,755,6869
15000US060374306002,1080,625,95,985,6870
15000US060374306003,679,252,20,659,6871
15000US060374306004,1840,459,396,1444,6872
15000US060374307011,976,212,70,906,6873
15000US060374307012,1980,531,459,1521,6874
15000US060374307013,1384,345,36,1348,6875
15000US060374307014,1013,507,102,911,6876
15000US060374307211,990,463,119,871,6877
15000US060374307212,1811,252,214,1597,6878
15000US060374307213,821,477,202,619,6879
15000US060374307231,1940,439,325,1615,6880
15000US060374307232,2723,460,232,2491,6881
15000US060374307241,2573,394,346,2227,6882
15000US060374307242,2416,458,220,2196,6883
15000US060374308011,678,16,290,388,6884
15000US060374308012,2810,259,407,2403,6885
15000US060374308013,1520,267,381,1139,6886
15000US060374308014,1907,300,92,1815,6887
15000US060374308021,845,277,29,816,6888
15000US060374308022,1373,255,186,1187,6889
15000US060374308023,947,191,17,930,6890
15000US060374308024,801,122,30,771,6891
15000US060374308031,919,146,167,752,6892
15000US060374308032,1342,430,265,1077,6893
15000US060374308033,1446,358,220,1226,6894
15000US060374308034,1032,199,127,905,6895
15000US060374308035,595,192,37,558,6896
15000US060374309011,1462,425,452,1010,6897
15000US060374309012,1062,366,417,645,6898
15000US060374309013,1892,329,1055,837,6899
15000US060374309021,2360,779,865,1495,6900
15000US060374309022,1485,302,720,765,6901
15000US060374309023,852,165,86,766,6902
15000US060374310011,485,241,202,283,6903
15000US060374310012,2167,779,1165,1002,6904
15000US060374310013,1977,768,885,1092,6905
15000US060374310014,2381,1039,806,1575,6906
15000US060374310021,1685,717,445,1240,6907
15000US060374310022,1657,771,407,1250,6908
15000US060374311001,2257,189,1569,688,6909
15000US060374311002,2014,292,1124,890,6910
15000US060374311003,974,224,309,665,6911
15000US060374311004,817,212,531,286,6912
15000US060374311005,1095,324,659,436,6913
15000US060374312001,1707,4,1517,190,6914
15000US060374312002,1431,101,902,529,6915
15000US060374312003,901,21,726,175,6916
15000US060374312004,1919,463,1034,885,6917
15000US060374313001,1013,475,162,851,6918
15000US060374313002,1718,661,652,1066,6919
15000US060374314001,755,201,103,652,6920
15000US060374314002,1005,145,316,689,6921
15000US060374314003,1511,301,515,996,6922
15000US060374314004,884,262,173,711,6923
15000US060374315011,1007,244,358,649,6924
15000US060374315012,1436,196,397,1039,6925
15000US060374315013,2066,388,727,1339,6926
15000US060374315021,1242,304,485,757,6927
15000US060374315022,1469,482,278,1191,6928
15000US060374315023,993,94,530,463,6929
15000US060374315024,839,201,129,710,6930
15000US060374316001,1189,346,39,1150,6931
15000US060374316002,1666,182,232,1434,6932
15000US060374316003,1156,253,57,1099,6933
15000US060374317001,836,18,34,802,6934
15000US060374317002,1249,616,12,1237,6935
15000US060374317003,1315,342,76,1239,6936
15000US060374317004,834,233,0,834,6937
15000US060374317005,2292,541,126,2166,6938
15000US060374318001,1946,330,311,1635,6939
15000US060374318002,2038,402,135,1903,6940
15000US060374318003,1523,266,110,1413,6941
15000US060374319001,1932,205,684,1248,6942
15000US060374319002,832,96,58,774,6943
15000US060374319003,1600,243,270,1330,6944
15000US060374320001,2028,386,556,1472,6945
15000US060374320002,1020,72,117,903,6946
15000US060374320003,1838,483,525,1313,6947
15000US060374320004,973,415,134,839,6948
15000US060374320005,1152,245,184,968,6949
15000US060374320006,1139,125,87,1052,6950
15000US060374321011,1529,136,575,954,6951
15000US060374321012,1637,366,315,1322,6952
15000US060374321013,1272,293,215,1057,6953
15000US060374321021,1404,158,273,1131,6954
15000US060374321022,1218,395,127,1091,6955
15000US060374321023,1149,184,256,893,6956
15000US060374321024,805,126,273,532,6957
15000US060374321025,1140,211,302,838,6958
15000US060374322011,1152,134,325,827,6959
15000US060374322012,3135,264,510,2625,6960
15000US060374322021,1530,97,502,1028,6961
15000US060374322022,766,55,213,553,6962
15000US060374322023,2067,209,803,1264,6963
15000US060374323001,1695,82,1137,558,6964
15000US060374323002,1094,45,361,733,6965
15000US060374323003,1464,125,737,727,6966
15000US060374324011,2201,99,1256,945,6967
15000US060374324012,1575,119,788,787,6968
15000US060374324021,3147,196,1435,1712,6969
15000US060374324022,2363,126,1643,720,6970
15000US060374324023,1809,84,889,920,6971
15000US060374325001,1949,200,1087,862,6972
15000US060374325002,2844,282,1571,1273,6973
15000US060374325003,1615,131,728,887,6974
15000US060374325004,2525,394,1146,1379,6975
15000US060374326011,1083,35,684,399,6976
15000US060374326012,2098,69,1472,626,6977
15000US060374326013,1197,54,525,672,6978
15000US060374326014,2321,140,1140,1181,6979
15000US060374326021,2068,63,1112,956,6980
15000US060374326022,1713,61,1048,665,6981
15000US060374326023,1030,11,356,674,6982
15000US060374327001,2880,127,2439,441,6983
15000US060374327002,1177,17,955,222,6984
15000US060374327003,1398,138,876,522,6985
15000US060374328011,1230,91,717,513,6986
15000US060374328012,1517,5,800,717,6987
15000US060374328021,2130,22,1440,690,6988
15000US060374328022,1350,8,795,555,6989
15000US060374328023,1609,7,929,680,6990
15000US060374329011,2100,64,511,1589,6991
15000US060374329012,1726,133,321,1405,6992
15000US060374329013,739,35,395,344,6993
15000US060374329021,1073,23,737,336,6994
15000US060374329022,1134,84,374,760,6995
15000US060374329023,1305,81,427,878,6996
15000US060374331011,1068,12,640,428,6997
15000US060374331012,1365,118,393,972,6998
15000US060374331021,2516,19,1844,672,6999
15000US060374331022,2379,0,981,1398,7000
15000US060374332001,1211,70,805,406,7001
15000US060374332002,936,10,744,192,7002
15000US060374332003,1462,104,1175,287,7003
15000US060374332004,2637,111,1755,882,7004
15000US060374333021,1656,35,1339,317,7005
15000US060374333041,1699,58,992,707,7006
15000US060374333042,3163,87,2165,998,7007
15000US060374333051,3472,41,2527,945,7008
15000US060374333052,1768,4,1329,439,7009
15000US060374333061,647,6,504,143,7010
15000US060374333062,1893,67,974,919,7011
15000US060374333063,671,18,641,30,7012
15000US060374333071,1430,51,655,775,7013
15000US060374333072,914,8,830,84,7014
15000US060374333073,841,0,642,199,7015
15000US060374334011,2326,68,1802,524,7016
15000US060374334012,839,44,459,380,7017
15000US060374334021,1925,69,1385,540,7018
15000US060374334022,2291,47,1732,559,7019
15000US060374334031,911,26,553,358,7020
15000US060374334032,2329,0,2011,318,7021
15000US060374334033,1419,8,1152,267,7022
15000US060374335011,1729,52,1595,134,7023
15000US060374335031,2230,87,1558,672,7024
15000US060374335032,623,7,589,34,7025
15000US060374335041,1922,24,1505,417,7026
15000US060374335042,1222,62,934,288,7027
15000US060374335043,1761,25,1409,352,7028
15000US060374336011,1278,41,196,1082,7029
15000US060374336012,3629,130,1391,2238,7030
15000US060374336021,2826,91,853,1973,7031
15000US060374337001,1389,10,1124,265,7032
15000US060374337002,1033,83,737,296,7033
15000US060374337003,1637,43,1396,241,7034
15000US060374338011,1743,22,1691,52,7035
15000US060374338012,1045,26,770,275,7036
15000US060374338013,1659,12,1519,140,7037
15000US060374338014,2100,0,2100,0,7038
15000US060374338021,1420,158,887,533,7039
15000US060374338022,1890,122,1457,433,7040
15000US060374339011,3164,24,2161,1003,7041
15000US060374339012,1189,0,1070,119,7042
15000US060374339013,1218,65,837,381,7043
15000US060374339021,750,47,660,90,7044
15000US060374339022,1698,116,1397,301,7045
15000US060374339023,1010,52,713,297,7046
15000US060374340011,1765,72,1420,345,7047
15000US060374340012,2598,110,2187,411,7048
15000US060374340031,1827,28,1691,136,7049
15000US060374340032,1056,57,907,149,7050
15000US060374340033,1517,89,1005,512,7051
15000US060374340041,1526,46,1406,120,7052
15000US060374340042,1389,6,1294,95,7053
15000US060374600001,922,666,88,834,7054
15000US060374600002,917,491,160,757,7055
15000US060374600003,1821,1089,349,1472,7056
15000US060374600004,890,668,92,798,7057
15000US060374601001,1035,618,130,905,7058
15000US060374601002,1947,1004,341,1606,7059
15000US060374601003,566,258,76,490,7060
15000US060374601004,930,582,196,734,7061
15000US060374601005,1652,960,173,1479,7062
15000US060374602001,847,265,87,760,7063
15000US060374602002,1186,597,200,986,7064
15000US060374602003,978,376,182,796,7065
15000US060374602004,690,340,23,667,7066
15000US060374602005,1892,541,238,1654,7067
15000US060374603011,996,280,202,794,7068
15000US060374603012,1004,218,77,927,7069
15000US060374603013,757,106,442,315,7070
15000US060374603014,1683,876,165,1518,7071
15000US060374603021,1006,210,250,756,7072
15000US060374603022,827,76,490,337,7073
15000US060374603023,1651,300,562,1089,7074
15000US060374603024,1162,296,617,545,7075
15000US060374604011,1070,233,363,707,7076
15000US060374604012,0,0,0,0,7077
15000US060374605011,1565,983,6,1559,7078
15000US060374605012,1027,502,200,827,7079
15000US060374605013,2780,1673,157,2623,7080
15000US060374605021,717,379,76,641,7081
15000US060374605022,511,394,39,472,7082
15000US060374605023,586,165,49,537,7083
15000US060374605024,1078,740,214,864,7084
15000US060374605025,837,313,179,658,7085
15000US060374605026,872,388,42,830,7086
15000US060374606001,1319,815,111,1208,7087
15000US060374606002,1268,866,18,1250,7088
15000US060374606003,1396,838,239,1157,7089
15000US060374606004,749,504,31,718,7090
15000US060374607001,880,400,89,791,7091
15000US060374607002,640,394,10,630,7092
15000US060374607003,734,321,223,511,7093
15000US060374607004,1239,917,47,1192,7094
15000US060374607005,1578,1048,47,1531,7095
15000US060374608001,1839,1408,156,1683,7096
15000US060374608002,1355,839,156,1199,7097
15000US060374609001,1899,246,967,932,7098
15000US060374609002,2190,96,1540,650,7099
15000US060374609003,1346,68,797,549,7100
15000US060374609004,852,194,197,655,7101
15000US060374609005,745,91,494,251,7102
15000US060374610001,851,73,513,338,7103
15000US060374610002,2264,138,1520,744,7104
15000US060374610003,1337,156,554,783,7105
15000US060374610004,2177,109,1185,992,7106
15000US060374611001,860,335,165,695,7107
15000US060374611002,1768,686,501,1267,7108
15000US060374611003,1083,290,328,755,7109
15000US060374611004,1550,246,930,620,7110
15000US060374612001,1054,808,62,992,7111
15000US060374612002,1536,985,352,1184,7112
15000US060374612003,818,383,89,729,7113
15000US060374612004,1204,787,120,1084,7114
15000US060374613001,770,477,0,770,7115
15000US060374613002,1331,811,161,1170,7116
15000US060374613003,1760,1334,351,1409,7117
15000US060374613004,1571,802,280,1291,7118
15000US060374613005,1444,768,209,1235,7119
15000US060374614001,1606,915,479,1127,7120
15000US060374614002,697,418,82,615,7121
15000US060374614003,809,381,266,543,7122
15000US060374615011,971,338,516,455,7123
15000US060374615012,1380,188,632,748,7124
15000US060374615013,1813,616,794,1019,7125
15000US060374615021,1628,165,1152,476,7126
15000US060374615022,3447,603,2167,1280,7127
15000US060374615023,1382,347,478,904,7128
15000US060374615024,844,74,267,577,7129
15000US060374616001,1587,47,1018,569,7130
15000US060374616002,1336,317,250,1086,7131
15000US060374616003,1908,109,1305,603,7132
15000US060374616004,1342,18,965,377,7133
15000US060374617001,716,272,174,542,7134
15000US060374617002,762,515,85,677,7135
15000US060374619011,2594,392,1901,693,7136
15000US060374619012,407,141,143,264,7137
15000US060374619013,2063,311,1341,722,7138
15000US060374619021,356,114,89,267,7139
15000US060374619022,1230,493,249,981,7140
15000US060374620011,1820,205,1245,575,7141
15000US060374620012,2084,127,1370,714,7142
15000US060374620021,2858,169,2412,446,7143
15000US060374620022,276,9,208,68,7144
15000US060374620023,1194,114,857,337,7145
15000US060374621001,834,340,225,609,7146
15000US060374621002,3086,225,2254,832,7147
15000US060374621003,1666,616,572,1094,7148
15000US060374622011,1293,665,390,903,7149
15000US060374622012,1236,377,252,984,7150
15000US060374622013,1169,265,588,581,7151
15000US060374622021,1352,824,105,1247,7152
15000US060374622022,1572,715,90,1482,7153
15000US060374623011,2050,529,1015,1035,7154
15000US060374623012,895,192,559,336,7155
15000US060374623013,514,120,330,184,7156
15000US060374623014,1093,351,580,513,7157
15000US060374623021,1225,299,291,934,7158
15000US060374623022,871,411,211,660,7159
15000US060374623023,956,198,201,755,7160
15000US060374624001,1678,941,420,1258,7161
15000US060374624002,723,385,182,541,7162
15000US060374624003,557,421,99,458,7163
15000US060374624004,1192,467,636,556,7164
15000US060374625001,1355,709,106,1249,7165
15000US060374625002,1428,639,232,1196,7166
15000US060374625003,2631,1725,570,2061,7167
15000US060374625004,1113,874,181,932,7168
15000US060374626001,1191,726,205,986,7169
15000US060374626002,1012,563,248,764,7170
15000US060374627001,751,210,235,516,7171
15000US060374627002,944,233,508,436,7172
15000US060374627003,1176,418,549,627,7173
15000US060374627004,1345,269,467,878,7174
15000US060374627005,1176,390,640,536,7175
15000US060374628001,1393,587,301,1092,7176
15000US060374628002,1270,435,290,980,7177
15000US060374629001,1900,793,450,1450,7178
15000US060374629002,921,491,183,738,7179
15000US060374629003,1055,459,319,736,7180
15000US060374630001,873,587,160,713,7181
15000US060374630002,1290,616,121,1169,7182
15000US060374631011,631,130,187,444,7183
15000US060374631012,1784,430,727,1057,7184
15000US060374631021,1759,292,1186,573,7185
15000US060374631022,1056,471,68,988,7186
15000US060374631023,929,382,428,501,7187
15000US060374632001,1067,386,364,703,7188
15000US060374632002,1603,1026,184,1419,7189
15000US060374632003,694,113,246,448,7190
15000US060374633001,1141,410,417,724,7191
15000US060374633002,876,531,133,743,7192
15000US060374634001,1527,366,371,1156,7193
15000US060374634002,1144,505,375,769,7194
15000US060374634003,824,610,70,754,7195
15000US060374634004,1982,504,288,1694,7196
15000US060374635001,1760,720,263,1497,7197
15000US060374635002,1703,893,247,1456,7198
15000US060374635003,2664,1275,283,2381,7199
15000US060374636011,716,406,105,611,7200
15000US060374636012,1359,687,227,1132,7201
15000US060374636013,2463,918,410,2053,7202
15000US060374636014,1287,600,295,992,7203
15000US060374636021,1476,508,299,1177,7204
15000US060374636022,2468,1107,241,2227,7205
15000US060374636023,924,574,85,839,7206
15000US060374636024,673,355,81,592,7207
15000US060374637001,966,575,235,731,7208
15000US060374637002,1733,957,217,1516,7209
15000US060374638001,706,595,75,631,7210
15000US060374638002,1030,643,90,940,7211
15000US060374638003,1059,583,301,758,7212
15000US060374638004,1009,534,51,958,7213
15000US060374639001,1060,609,190,870,7214
15000US060374639002,1173,710,213,960,7215
15000US060374639003,1155,718,246,909,7216
15000US060374640001,1418,807,42,1376,7217
15000US060374640002,1191,941,98,1093,7218
15000US060374640003,1197,442,212,985,7219
15000US060374640004,857,549,149,708,7220
15000US060374640005,1301,637,294,1007,7221
15000US060374641001,906,405,120,786,7222
15000US060374641002,1181,467,225,956,7223
15000US060374641003,586,321,0,586,7224
15000US060374641004,1400,286,551,849,7225
15000US060374641005,1077,241,132,945,7226
15000US060374641006,1112,738,0,1112,7227
15000US060374641007,1135,143,0,1135,7228
15000US060374642001,786,234,54,732,7229
15000US060374642002,630,40,0,630,7230
15000US060374642003,1327,451,0,1327,7231
15000US060374642004,936,228,0,936,7232
15000US060374642005,721,198,0,721,7233
15000US060374642006,1527,596,86,1441,7234
15000US060374800021,738,169,63,675,7235
15000US060374800022,1275,332,88,1187,7236
15000US060374800023,1397,325,467,930,7237
15000US060374800111,2479,405,641,1838,7238
15000US060374800112,2746,532,1150,1596,7239
15000US060374800121,1295,165,307,988,7240
15000US060374800122,847,106,132,715,7241
15000US060374800123,1770,318,317,1453,7242
15000US060374800124,1200,173,266,934,7243
15000US060374801011,1780,240,293,1487,7244
15000US060374801012,851,196,164,687,7245
15000US060374801013,1617,224,262,1355,7246
15000US060374801021,869,262,132,737,7247
15000US060374801022,1771,142,471,1300,7248
15000US060374801023,2091,242,623,1468,7249
15000US060374802011,1791,669,404,1387,7250
15000US060374802012,773,412,59,714,7251
15000US060374802013,1486,334,538,948,7252
15000US060374802021,920,206,319,601,7253
15000US060374802022,930,243,121,809,7254
15000US060374802023,858,397,244,614,7255
15000US060374803021,1282,302,488,794,7256
15000US060374803022,1422,437,401,1021,7257
15000US060374803023,1957,196,498,1459,7258
15000US060374803031,1153,73,701,452,7259
15000US060374803032,2952,108,1395,1557,7260
15000US060374803041,2344,106,735,1609,7261
15000US060374803042,817,53,320,497,7262
15000US060374803043,1116,80,390,726,7263
15000US060374804001,932,227,436,496,7264
15000US060374804002,2396,544,778,1618,7265
15000US060374804003,2063,334,567,1496,7266
15000US060374805001,1457,692,215,1242,7267
15000US060374805002,1569,509,298,1271,7268
15000US060374805003,1283,693,182,1101,7269
15000US060374805004,756,489,42,714,7270
15000US060374806001,1504,720,371,1133,7271
15000US060374806002,1040,364,458,582,7272
15000US060374806003,1528,956,266,1262,7273
15000US060374806004,2989,1306,492,2497,7274
15000US060374806005,551,386,26,525,7275
15000US060374806006,921,364,218,703,7276
15000US060374807021,1709,511,202,1507,7277
15000US060374807022,2473,940,701,1772,7278
15000US060374807031,1069,300,232,837,7279
15000US060374807032,497,210,61,436,7280
15000US060374807033,1773,902,268,1505,7281
15000US060374807041,1810,621,446,1364,7282
15000US060374807042,3007,991,646,2361,7283
15000US060374808021,877,24,330,547,7284
15000US060374808022,2354,224,1144,1210,7285
15000US060374808031,927,195,398,529,7286
15000US060374808032,1272,139,743,529,7287
15000US060374808033,801,82,311,490,7288
15000US060374808034,926,121,712,214,7289
15000US060374808041,2677,247,1144,1533,7290
15000US060374808042,2499,101,1318,1181,7291
15000US060374809011,3316,186,1302,2014,7292
15000US060374809012,1720,45,629,1091,7293
15000US060374809021,2886,210,1395,1491,7294
15000US060374809022,1132,52,288,844,7295
15000US060374809031,2929,96,988,1941,7296
15000US060374810011,567,30,360,207,7297
15000US060374810012,2342,330,670,1672,7298
15000US060374810013,1269,132,316,953,7299
15000US060374810021,1820,11,1145,675,7300
15000US060374810022,3294,97,1610,1684,7301
15000US060374810023,838,0,274,564,7302
15000US060374811011,2256,155,1064,1192,7303
15000US060374811012,2047,136,996,1051,7304
15000US060374811021,1445,294,238,1207,7305
15000US060374811022,589,53,80,509,7306
15000US060374811023,1748,61,524,1224,7307
15000US060374811031,1498,34,762,736,7308
15000US060374811032,606,7,169,437,7309
15000US060374811033,1324,101,427,897,7310
15000US060374811034,588,22,136,452,7311
15000US060374811035,688,36,103,585,7312
15000US060374812011,810,184,79,731,7313
15000US060374812012,1546,88,307,1239,7314
15000US060374812013,1264,178,333,931,7315
15000US060374812021,2632,183,773,1859,7316
15000US060374812022,1632,252,388,1244,7317
15000US060374812023,1490,266,442,1048,7318
15000US060374813001,1275,66,373,902,7319
15000US060374813002,1926,38,599,1327,7320
15000US060374814011,3506,80,426,3080,7321
15000US060374814012,1917,221,397,1520,7322
15000US060374814013,949,8,149,800,7323
15000US060374814021,1058,13,144,914,7324
15000US060374814022,2305,153,696,1609,7325
15000US060374814023,988,89,92,896,7326
15000US060374814024,851,0,98,753,7327
15000US060374814025,1347,132,223,1124,7328
15000US060374814026,460,35,71,389,7329
15000US060374815001,773,33,71,702,7330
15000US060374815002,710,91,34,676,7331
15000US060374815003,2033,158,467,1566,7332
15000US060374815004,783,27,229,554,7333
15000US060374816031,3032,75,726,2306,7334
15000US060374816032,868,80,133,735,7335
15000US060374816041,856,177,142,714,7336
15000US060374816042,3230,274,939,2291,7337
15000US060374816051,943,97,268,675,7338
15000US060374816052,905,54,321,584,7339
15000US060374816053,1032,42,182,850,7340
15000US060374816061,1873,62,334,1539,7341
15000US060374816062,1963,118,485,1478,7342
15000US060374816063,1210,103,406,804,7343
15000US060374817111,1755,10,40,1715,7344
15000US060374817112,2541,137,182,2359,7345
15000US060374817121,3219,7,566,2653,7346
15000US060374817122,2387,10,382,2005,7347
15000US060374817131,2296,11,548,1748,7348
15000US060374817132,654,35,14,640,7349
15000US060374817141,1431,46,99,1332,7350
15000US060374817142,1068,36,209,859,7351
15000US060374818001,867,105,250,617,7352
15000US060374818002,1383,211,320,1063,7353
15000US060374818003,639,76,122,517,7354
15000US060374819011,1346,175,482,864,7355
15000US060374819012,732,171,160,572,7356
15000US060374819013,1542,354,762,780,7357
15000US060374819014,2025,238,1012,1013,7358
15000US060374819021,3241,219,1658,1583,7359
15000US060374820011,2122,157,298,1824,7360
15000US060374820012,692,92,111,581,7361
15000US060374820021,1267,101,124,1143,7362
15000US060374820022,2928,83,1674,1254,7363
15000US060374820023,1395,16,464,931,7364
15000US060374820024,1179,102,94,1085,7365
15000US060374821011,1033,76,309,724,7366
15000US060374821012,1478,0,567,911,7367
15000US060374821013,2418,89,560,1858,7368
15000US060374821021,1735,158,660,1075,7369
15000US060374821022,1192,136,316,876,7370
15000US060374822011,1318,45,479,839,7371
15000US060374822012,1284,16,178,1106,7372
15000US060374822013,1290,0,255,1035,7373
15000US060374822021,964,25,185,779,7374
15000US060374822022,2311,50,358,1953,7375
15000US060374822023,1925,11,561,1364,7376
15000US060374823011,396,49,27,369,7377
15000US060374823012,1080,277,114,966,7378
15000US060374823013,1211,14,126,1085,7379
15000US060374823014,1156,162,293,863,7380
15000US060374823015,1152,39,433,719,7381
15000US060374823031,1276,123,355,921,7382
15000US060374823032,2617,29,945,1672,7383
15000US060374823033,1952,7,710,1242,7384
15000US060374823041,1876,45,922,954,7385
15000US060374823042,2041,54,1127,914,7386
15000US060374824011,738,17,390,348,7387
15000US060374824012,916,0,399,517,7388
15000US060374824013,2319,16,837,1482,7389
15000US060374824021,2942,54,1238,1704,7390
15000US060374824022,4583,242,1668,2915,7391
15000US060374825021,1411,9,409,1002,7392
15000US060374825022,1668,23,289,1379,7393
15000US060374825031,1993,22,948,1045,7394
15000US060374825032,2342,9,603,1739,7395
15000US060374825211,1935,5,973,962,7396
15000US060374825212,1345,188,354,991,7397
15000US060374825213,2472,101,1055,1417,7398
15000US060374825221,2572,441,911,1661,7399
15000US060374825222,799,24,243,556,7400
15000US060374825223,1559,236,619,940,7401
15000US060374826001,1328,29,170,1158,7402
15000US060374826002,2073,227,359,1714,7403
15000US060374826003,1457,17,742,715,7404
15000US060374826004,1351,150,438,913,7405
15000US060374827011,762,39,421,341,7406
15000US060374827012,939,36,636,303,7407
15000US060374827013,663,6,370,293,7408
15000US060374827014,2193,81,1113,1080,7409
15000US060374827021,1374,115,573,801,7410
15000US060374827022,1039,40,493,546,7411
15000US060374828001,789,112,240,549,7412
15000US060374828002,1160,92,706,454,7413
15000US060374828003,2562,18,1247,1315,7414
15000US060375001001,1654,1015,252,1402,7415
15000US060375001002,1385,572,611,774,7416
15000US060375001003,637,358,103,534,7417
15000US060375002011,2144,1181,302,1842,7418
15000US060375002012,1754,881,715,1039,7419
15000US060375002013,2295,960,1139,1156,7420
15000US060375002021,717,405,265,452,7421
15000US060375002022,785,212,346,439,7422
15000US060375002023,871,312,472,399,7423
15000US060375002024,819,405,398,421,7424
15000US060375002025,1576,435,759,817,7425
15000US060375003001,3268,712,1989,1279,7426
15000US060375004021,1204,0,1204,0,7427
15000US060375004022,1134,117,1006,128,7428
15000US060375004023,2115,75,2029,86,7429
15000US060375004031,1662,135,1480,182,7430
15000US060375004032,2531,22,2198,333,7431
15000US060375004041,1727,89,1638,89,7432
15000US060375004042,552,62,480,72,7433
15000US060375004043,1715,53,1369,346,7434
15000US060375004044,1072,0,855,217,7435
15000US060375005001,2787,143,2394,393,7436
15000US060375006001,834,50,784,50,7437
15000US060375006002,752,6,746,6,7438
15000US060375006003,662,133,491,171,7439
15000US060375006004,2089,14,2068,21,7440
15000US060375006005,1605,32,1553,52,7441
15000US060375007001,1147,35,1112,35,7442
15000US060375007002,1196,89,1064,132,7443
15000US060375007003,1566,101,1443,123,7444
15000US060375007004,1365,112,1238,127,7445
15000US060375007005,1124,41,1083,41,7446
15000US060375007006,243,16,211,32,7447
15000US060375008001,1222,46,1176,46,7448
15000US060375008002,982,93,816,166,7449
15000US060375008003,1221,30,1191,30,7450
15000US060375008004,2107,212,1626,481,7451
15000US060375009001,1180,36,1014,166,7452
15000US060375009002,1640,61,1526,114,7453
15000US060375009003,1934,114,1751,183,7454
15000US060375009004,1251,25,1050,201,7455
15000US060375010011,1443,61,1382,61,7456
15000US060375010012,860,87,773,87,7457
15000US060375010013,1024,5,1019,5,7458
15000US060375010021,998,191,763,235,7459
15000US060375010022,788,28,657,131,7460
15000US060375010023,1256,192,1048,208,7461
15000US060375010024,772,60,685,87,7462
15000US060375010025,1046,154,871,175,7463
15000US060375012001,3438,658,2553,885,7464
15000US060375012002,1916,150,1467,449,7465
15000US060375013001,1126,274,802,324,7466
15000US060375013002,2837,393,2206,631,7467
15000US060375013003,849,137,635,214,7468
15000US060375013004,1000,226,730,270,7469
15000US060375013005,967,112,855,112,7470
15000US060375013006,429,118,155,274,7471
15000US060375014001,1318,92,1162,156,7472
15000US060375014002,1542,98,1444,98,7473
15000US060375014003,1365,100,1234,131,7474
15000US060375015011,2455,865,1209,1246,7475
15000US060375015031,1516,141,1265,251,7476
15000US060375015032,748,280,462,286,7477
15000US060375015033,1362,249,1084,278,7478
15000US060375015034,1268,268,939,329,7479
15000US060375015041,1114,234,692,422,7480
15000US060375015042,1273,194,1024,249,7481
15000US060375015043,1109,147,915,194,7482
15000US060375016001,3400,1335,1330,2070,7483
15000US060375016002,1766,562,1204,562,7484
15000US060375016003,1302,182,965,337,7485
15000US060375016004,1012,377,542,470,7486
15000US060375016005,342,185,138,204,7487
15000US060375017001,802,425,320,482,7488
15000US060375017002,714,270,436,278,7489
15000US060375017003,928,313,568,360,7490
15000US060375017004,1316,265,1051,265,7491
15000US060375018021,1078,259,795,283,7492
15000US060375018022,1099,246,773,326,7493
15000US060375018023,1243,197,1030,213,7494
15000US060375018031,2418,218,2044,374,7495
15000US060375018032,2310,175,2005,305,7496
15000US060375018041,1375,135,1171,204,7497
15000US060375018042,631,77,546,85,7498
15000US060375019001,1360,451,863,497,7499
15000US060375019002,1204,254,944,260,7500
15000US060375019003,908,161,722,186,7501
15000US060375019004,753,126,467,286,7502
15000US060375020031,1121,132,905,216,7503
15000US060375020032,1685,121,1550,135,7504
15000US060375020041,1302,142,970,332,7505
15000US060375020042,2679,111,2491,188,7506
15000US060375020051,1709,308,1282,427,7507
15000US060375020052,1578,226,1174,404,7508
15000US060375020053,1606,509,789,817,7509
15000US060375021001,1042,165,847,195,7510
15000US060375021002,2560,258,2255,305,7511
15000US060375021003,1629,369,1245,384,7512
15000US060375022001,2924,263,2450,474,7513
15000US060375022002,950,149,801,149,7514
15000US060375022003,626,24,602,24,7515
15000US060375022004,907,86,746,161,7516
15000US060375022005,1043,85,949,94,7517
15000US060375023011,1778,108,1669,109,7518
15000US060375023012,849,19,830,19,7519
15000US060375023013,1047,7,745,302,7520
15000US060375023014,1828,8,1820,8,7521
15000US060375023015,618,42,576,42,7522
15000US060375023021,3148,124,2900,248,7523
15000US060375024011,1243,49,1108,135,7524
15000US060375024012,1511,155,1329,182,7525
15000US060375024013,2245,118,2118,127,7526
15000US060375024021,932,51,811,121,7527
15000US060375024022,1035,84,944,91,7528
15000US060375024023,1817,45,1762,55,7529
15000US060375025001,1794,187,1569,225,7530
15000US060375025002,2429,41,2353,76,7531
15000US060375026011,2175,90,2075,100,7532
15000US060375026012,782,39,743,39,7533
15000US060375026013,1664,126,1468,196,7534
15000US060375026014,1649,162,1465,184,7535
15000US060375026015,751,27,724,27,7536
15000US060375026021,2029,155,1841,188,7537
15000US060375026022,1285,168,1038,247,7538
15000US060375026023,1101,112,962,139,7539
15000US060375027001,1500,98,1151,349,7540
15000US060375027002,1357,71,1169,188,7541
15000US060375027003,1305,67,1194,111,7542
15000US060375027004,1215,59,1045,170,7543
15000US060375027005,1315,99,1123,192,7544
15000US060375028011,889,86,731,158,7545
15000US060375028012,2134,231,1832,302,7546
15000US060375028013,1236,84,1140,96,7547
15000US060375028014,1573,130,982,591,7548
15000US060375028015,994,161,787,207,7549
15000US060375028021,1801,197,1413,388,7550
15000US060375028022,749,24,189,560,7551
15000US060375029011,1590,344,1085,505,7552
15000US060375029012,2814,342,2260,554,7553
15000US060375029013,1260,152,1022,238,7554
15000US060375029021,1447,169,1116,331,7555
15000US060375029022,912,81,825,87,7556
15000US060375029023,1763,49,1677,86,7557
15000US060375030001,929,32,685,244,7558
15000US060375030002,2143,77,2021,122,7559
15000US060375030003,2455,57,2383,72,7560
15000US060375031031,2391,112,2043,348,7561
15000US060375031032,1146,194,938,208,7562
15000US060375031033,1121,271,757,364,7563
15000US060375031034,876,16,844,32,7564
15000US060375031041,664,21,610,54,7565
15000US060375031042,2017,335,1638,379,7566
15000US060375031051,1843,261,1454,389,7567
15000US060375031052,2424,366,1858,566,7568
15000US060375031061,1242,304,878,364,7569
15000US060375031062,764,89,659,105,7570
15000US060375031063,1463,398,885,578,7571
15000US060375032011,1406,288,997,409,7572
15000US060375032012,2146,519,1468,678,7573
15000US060375032013,794,204,521,273,7574
15000US060375032021,2182,284,1676,506,7575
15000US060375032022,881,63,731,150,7576
15000US060375032023,1712,287,1266,446,7577
15000US060375033011,816,268,505,311,7578
15000US060375033012,1032,407,617,415,7579
15000US060375033013,599,164,425,174,7580
15000US060375033014,638,235,377,261,7581
15000US060375033021,1706,257,1316,390,7582
15000US060375033022,3512,461,2569,943,7583
15000US060375033023,1397,280,1092,305,7584
15000US060375034011,1139,496,538,601,7585
15000US060375034012,2015,520,1351,664,7586
15000US060375034013,1093,425,478,615,7587
15000US060375034014,1319,503,716,603,7588
15000US060375034015,1270,503,592,678,7589
15000US060375034021,1950,684,1088,862,7590
15000US060375034022,1446,518,889,557,7591
15000US060375034023,896,284,579,317,7592
15000US060375035011,546,210,328,218,7593
15000US060375035012,2543,369,1702,841,7594
15000US060375035013,3605,681,2683,922,7595
15000US060375035021,982,322,584,398,7596
15000US060375035022,1021,166,831,190,7597
15000US060375035023,1166,232,848,318,7598
15000US060375035024,1053,352,611,442,7599
15000US060375036011,2740,994,1600,1140,7600
15000US060375036012,490,253,184,306,7601
15000US060375036013,1067,246,288,779,7602
15000US060375036021,1194,540,502,692,7603
15000US060375036022,2806,1085,1173,1633,7604
15000US060375037011,2376,804,1483,893,7605
15000US060375037012,3070,913,1842,1228,7606
15000US060375037021,1715,908,616,1099,7607
15000US060375037022,3274,1097,2069,1205,7608
15000US060375037031,1678,193,195,1483,7609
15000US060375037032,3046,1156,837,2209,7610
15000US060375037033,3091,783,629,2462,7611
15000US060375038011,1466,452,813,653,7612
15000US060375038012,907,421,337,570,7613
15000US060375038013,688,132,434,254,7614
15000US060375038014,1073,467,349,724,7615
15000US060375038021,1090,463,311,779,7616
15000US060375038022,1033,322,515,518,7617
15000US060375038023,3008,714,1306,1702,7618
15000US060375039011,1252,511,689,563,7619
15000US060375039012,1731,477,603,1128,7620
15000US060375039021,582,225,149,433,7621
15000US060375039022,687,409,245,442,7622
15000US060375039023,1707,389,915,792,7623
15000US060375039024,1599,705,708,891,7624
15000US060375040011,1486,618,779,707,7625
15000US060375040012,3400,1895,715,2685,7626
15000US060375040013,815,347,199,616,7627
15000US060375040021,1235,504,496,739,7628
15000US060375040022,1517,572,609,908,7629
15000US060375040023,428,334,94,334,7630
15000US060375040024,718,286,388,330,7631
15000US060375040025,1315,364,635,680,7632
15000US060375041011,2362,417,1490,872,7633
15000US060375041012,1802,228,1542,260,7634
15000US060375041013,1117,316,389,728,7635
15000US060375041021,0,0,0,0,7636
15000US060375300031,1282,268,627,655,7637
15000US060375300032,1994,376,1329,665,7638
15000US060375300041,521,13,305,216,7639
15000US060375300042,3439,612,2371,1068,7640
15000US060375300051,1877,225,520,1357,7641
15000US060375300052,2641,309,1031,1610,7642
15000US060375300061,2615,404,1545,1070,7643
15000US060375300062,1094,72,841,253,7644
15000US060375301011,2391,277,2045,346,7645
15000US060375301012,1128,33,871,257,7646
15000US060375301013,1158,133,1014,144,7647
15000US060375301014,527,18,414,113,7648
15000US060375301021,1241,437,773,468,7649
15000US060375301022,1476,263,1138,338,7650
15000US060375301023,949,84,777,172,7651
15000US060375301024,1489,163,1044,445,7652
15000US060375302021,1156,66,1006,150,7653
15000US060375302022,1986,94,1763,223,7654
15000US060375302023,1472,16,1429,43,7655
15000US060375302031,2207,56,1929,278,7656
15000US060375302032,780,130,616,164,7657
15000US060375302041,1791,26,1694,97,7658
15000US060375302042,2661,50,2292,369,7659
15000US060375303011,1127,9,1101,26,7660
15000US060375303012,1117,102,1002,115,7661
15000US060375303021,1115,43,982,133,7662
15000US060375303022,2807,111,2689,118,7663
15000US060375303023,1579,0,1579,0,7664
15000US060375303024,1468,105,1202,266,7665
15000US060375304001,1602,10,1450,152,7666
15000US060375304002,2204,28,1274,930,7667
15000US060375305001,1421,61,1333,88,7668
15000US060375305002,934,0,867,67,7669
15000US060375305003,732,10,722,10,7670
15000US060375305004,980,10,966,14,7671
15000US060375306011,2561,46,2380,181,7672
15000US060375306012,868,29,833,35,7673
15000US060375306021,1558,27,1447,111,7674
15000US060375307001,2277,15,2209,68,7675
15000US060375308011,1296,7,1267,29,7676
15000US060375308012,1108,82,1026,82,7677
15000US060375308013,1425,0,1297,128,7678
15000US060375308014,1516,115,1401,115,7679
15000US060375308021,1955,17,1921,34,7680
15000US060375308022,1505,18,1445,60,7681
15000US060375309011,1113,0,1090,23,7682
15000US060375309012,1427,0,1421,6,7683
15000US060375309013,1283,11,1272,11,7684
15000US060375309021,2240,37,2179,61,7685
15000US060375309022,2146,21,1951,195,7686
15000US060375310001,1724,0,1716,8,7687
15000US060375310002,718,0,711,7,7688
15000US060375310003,2898,31,2824,74,7689
15000US060375311011,605,8,588,17,7690
15000US060375311012,1621,14,1584,37,7691
15000US060375311013,1377,0,1359,18,7692
15000US060375311014,1074,4,1022,52,7693
15000US060375311021,2441,50,2387,54,7694
15000US060375311022,975,0,970,5,7695
15000US060375312011,2858,0,2858,0,7696
15000US060375312012,2590,0,2505,85,7697
15000US060375312021,1348,8,1325,23,7698
15000US060375312022,2973,52,2921,52,7699
15000US060375313011,1725,0,1725,0,7700
15000US060375313012,1006,0,1006,0,7701
15000US060375313013,1292,19,1253,39,7702
15000US060375313014,1300,42,1258,42,7703
15000US060375313021,929,48,881,48,7704
15000US060375313022,1132,20,1106,26,7705
15000US060375313023,2200,0,2200,0,7706
15000US060375313024,1542,0,1542,0,7707
15000US060375313025,1246,35,1211,35,7708
15000US060375315021,1260,9,1222,38,7709
15000US060375315022,492,2,490,2,7710
15000US060375315023,578,0,578,0,7711
15000US060375315024,877,0,849,28,7712
15000US060375315031,1262,11,1226,36,7713
15000US060375315032,1575,12,1563,12,7714
15000US060375315041,2850,22,2828,22,7715
15000US060375315042,1599,41,1558,41,7716
15000US060375316021,1183,0,1183,0,7717
15000US060375316022,856,0,856,0,7718
15000US060375316023,2815,71,2744,71,7719
15000US060375316031,837,48,732,105,7720
15000US060375316032,2413,7,2350,63,7721
15000US060375316041,2141,0,2141,0,7722
15000US060375316042,1743,70,1673,70,7723
15000US060375317011,3273,195,3066,207,7724
15000US060375317012,1944,18,1894,50,7725
15000US060375317021,980,0,980,0,7726
15000US060375317022,1197,19,1129,68,7727
15000US060375317023,1617,71,1546,71,7728
15000US060375317024,938,21,917,21,7729
15000US060375318001,1750,0,1750,0,7730
15000US060375318002,2429,36,2393,36,7731
15000US060375318003,983,129,854,129,7732
15000US060375319011,2062,9,2012,50,7733
15000US060375319012,1490,0,1490,0,7734
15000US060375319013,2449,0,2394,55,7735
15000US060375319014,724,0,724,0,7736
15000US060375319021,815,70,745,70,7737
15000US060375319022,1871,33,1838,33,7738
15000US060375319023,1226,89,1137,89,7739
15000US060375320011,1513,149,1287,226,7740
15000US060375320012,1757,17,1505,252,7741
15000US060375320021,578,47,514,64,7742
15000US060375320022,2555,114,2202,353,7743
15000US060375321011,2133,91,1800,333,7744
15000US060375321012,3299,0,3248,51,7745
15000US060375321013,1076,51,967,109,7746
15000US060375321021,1974,96,1719,255,7747
15000US060375321022,1794,154,1461,333,7748
15000US060375322001,2229,53,1880,349,7749
15000US060375322002,1976,7,1871,105,7750
15000US060375322003,2109,106,1790,319,7751
15000US060375323021,1839,2,1791,48,7752
15000US060375323022,1039,0,1039,0,7753
15000US060375323023,1021,10,1004,17,7754
15000US060375323024,1050,0,1042,8,7755
15000US060375323031,912,24,853,59,7756
15000US060375323032,2936,103,2733,203,7757
15000US060375323033,815,0,789,26,7758
15000US060375323041,2943,7,2739,204,7759
15000US060375323042,996,126,601,395,7760
15000US060375324001,88,6,40,48,7761
15000US060375325001,964,11,777,187,7762
15000US060375325002,1440,0,1334,106,7763
15000US060375325003,1612,0,1531,81,7764
15000US060375326031,1004,0,991,13,7765
15000US060375326032,952,0,952,0,7766
15000US060375326033,1043,20,1002,41,7767
15000US060375326041,788,21,756,32,7768
15000US060375326042,2052,0,2052,0,7769
15000US060375326051,722,20,694,28,7770
15000US060375326052,1025,16,1009,16,7771
15000US060375326053,2322,17,2207,115,7772
15000US060375326061,1395,31,1323,72,7773
15000US060375326062,2309,47,2249,60,7774
15000US060375326063,1051,23,1002,49,7775
15000US060375327001,1641,0,1593,48,7776
15000US060375327002,1436,48,1363,73,7777
15000US060375328001,2222,19,2132,90,7778
15000US060375328002,2108,0,1908,200,7779
15000US060375329001,539,65,354,185,7780
15000US060375329002,1799,0,1720,79,7781
15000US060375329003,3138,0,2884,254,7782
15000US060375329004,1592,0,1540,52,7783
15000US060375330011,2492,12,2459,33,7784
15000US060375330012,376,0,376,0,7785
15000US060375330013,1565,2,1498,67,7786
15000US060375330021,1315,20,1222,93,7787
15000US060375330022,1394,36,1353,41,7788
15000US060375331031,1527,40,1440,87,7789
15000US060375331032,1972,30,1942,30,7790
15000US060375331041,1860,37,1823,37,7791
15000US060375331042,2486,80,2404,82,7792
15000US060375331051,2549,30,2505,44,7793
15000US060375331061,1154,10,1144,10,7794
15000US060375331062,604,0,596,8,7795
15000US060375331071,874,14,800,74,7796
15000US060375331072,2720,0,2720,0,7797
15000US060375332011,805,19,786,19,7798
15000US060375332012,2024,43,1981,43,7799
15000US060375332021,1170,22,1142,28,7800
15000US060375332022,1446,10,1436,10,7801
15000US060375332031,836,8,823,13,7802
15000US060375332032,1089,0,1050,39,7803
15000US060375333001,1157,4,1141,16,7804
15000US060375333002,2191,62,2127,64,7805
15000US060375334011,2398,0,2398,0,7806
15000US060375334012,1184,11,1152,32,7807
15000US060375334013,1948,0,1948,0,7808
15000US060375334021,2109,20,2089,20,7809
15000US060375334022,1895,0,1895,0,7810
15000US060375334031,1870,63,1803,67,7811
15000US060375334032,1044,80,948,96,7812
15000US060375335011,1608,30,1578,30,7813
15000US060375335012,1581,9,1567,14,7814
15000US060375335021,1520,42,1478,42,7815
15000US060375335022,697,16,681,16,7816
15000US060375335031,1780,35,1745,35,7817
15000US060375335032,425,0,420,5,7818
15000US060375336011,1709,0,1709,0,7819
15000US060375336012,2194,64,1972,222,7820
15000US060375336013,826,0,826,0,7821
15000US060375336021,1913,5,1908,5,7822
15000US060375336022,2525,73,2452,73,7823
15000US060375336023,955,30,914,41,7824
15000US060375336031,2473,76,2388,85,7825
15000US060375336032,2767,287,2470,297,7826
15000US060375336033,1874,92,1717,157,7827
15000US060375337011,1566,73,1458,108,7828
15000US060375337012,2249,29,2168,81,7829
15000US060375337021,2417,11,2383,34,7830
15000US060375337022,1189,0,1189,0,7831
15000US060375337031,1987,23,1964,23,7832
15000US060375337032,2468,37,2431,37,7833
15000US060375338031,1372,9,1327,45,7834
15000US060375338032,1648,236,1298,350,7835
15000US060375338033,1080,198,860,220,7836
15000US060375338034,2060,251,1743,317,7837
15000US060375338041,1404,7,1253,151,7838
15000US060375338042,3166,88,3051,115,7839
15000US060375338051,2188,21,2167,21,7840
15000US060375338052,774,8,766,8,7841
15000US060375338053,697,10,687,10,7842
15000US060375338061,2888,52,2710,178,7843
15000US060375338062,873,0,873,0,7844
15000US060375339011,1416,22,1394,22,7845
15000US060375339012,1887,7,1880,7,7846
15000US060375339013,2124,0,2124,0,7847
15000US060375339014,964,117,827,137,7848
15000US060375339021,2447,53,2394,53,7849
15000US060375339022,1628,20,1594,34,7850
15000US060375340011,1650,25,1589,61,7851
15000US060375340012,2521,31,2485,36,7852
15000US060375340013,842,24,731,111,7853
15000US060375340021,2894,160,2681,213,7854
15000US060375340022,1516,60,1435,81,7855
15000US060375341011,706,39,612,94,7856
15000US060375341012,1140,15,1045,95,7857
15000US060375341013,472,6,466,6,7858
15000US060375341021,972,18,939,33,7859
15000US060375341022,2267,150,1993,274,7860
15000US060375341023,1804,9,1795,9,7861
15000US060375341024,1496,15,1481,15,7862
15000US060375342011,2831,152,2652,179,7863
15000US060375342012,1790,39,1743,47,7864
15000US060375342021,2690,95,2575,115,7865
15000US060375342022,1625,35,1590,35,7866
15000US060375342023,1592,131,1439,153,7867
15000US060375342031,1698,44,1646,52,7868
15000US060375342032,1833,50,1757,76,7869
15000US060375343011,2502,34,2422,80,7870
15000US060375343012,1989,76,1847,142,7871
15000US060375343021,2074,71,2003,71,7872
15000US060375343022,1735,16,1706,29,7873
15000US060375344031,3008,75,2903,105,7874
15000US060375344041,1616,94,1510,106,7875
15000US060375344042,1915,141,1700,215,7876
15000US060375344051,3290,5,3252,38,7877
15000US060375344052,979,36,935,44,7878
15000US060375344061,2671,36,2635,36,7879
15000US060375344062,2327,61,2257,70,7880
15000US060375345011,1540,30,1510,30,7881
15000US060375345012,1309,12,1297,12,7882
15000US060375345013,2037,94,1927,110,7883
15000US060375345021,1963,21,1942,21,7884
15000US060375345022,912,68,844,68,7885
15000US060375345023,1754,0,1754,0,7886
15000US060375347001,4717,111,4521,196,7887
15000US060375348021,1939,20,1801,138,7888
15000US060375348022,1068,18,1050,18,7889
15000US060375348031,2536,32,2504,32,7890
15000US060375348032,1652,29,1494,158,7891
15000US060375348041,2543,0,2530,13,7892
15000US060375348042,1336,16,1297,39,7893
15000US060375349001,769,10,718,51,7894
15000US060375349002,1685,4,1681,4,7895
15000US060375349003,1230,0,1213,17,7896
15000US060375349004,2212,0,2212,0,7897
15000US060375350011,2212,0,1998,214,7898
15000US060375350012,850,0,830,20,7899
15000US060375350013,1394,0,1215,179,7900
15000US060375350021,1420,5,1334,86,7901
15000US060375350022,910,0,854,56,7902
15000US060375350023,1204,77,1058,146,7903
15000US060375351011,1771,14,1684,87,7904
15000US060375351012,1347,0,1227,120,7905
15000US060375351013,808,0,617,191,7906
15000US060375351014,1891,0,1509,382,7907
15000US060375351015,1905,20,1504,401,7908
15000US060375351021,1022,5,623,399,7909
15000US060375351022,2569,10,2197,372,7910
15000US060375351023,1464,0,1086,378,7911
15000US060375352001,2094,0,1840,254,7912
15000US060375352002,1970,28,1776,194,7913
15000US060375352003,1804,0,1424,380,7914
15000US060375353001,1187,0,1181,6,7915
15000US060375353002,890,0,840,50,7916
15000US060375353003,1858,8,1818,40,7917
15000US060375353004,1173,0,1139,34,7918
15000US060375353005,938,0,830,108,7919
15000US060375354001,1809,5,1664,145,7920
15000US060375354002,614,0,583,31,7921
15000US060375354003,773,10,716,57,7922
15000US060375355011,2001,13,1961,40,7923
15000US060375355012,2166,23,2114,52,7924
15000US060375355021,2927,62,2827,100,7925
15000US060375355022,2111,66,2022,89,7926
15000US060375355031,2401,24,2362,39,7927
15000US060375356031,1210,0,1203,7,7928
15000US060375356032,2107,12,2041,66,7929
15000US060375356041,1560,10,1550,10,7930
15000US060375356042,2764,14,2750,14,7931
15000US060375356051,1791,29,1739,52,7932
15000US060375356052,2754,17,2723,31,7933
15000US060375356061,1943,62,1855,88,7934
15000US060375356071,1755,0,1755,0,7935
15000US060375356072,1164,6,1158,6,7936
15000US060375356073,1024,51,945,79,7937
15000US060375356074,957,0,957,0,7938
15000US060375357011,1454,19,1427,27,7939
15000US060375357012,2444,0,2426,18,7940
15000US060375357013,2180,31,2149,31,7941
15000US060375357021,1098,19,1071,27,7942
15000US060375357022,1048,56,992,56,7943
15000US060375357023,812,140,586,226,7944
15000US060375357024,1644,0,1644,0,7945
15000US060375358021,1463,53,1391,72,7946
15000US060375358022,925,17,900,25,7947
15000US060375358023,1431,155,1276,155,7948
15000US060375358024,2749,106,2643,106,7949
15000US060375358031,1808,14,1768,40,7950
15000US060375358032,1750,22,1720,30,7951
15000US060375358033,894,13,881,13,7952
15000US060375358041,2634,146,2488,146,7953
15000US060375358042,2940,9,2896,44,7954
15000US060375359011,1391,8,1374,17,7955
15000US060375359012,1211,8,1184,27,7956
15000US060375359013,1844,23,1821,23,7957
15000US060375359014,1272,18,1254,18,7958
15000US060375359021,1561,75,1486,75,7959
15000US060375359022,1301,69,1232,69,7960
15000US060375359023,2409,101,2256,153,7961
15000US060375359024,1915,51,1864,51,7962
15000US060375360001,985,31,945,40,7963
15000US060375360002,2969,19,2936,33,7964
15000US060375361021,1537,83,1408,129,7965
15000US060375361022,690,44,639,51,7966
15000US060375361023,1215,504,702,513,7967
15000US060375361031,1020,41,971,49,7968
15000US060375361032,2213,36,2146,67,7969
15000US060375361033,2351,31,2293,58,7970
15000US060375361041,1081,22,917,164,7971
15000US060375361042,1152,36,1063,89,7972
15000US060375361043,1460,10,1425,35,7973
15000US060375361044,595,15,556,39,7974
15000US060375362001,1704,90,1482,222,7975
15000US060375362002,1566,155,1345,221,7976
15000US060375362003,698,108,519,179,7977
15000US060375362004,1621,72,1354,267,7978
15000US060375362005,1549,104,1398,151,7979
15000US060375400001,1997,0,1815,182,7980
15000US060375400002,1833,28,1785,48,7981
15000US060375400003,464,8,443,21,7982
15000US060375400004,2901,73,2622,279,7983
15000US060375401011,1088,7,1027,61,7984
15000US060375401012,1940,0,1728,212,7985
15000US060375401013,1290,50,1173,117,7986
15000US060375401014,2352,21,2108,244,7987
15000US060375401021,1430,0,1166,264,7988
15000US060375401022,1597,20,1537,60,7989
15000US060375401023,2212,127,1845,367,7990
15000US060375401024,1482,0,1218,264,7991
15000US060375402011,1255,7,1198,57,7992
15000US060375402012,906,0,877,29,7993
15000US060375402021,2066,71,1995,71,7994
15000US060375402022,3106,228,2562,544,7995
15000US060375402023,914,30,811,103,7996
15000US060375402024,1048,66,929,119,7997
15000US060375402031,3224,27,2926,298,7998
15000US060375402032,1391,33,1290,101,7999
15000US060375402033,1189,0,996,193,8000
15000US060375403001,1126,0,1126,0,8001
15000US060375403002,1466,38,1419,47,8002
15000US060375403003,440,0,440,0,8003
15000US060375403004,2079,57,2001,78,8004
15000US060375404001,856,0,784,72,8005
15000US060375404002,1738,0,1340,398,8006
15000US060375405011,1109,6,969,140,8007
15000US060375405012,3095,507,1924,1171,8008
15000US060375405013,1071,0,996,75,8009
15000US060375405014,2053,27,1915,138,8010
15000US060375405021,3267,79,2954,313,8011
15000US060375405022,1563,38,1210,353,8012
15000US060375405023,1881,55,1687,194,8013
15000US060375406001,3233,5,1829,1404,8014
15000US060375406002,1498,0,1133,365,8015
15000US060375407001,1073,42,700,373,8016
15000US060375407002,1610,70,702,908,8017
15000US060375407003,779,19,679,100,8018
15000US060375408001,783,0,439,344,8019
15000US060375408002,822,0,434,388,8020
15000US060375408003,767,0,684,83,8021
15000US060375408004,1311,0,705,606,8022
15000US060375408005,2174,2,808,1366,8023
15000US060375409011,1149,101,816,333,8024
15000US060375409012,1505,0,980,525,8025
15000US060375409013,1443,0,908,535,8026
15000US060375409014,468,0,286,182,8027
15000US060375409021,1648,0,749,899,8028
15000US060375409022,1616,6,282,1334,8029
15000US060375409023,1642,0,745,897,8030
15000US060375409024,0,0,0,0,8031
15000US060375410011,1049,31,392,657,8032
15000US060375410021,2963,487,978,1985,8033
15000US060375411001,1268,0,768,500,8034
15000US060375411002,1032,46,233,799,8035
15000US060375411003,561,11,267,294,8036
15000US060375412001,694,11,142,552,8037
15000US060375412002,710,0,130,580,8038
15000US060375412003,1770,0,103,1667,8039
15000US060375412004,1870,12,1556,314,8040
15000US060375412005,1396,7,547,849,8041
15000US060375413001,914,9,547,367,8042
15000US060375413002,716,0,450,266,8043
15000US060375413003,1799,0,932,867,8044
15000US060375413004,1576,2,1320,256,8045
15000US060375413005,977,0,521,456,8046
15000US060375414001,1760,0,1057,703,8047
15000US060375414002,999,36,811,188,8048
15000US060375414003,1164,8,1127,37,8049
15000US060375414004,1063,0,1025,38,8050
15000US060375414005,2475,0,1847,628,8051
15000US060375415001,1690,0,1609,81,8052
15000US060375415002,793,0,709,84,8053
15000US060375415003,1115,0,1093,22,8054
15000US060375415004,2271,32,1862,409,8055
15000US060375416031,1874,64,1635,239,8056
15000US060375416032,1508,15,1126,382,8057
15000US060375416041,2255,47,1815,440,8058
15000US060375416042,2051,8,1926,125,8059
15000US060375416043,2085,103,1278,807,8060
15000US060375416051,957,6,832,125,8061
15000US060375416052,2541,0,2123,418,8062
15000US060375416053,1934,0,1003,931,8063
15000US060375416061,1470,29,1283,187,8064
15000US060375416062,934,6,677,257,8065
15000US060375417001,993,0,985,8,8066
15000US060375417002,1344,6,1273,71,8067
15000US060375417003,1048,10,687,361,8068
15000US060375417004,688,0,657,31,8069
15000US060375417005,1467,7,1276,191,8070
15000US060375417006,794,0,522,272,8071
15000US060375418011,1316,0,1268,48,8072
15000US060375418012,2493,10,2120,373,8073
15000US060375418013,2008,0,1604,404,8074
15000US060375418021,1070,5,994,76,8075
15000US060375418022,1482,0,1080,402,8076
15000US060375418023,1962,6,1655,307,8077
15000US060375418024,937,0,916,21,8078
15000US060375420001,1288,0,715,573,8079
15000US060375420002,1685,0,1367,318,8080
15000US060375420003,2609,107,1877,732,8081
15000US060375421031,1874,0,1696,178,8082
15000US060375421032,873,0,762,111,8083
15000US060375421033,1286,18,953,333,8084
15000US060375421041,1733,12,1556,177,8085
15000US060375421042,1069,30,926,143,8086
15000US060375421043,527,9,258,269,8087
15000US060375421051,1937,0,1802,135,8088
15000US060375421052,837,10,643,194,8089
15000US060375421053,2119,19,1774,345,8090
15000US060375421061,1128,0,863,265,8091
15000US060375421062,1708,21,1427,281,8092
15000US060375421063,559,33,507,52,8093
15000US060375422001,2304,23,1745,559,8094
15000US060375422002,3485,35,2627,858,8095
15000US060375422003,1602,0,1365,237,8096
15000US060375424011,1088,0,558,530,8097
15000US060375424012,1608,1,1366,242,8098
15000US060375424013,897,9,255,642,8099
15000US060375424014,1022,0,682,340,8100
15000US060375424021,1663,34,1251,412,8101
15000US060375424022,824,0,382,442,8102
15000US060375424023,827,13,580,247,8103
15000US060375425011,2835,76,1006,1829,8104
15000US060375425012,2282,0,1388,894,8105
15000US060375425021,1174,25,464,710,8106
15000US060375425022,454,0,251,203,8107
15000US060375425023,1094,9,903,191,8108
15000US060375425024,1791,9,1003,788,8109
15000US060375426011,813,34,642,171,8110
15000US060375426012,1202,2,895,307,8111
15000US060375426013,1136,0,1107,29,8112
15000US060375426021,1427,35,1146,281,8113
15000US060375426022,2968,0,2304,664,8114
15000US060375426023,1053,36,675,378,8115
15000US060375427001,928,11,852,76,8116
15000US060375427002,1010,0,602,408,8117
15000US060375427003,1821,5,1256,565,8118
15000US060375427004,1300,0,1061,239,8119
15000US060375427005,635,48,536,99,8120
15000US060375428001,1390,60,455,935,8121
15000US060375428002,1036,10,521,515,8122
15000US060375428003,666,0,338,328,8123
15000US060375429001,1908,0,1752,156,8124
15000US060375429002,1296,2,604,692,8125
15000US060375430001,788,3,388,400,8126
15000US060375430002,472,0,301,171,8127
15000US060375430003,1199,0,1092,107,8128
15000US060375430004,1461,26,309,1152,8129
15000US060375430005,660,0,39,621,8130
15000US060375431001,1111,0,534,577,8131
15000US060375431002,454,0,69,385,8132
15000US060375431003,873,2,475,398,8133
15000US060375431004,1389,28,900,489,8134
15000US060375431005,505,0,38,467,8135
15000US060375431006,637,0,150,487,8136
15000US060375431007,1533,14,912,621,8137
15000US060375432011,1870,63,1113,757,8138
15000US060375432012,2030,30,1140,890,8139
15000US060375432021,1536,8,880,656,8140
15000US060375432022,1151,13,928,223,8141
15000US060375432023,1328,24,1105,223,8142
15000US060375432024,1113,0,842,271,8143
15000US060375433041,1408,47,313,1095,8144
15000US060375433042,2180,29,331,1849,8145
15000US060375433043,1300,28,119,1181,8146
15000US060375433044,1287,45,312,975,8147
15000US060375433051,3227,949,1110,2117,8148
15000US060375433061,2772,74,486,2286,8149
15000US060375433062,1140,197,468,672,8150
15000US060375433063,429,45,141,288,8151
15000US060375433064,3124,304,1187,1937,8152
15000US060375433211,3275,253,712,2563,8153
15000US060375433212,2370,248,119,2251,8154
15000US060375433221,1983,38,113,1870,8155
15000US060375433222,1213,0,185,1028,8156
15000US060375433223,2180,116,193,1987,8157
15000US060375433224,358,0,29,329,8158
15000US060375433225,1383,0,194,1189,8159
15000US060375434001,1965,96,1212,753,8160
15000US060375434002,1608,71,983,625,8161
15000US060375434003,677,146,146,531,8162
15000US060375435011,1250,93,680,570,8163
15000US060375435012,1255,155,467,788,8164
15000US060375435013,2067,200,638,1429,8165
15000US060375435014,2508,138,612,1896,8166
15000US060375435021,1339,156,802,537,8167
15000US060375435022,1099,99,661,438,8168
15000US060375435023,1595,393,595,1000,8169
15000US060375435031,2751,427,673,2078,8170
15000US060375435032,2779,484,981,1798,8171
15000US060375436011,4165,293,1651,2514,8172
15000US060375436021,4865,716,2264,2601,8173
15000US060375436022,1741,186,500,1241,8174
15000US060375436023,1686,156,438,1248,8175
15000US060375436031,1984,774,416,1568,8176
15000US060375436032,2090,285,426,1664,8177
15000US060375436041,3365,375,1255,2110,8178
15000US060375436042,2390,258,1218,1172,8179
15000US060375437011,1430,74,517,913,8180
15000US060375437012,1438,125,993,445,8181
15000US060375437021,1442,44,791,651,8182
15000US060375437022,2671,60,1545,1126,8183
15000US060375437023,650,51,369,281,8184
15000US060375437024,1221,72,752,469,8185
15000US060375437025,869,115,383,486,8186
15000US060375437031,3479,363,1822,1657,8187
15000US060375438011,2959,448,1359,1600,8188
15000US060375438012,1625,166,858,767,8189
15000US060375438013,811,136,236,575,8190
15000US060375438021,1904,30,392,1512,8191
15000US060375438022,843,81,507,336,8192
15000US060375438023,2126,87,1017,1109,8193
15000US060375438024,1999,94,608,1391,8194
15000US060375439031,1683,158,657,1026,8195
15000US060375439032,2032,222,1034,998,8196
15000US060375439051,748,0,540,208,8197
15000US060375439052,2053,17,1176,877,8198
15000US060375439053,1766,166,1301,465,8199
15000US060375440011,316,53,142,174,8200
15000US060375440012,993,108,588,405,8201
15000US060375440013,1277,69,883,394,8202
15000US060375440014,1980,53,1527,453,8203
15000US060375440021,873,110,350,523,8204
15000US060375440022,1278,51,1035,243,8205
15000US060375440023,1181,170,737,444,8206
15000US060375500001,1648,538,491,1157,8207
15000US060375501001,511,27,390,121,8208
15000US060375501002,1288,194,1034,254,8209
15000US060375501003,1474,45,1226,248,8210
15000US060375501004,1396,101,1223,173,8211
15000US060375501005,982,37,818,164,8212
15000US060375501006,1939,127,1418,521,8213
15000US060375502011,1578,289,1163,415,8214
15000US060375502012,1398,77,1193,205,8215
15000US060375502021,1471,212,1159,312,8216
15000US060375502022,1995,203,1614,381,8217
15000US060375502023,524,168,340,184,8218
15000US060375502024,848,79,459,389,8219
15000US060375502025,989,108,672,317,8220
15000US060375503001,1222,87,1025,197,8221
15000US060375503002,1845,381,1000,845,8222
15000US060375503003,631,319,284,347,8223
15000US060375503004,1458,178,957,501,8224
15000US060375503005,1190,61,945,245,8225
15000US060375503006,467,19,419,48,8226
15000US060375503007,1270,145,1043,227,8227
15000US060375504001,1419,285,1035,384,8228
15000US060375505001,1996,188,1513,483,8229
15000US060375505002,1679,62,1436,243,8230
15000US060375505003,850,125,715,135,8231
15000US060375505004,665,91,388,277,8232
15000US060375505005,1495,147,897,598,8233
15000US060375505006,1283,306,855,428,8234
15000US060375506011,2853,365,2180,673,8235
15000US060375506012,927,227,642,285,8236
15000US060375506013,1091,144,912,179,8237
15000US060375506014,1131,140,862,269,8238
15000US060375506021,704,134,505,199,8239
15000US060375506022,1294,162,995,299,8240
15000US060375506023,1960,398,1368,592,8241
15000US060375506024,792,197,507,285,8242
15000US060375507001,1193,86,913,280,8243
15000US060375507002,1819,255,1501,318,8244
15000US060375507003,759,265,367,392,8245
15000US060375507004,607,116,347,260,8246
15000US060375507005,1519,191,1226,293,8247
15000US060375507006,1021,260,709,312,8248
15000US060375508001,1238,233,840,398,8249
15000US060375508002,665,107,500,165,8250
15000US060375508003,1314,77,1200,114,8251
15000US060375508004,664,89,508,156,8252
15000US060375508005,950,122,810,140,8253
15000US060375508006,1333,393,827,506,8254
15000US060375508007,1316,95,1221,95,8255
15000US060375509011,1792,195,1414,378,8256
15000US060375509012,651,100,373,278,8257
15000US060375509013,1633,199,1292,341,8258
15000US060375509021,1033,235,594,439,8259
15000US060375509022,1970,279,1413,557,8260
15000US060375509023,840,159,658,182,8261
15000US060375509024,2103,114,1863,240,8262
15000US060375510001,1282,523,403,879,8263
15000US060375510002,1174,128,942,232,8264
15000US060375510003,1721,164,1268,453,8265
15000US060375510004,788,219,535,253,8266
15000US060375510005,1279,211,910,369,8267
15000US060375510006,955,269,560,395,8268
15000US060375511011,1341,81,778,563,8269
15000US060375511012,839,49,735,104,8270
15000US060375511013,1846,142,1466,380,8271
15000US060375511021,1074,38,962,112,8272
15000US060375511022,2071,181,1711,360,8273
15000US060375511023,2053,144,1419,634,8274
15000US060375512011,1504,97,1224,280,8275
15000US060375512012,2164,394,1561,603,8276
15000US060375512021,2364,284,2041,323,8277
15000US060375512022,752,197,487,265,8278
15000US060375512023,2096,367,1317,779,8279
15000US060375512024,2318,276,1672,646,8280
15000US060375513001,2189,262,1786,403,8281
15000US060375513002,1265,343,656,609,8282
15000US060375513003,1931,180,1639,292,8283
15000US060375514011,2869,243,2510,359,8284
15000US060375514012,1892,432,1417,475,8285
15000US060375514021,1617,71,1351,266,8286
15000US060375514022,1623,230,999,624,8287
15000US060375514023,1229,273,838,391,8288
15000US060375515011,3245,568,2037,1208,8289
15000US060375515012,1573,340,1192,381,8290
15000US060375515021,1736,735,931,805,8291
15000US060375515022,1323,168,1103,220,8292
15000US060375515023,1370,268,836,534,8293
15000US060375516001,32,20,6,26,8294
15000US060375517001,2395,249,1946,449,8295
15000US060375517002,1091,161,844,247,8296
15000US060375517003,975,99,691,284,8297
15000US060375517004,801,86,715,86,8298
15000US060375517005,794,40,679,115,8299
15000US060375518001,2313,237,1412,901,8300
15000US060375518002,1354,550,725,629,8301
15000US060375518003,1431,298,919,512,8302
15000US060375518004,988,48,780,208,8303
15000US060375518005,1444,97,1309,135,8304
15000US060375519001,948,190,551,397,8305
15000US060375519002,613,45,568,45,8306
15000US060375519003,1133,70,555,578,8307
15000US060375519004,1062,10,830,232,8308
15000US060375519005,764,48,530,234,8309
15000US060375519006,841,153,612,229,8310
15000US060375520011,1352,124,994,358,8311
15000US060375520012,1643,160,1111,532,8312
15000US060375520013,1108,88,830,278,8313
15000US060375520021,1828,250,944,884,8314
15000US060375520022,1001,36,881,120,8315
15000US060375520023,890,8,692,198,8316
15000US060375521001,1347,386,739,608,8317
15000US060375521002,1341,77,646,695,8318
15000US060375521003,1115,108,947,168,8319
15000US060375521004,804,190,530,274,8320
15000US060375521005,1295,224,811,484,8321
15000US060375522001,1884,128,1520,364,8322
15000US060375522002,2439,165,1906,533,8323
15000US060375522003,1421,29,1220,201,8324
15000US060375523011,1289,94,956,333,8325
15000US060375523012,2748,154,1606,1142,8326
15000US060375523013,918,177,696,222,8327
15000US060375523021,1478,23,1085,393,8328
15000US060375523022,690,170,381,309,8329
15000US060375523023,1744,471,581,1163,8330
15000US060375524001,397,0,373,24,8331
15000US060375524002,1166,44,1048,118,8332
15000US060375524003,1012,104,775,237,8333
15000US060375526011,1375,71,1232,143,8334
15000US060375526012,1641,55,1511,130,8335
15000US060375526013,1085,20,951,134,8336
15000US060375526014,1155,72,980,175,8337
15000US060375526021,1187,271,288,899,8338
15000US060375526022,1357,31,905,452,8339
15000US060375526023,2276,82,1509,767,8340
15000US060375527001,2560,436,1875,685,8341
15000US060375527002,730,159,392,338,8342
15000US060375527003,1458,168,1064,394,8343
15000US060375527004,1128,162,955,173,8344
15000US060375527005,1189,195,697,492,8345
15000US060375528001,1127,104,848,279,8346
15000US060375528002,2705,98,2128,577,8347
15000US060375528003,903,241,593,310,8348
15000US060375528004,1334,208,1023,311,8349
15000US060375529001,551,104,373,178,8350
15000US060375529002,1251,244,846,405,8351
15000US060375529003,926,305,511,415,8352
15000US060375529004,2958,139,2178,780,8353
15000US060375529005,1684,152,880,804,8354
15000US060375530001,717,116,489,228,8355
15000US060375530002,1061,60,894,167,8356
15000US060375530003,1924,597,996,928,8357
15000US060375530004,1032,142,648,384,8358
15000US060375531001,2773,490,1253,1520,8359
15000US060375531002,1078,137,717,361,8360
15000US060375531003,680,399,138,542,8361
15000US060375531004,1841,406,893,948,8362
15000US060375532001,1390,233,944,446,8363
15000US060375532002,808,186,391,417,8364
15000US060375532003,824,71,568,256,8365
15000US060375532004,966,252,453,513,8366
15000US060375532005,1868,246,1410,458,8367
15000US060375532006,751,177,361,390,8368
15000US060375532007,1056,162,732,324,8369
15000US060375533001,882,236,611,271,8370
15000US060375533002,950,124,555,395,8371
15000US060375533003,1614,93,1244,370,8372
15000US060375534001,985,136,697,288,8373
15000US060375534002,1450,86,1178,272,8374
15000US060375534003,1128,89,875,253,8375
15000US060375535021,1754,181,1173,581,8376
15000US060375535022,2413,76,2160,253,8377
15000US060375535031,2799,91,2255,544,8378
15000US060375535041,2207,149,1905,302,8379
15000US060375535042,2146,61,1778,368,8380
15000US060375535043,1843,41,1711,132,8381
15000US060375536011,3224,104,2431,793,8382
15000US060375536012,1453,74,1287,166,8383
15000US060375536021,3625,162,2234,1391,8384
15000US060375536022,1508,112,1294,214,8385
15000US060375537011,1191,51,1090,101,8386
15000US060375537012,2034,18,2016,18,8387
15000US060375537013,886,0,864,22,8388
15000US060375537021,2523,0,2239,284,8389
15000US060375537022,2059,0,1971,88,8390
15000US060375538011,1510,0,1412,98,8391
15000US060375538012,1048,32,783,265,8392
15000US060375538013,2274,53,1837,437,8393
15000US060375538021,1131,80,725,406,8394
15000US060375538022,2398,199,1880,518,8395
15000US060375538023,2414,84,1833,581,8396
15000US060375539011,1958,156,1656,302,8397
15000US060375539012,1985,88,1531,454,8398
15000US060375539013,1813,74,1525,288,8399
15000US060375539014,1043,144,881,162,8400
15000US060375539021,2238,93,1808,430,8401
15000US060375539022,1752,276,1300,452,8402
15000US060375539023,1712,235,1238,474,8403
15000US060375540011,1265,216,931,334,8404
15000US060375540012,929,140,532,397,8405
15000US060375540013,882,50,661,221,8406
15000US060375540014,750,269,267,483,8407
15000US060375540021,2027,268,1258,769,8408
15000US060375540022,2807,373,1668,1139,8409
15000US060375540023,1224,366,775,449,8410
15000US060375541011,1184,139,663,521,8411
15000US060375541012,2644,197,2131,513,8412
15000US060375541031,1581,304,845,736,8413
15000US060375541041,1091,117,613,478,8414
15000US060375541042,1419,240,766,653,8415
15000US060375541051,2614,372,1158,1456,8416
15000US060375541052,1894,312,1142,752,8417
15000US060375542011,1254,362,613,641,8418
15000US060375542012,1443,213,932,511,8419
15000US060375542013,1698,195,1026,672,8420
15000US060375542031,748,313,231,517,8421
15000US060375542032,2131,305,1079,1052,8422
15000US060375542033,951,172,603,348,8423
15000US060375542041,377,108,119,258,8424
15000US060375542042,1697,164,708,989,8425
15000US060375542043,2255,197,1593,662,8426
15000US060375543011,1727,123,1552,175,8427
15000US060375543012,1335,203,715,620,8428
15000US060375543013,658,102,245,413,8429
15000US060375543021,2770,145,1654,1116,8430
15000US060375543022,1382,88,755,627,8431
15000US060375544031,2683,348,1225,1458,8432
15000US060375544032,3143,420,1805,1338,8433
15000US060375544041,1526,225,876,650,8434
15000US060375544042,2605,436,909,1696,8435
15000US060375544051,671,303,291,380,8436
15000US060375544052,2191,253,1143,1048,8437
15000US060375544061,2019,711,587,1432,8438
15000US060375544062,581,290,138,443,8439
15000US060375544063,2050,497,590,1460,8440
15000US060375545111,2836,407,257,2579,8441
15000US060375545112,1254,173,77,1177,8442
15000US060375545121,3890,674,189,3701,8443
15000US060375545122,2247,251,181,2066,8444
15000US060375545131,2654,229,232,2422,8445
15000US060375545141,1327,172,476,851,8446
15000US060375545142,1948,260,103,1845,8447
15000US060375545143,1523,173,210,1313,8448
15000US060375545151,1286,213,151,1135,8449
15000US060375545152,2587,486,337,2250,8450
15000US060375545161,2119,221,376,1743,8451
15000US060375545162,1701,146,211,1490,8452
15000US060375545171,2666,282,188,2478,8453
15000US060375545172,1673,140,173,1500,8454
15000US060375545181,1249,247,49,1200,8455
15000US060375545182,2816,347,588,2228,8456
15000US060375545183,1395,191,65,1330,8457
15000US060375545191,1294,268,159,1135,8458
15000US060375545192,2152,388,53,2099,8459
15000US060375545211,2452,633,551,1901,8460
15000US060375545212,1848,360,310,1538,8461
15000US060375545213,1866,380,436,1430,8462
15000US060375545221,1286,409,256,1030,8463
15000US060375545222,1589,253,284,1305,8464
15000US060375545223,2139,388,404,1735,8465
15000US060375546001,2540,302,1148,1392,8466
15000US060375546002,1971,172,1130,841,8467
15000US060375547001,1549,109,1257,292,8468
15000US060375547002,2404,106,1848,556,8469
15000US060375547003,969,88,775,194,8470
15000US060375548011,2389,17,2216,173,8471
15000US060375548012,755,192,207,548,8472
15000US060375548021,2559,631,1079,1480,8473
15000US060375548022,2085,291,525,1560,8474
15000US060375548023,1488,552,197,1291,8475
15000US060375549001,1957,865,325,1632,8476
15000US060375549002,1187,168,195,992,8477
15000US060375549003,369,86,33,336,8478
15000US060375549004,2984,189,1330,1654,8479
15000US060375549005,1016,366,265,751,8480
15000US060375550011,1043,356,419,624,8481
15000US060375550012,746,19,201,545,8482
15000US060375550013,1217,333,408,809,8483
15000US060375550014,2401,121,1645,756,8484
15000US060375550021,1214,117,718,496,8485
15000US060375550022,1938,562,755,1183,8486
15000US060375551021,3794,563,1778,2016,8487
15000US060375551022,2800,262,1351,1449,8488
15000US060375551031,2292,463,679,1613,8489
15000US060375551032,2520,492,722,1798,8490
15000US060375551041,2535,527,733,1802,8491
15000US060375551042,1791,69,1373,418,8492
15000US060375552021,2162,1121,462,1700,8493
15000US060375552022,1233,849,144,1089,8494
15000US060375552111,2254,64,2012,242,8495
15000US060375552112,490,4,437,53,8496
15000US060375552113,2878,90,2462,416,8497
15000US060375552121,4739,514,3474,1265,8498
15000US060375700011,1533,691,557,976,8499
15000US060375700012,929,377,220,709,8500
15000US060375700013,1269,440,457,812,8501
15000US060375700014,983,414,52,931,8502
15000US060375700021,894,251,452,442,8503
15000US060375700022,879,409,349,530,8504
15000US060375700023,1260,503,336,924,8505
15000US060375700031,1096,456,426,670,8506
15000US060375700032,1119,431,109,1010,8507
15000US060375700033,1006,444,412,594,8508
15000US060375700034,403,132,234,169,8509
15000US060375700035,732,265,241,491,8510
15000US060375701001,1133,278,365,768,8511
15000US060375701002,2011,365,592,1419,8512
15000US060375702021,796,87,459,337,8513
15000US060375702022,1064,62,620,444,8514
15000US060375702023,1212,233,711,501,8515
15000US060375702024,730,58,344,386,8516
15000US060375702025,2201,136,1610,591,8517
15000US060375702031,2537,116,1682,855,8518
15000US060375702032,1280,21,669,611,8519
15000US060375702041,1026,279,201,825,8520
15000US060375702042,2943,100,2170,773,8521
15000US060375703011,2867,124,1894,973,8522
15000US060375703012,1434,117,1220,214,8523
15000US060375703013,1634,74,1263,371,8524
15000US060375703014,1884,178,1129,755,8525
15000US060375703031,2261,119,1387,874,8526
15000US060375703032,2439,126,1475,964,8527
15000US060375703041,1480,81,904,576,8528
15000US060375703042,2072,180,1320,752,8529
15000US060375703043,1461,73,952,509,8530
15000US060375704021,1450,65,695,755,8531
15000US060375704022,1026,40,328,698,8532
15000US060375704023,960,37,634,326,8533
15000US060375704031,1343,0,1032,311,8534
15000US060375704032,1461,8,928,533,8535
15000US060375704033,2369,117,1989,380,8536
15000US060375704041,1534,33,806,728,8537
15000US060375704042,1991,47,1677,314,8538
15000US060375705011,1936,207,1408,528,8539
15000US060375705012,1541,205,1032,509,8540
15000US060375705013,1881,330,907,974,8541
15000US060375705014,1875,205,812,1063,8542
15000US060375705021,1373,258,676,697,8543
15000US060375705022,2762,271,1632,1130,8544
15000US060375705023,948,173,473,475,8545
15000US060375705024,1338,172,778,560,8546
15000US060375706011,2558,249,1470,1088,8547
15000US060375706012,1998,118,959,1039,8548
15000US060375706013,1227,86,958,269,8549
15000US060375706021,1658,159,544,1114,8550
15000US060375706022,2285,165,1363,922,8551
15000US060375706023,1635,105,1227,408,8552
15000US060375706024,1092,92,543,549,8553
15000US060375706031,1913,231,764,1149,8554
15000US060375706032,2474,90,814,1660,8555
15000US060375706033,684,24,373,311,8556
15000US060375707011,743,314,368,375,8557
15000US060375707012,2217,190,709,1508,8558
15000US060375707013,1006,286,501,505,8559
15000US060375707014,796,346,57,739,8560
15000US060375707015,1988,422,462,1526,8561
15000US060375707021,1421,478,522,899,8562
15000US060375707022,971,334,327,644,8563
15000US060375708001,908,483,288,620,8564
15000US060375708002,1700,727,657,1043,8565
15000US060375708003,676,374,260,416,8566
15000US060375708004,1171,497,318,853,8567
15000US060375708005,1161,277,568,593,8568
15000US060375709011,1495,617,584,911,8569
15000US060375709012,1529,599,541,988,8570
15000US060375709013,1394,868,255,1139,8571
15000US060375709014,518,374,135,383,8572
15000US060375709015,994,703,184,810,8573
15000US060375709021,780,378,243,537,8574
15000US060375709022,1708,637,955,753,8575
15000US060375709023,1236,731,285,951,8576
15000US060375710001,768,458,179,589,8577
15000US060375710002,974,680,253,721,8578
15000US060375710003,890,586,224,666,8579
15000US060375710004,739,361,352,387,8580
15000US060375710005,755,486,187,568,8581
15000US060375710006,1778,861,536,1242,8582
15000US060375711011,722,388,228,494,8583
15000US060375711012,1138,547,340,798,8584
15000US060375711013,1009,743,143,866,8585
15000US060375711014,978,594,161,817,8586
15000US060375711015,665,377,211,454,8587
15000US060375711021,934,483,152,782,8588
15000US060375711022,717,343,200,517,8589
15000US060375711023,918,404,116,802,8590
15000US060375711024,710,266,283,427,8591
15000US060375711025,770,392,115,655,8592
15000US060375712001,2188,712,683,1505,8593
15000US060375712002,1036,573,182,854,8594
15000US060375712003,462,224,238,224,8595
15000US060375712004,759,256,339,420,8596
15000US060375712005,894,574,80,814,8597
15000US060375712006,1140,352,563,577,8598
15000US060375712007,1469,652,539,930,8599
15000US060375713001,1144,563,387,757,8600
15000US060375713002,762,503,218,544,8601
15000US060375713003,1820,622,296,1524,8602
15000US060375713004,613,343,169,444,8603
15000US060375714001,1122,527,370,752,8604
15000US060375714002,652,287,294,358,8605
15000US060375714003,775,45,366,409,8606
15000US060375714004,1123,406,315,808,8607
15000US060375714005,941,411,307,634,8608
15000US060375715021,1174,341,258,916,8609
15000US060375715022,865,315,237,628,8610
15000US060375715023,1704,390,410,1294,8611
15000US060375715024,691,105,428,263,8612
15000US060375715031,2746,588,943,1803,8613
15000US060375715032,1498,235,361,1137,8614
15000US060375715041,1154,346,369,785,8615
15000US060375715042,887,187,264,623,8616
15000US060375715043,1339,328,441,898,8617
15000US060375715044,1185,139,497,688,8618
15000US060375716001,2068,130,698,1370,8619
15000US060375717011,1319,58,795,524,8620
15000US060375717012,1956,84,1425,531,8621
15000US060375717013,2889,343,1453,1436,8622
15000US060375717031,516,22,345,171,8623
15000US060375717032,2269,147,815,1454,8624
15000US060375717033,391,18,189,202,8625
15000US060375717034,745,68,521,224,8626
15000US060375717041,1886,58,1355,531,8627
15000US060375717042,696,113,395,301,8628
15000US060375717043,1631,115,626,1005,8629
15000US060375718001,1122,884,161,961,8630
15000US060375718002,1035,607,246,789,8631
15000US060375718003,837,242,169,668,8632
15000US060375719001,1514,525,658,856,8633
15000US060375719002,1421,365,356,1065,8634
15000US060375719003,1737,916,199,1538,8635
15000US060375719004,1041,548,235,806,8636
15000US060375720011,2114,1006,509,1605,8637
15000US060375720012,1089,823,151,938,8638
15000US060375720013,1045,541,456,589,8639
15000US060375720014,1024,329,345,679,8640
15000US060375720021,1313,609,412,901,8641
15000US060375720022,2703,612,338,2365,8642
15000US060375720023,1589,607,314,1275,8643
15000US060375721001,1080,240,329,751,8644
15000US060375722011,1725,222,619,1106,8645
15000US060375722012,998,91,476,522,8646
15000US060375722013,2084,375,700,1384,8647
15000US060375722014,2152,288,881,1271,8648
15000US060375722021,669,54,254,415,8649
15000US060375722022,456,81,231,225,8650
15000US060375722023,1013,117,382,631,8651
15000US060375722024,1414,232,347,1067,8652
15000US060375723011,1980,47,1169,811,8653
15000US060375723012,1888,147,1218,670,8654
15000US060375723021,907,49,411,496,8655
15000US060375723022,833,22,413,420,8656
15000US060375723023,1858,70,1037,821,8657
15000US060375724001,1310,144,375,935,8658
15000US060375725001,2245,123,397,1848,8659
15000US060375725002,1070,123,349,721,8660
15000US060375726001,985,17,223,762,8661
15000US060375726002,1589,11,330,1259,8662
15000US060375726003,2156,32,1826,330,8663
15000US060375726004,801,53,172,629,8664
15000US060375727001,756,103,202,554,8665
15000US060375727002,1373,0,579,794,8666
15000US060375727003,1308,52,251,1057,8667
15000US060375727004,1885,139,658,1227,8668
15000US060375728001,1059,196,152,907,8669
15000US060375729001,1963,34,1432,531,8670
15000US060375729002,2312,122,1893,419,8671
15000US060375729003,1246,62,306,940,8672
15000US060375730021,1779,282,1049,730,8673
15000US060375730022,1952,12,1644,308,8674
15000US060375730031,1931,360,843,1088,8675
15000US060375730041,1121,44,632,489,8676
15000US060375730042,1520,42,931,589,8677
15000US060375730043,659,151,212,447,8678
15000US060375730044,1251,55,791,460,8679
15000US060375731001,2236,65,911,1325,8680
15000US060375731002,3785,173,2502,1283,8681
15000US060375731003,1032,195,364,668,8682
15000US060375731004,639,180,259,380,8683
15000US060375732011,2756,90,1366,1390,8684
15000US060375732012,2030,44,1488,542,8685
15000US060375732021,1675,32,891,784,8686
15000US060375732022,2282,176,1342,940,8687
15000US060375732023,2440,138,1797,643,8688
15000US060375733001,3047,66,1083,1964,8689
15000US060375733002,1264,19,595,669,8690
15000US060375734011,1382,355,490,892,8691
15000US060375734021,0,0,0,0,8692
15000US060375734022,843,371,369,474,8693
15000US060375734023,2105,185,1227,878,8694
15000US060375734024,2018,384,680,1338,8695
15000US060375734025,1887,464,809,1078,8696
15000US060375734031,3256,1241,761,2495,8697
15000US060375736011,1487,613,294,1193,8698
15000US060375736012,570,393,127,443,8699
15000US060375736013,654,250,229,425,8700
15000US060375736014,0,0,0,0,8701
15000US060375736015,0,0,0,0,8702
15000US060375736016,572,362,102,470,8703
15000US060375736017,1083,377,541,542,8704
15000US060375736018,718,322,179,539,8705
15000US060375736019,858,428,373,485,8706
15000US060375737001,802,528,141,661,8707
15000US060375737002,613,424,94,519,8708
15000US060375737003,1029,608,244,785,8709
15000US060375737004,1078,490,371,707,8710
15000US060375737005,510,344,162,348,8711
15000US060375737006,711,544,95,616,8712
15000US060375738001,1379,907,296,1083,8713
15000US060375738002,986,685,150,836,8714
15000US060375738003,905,592,204,701,8715
15000US060375738004,1089,687,125,964,8716
15000US060375739021,2089,1267,328,1761,8717
15000US060375740001,844,512,207,637,8718
15000US060375740002,886,564,152,734,8719
15000US060375740003,1218,723,207,1011,8720
15000US060375740004,1088,660,259,829,8721
15000US060375740005,1385,894,372,1013,8722
15000US060375741001,899,419,369,530,8723
15000US060375741002,1310,763,301,1009,8724
15000US060375741003,929,730,142,787,8725
15000US060375741004,1077,761,196,881,8726
15000US060375741005,904,662,74,830,8727
15000US060375742011,951,593,248,703,8728
15000US060375742012,1058,354,384,674,8729
15000US060375742013,603,377,188,415,8730
15000US060375742014,511,390,47,464,8731
15000US060375742021,905,443,370,535,8732
15000US060375742022,1211,630,419,792,8733
15000US060375743001,791,583,68,723,8734
15000US060375743002,669,541,55,614,8735
15000US060375743003,921,400,87,834,8736
15000US060375743004,621,315,154,467,8737
15000US060375743005,834,689,62,772,8738
15000US060375743006,1102,736,132,970,8739
15000US060375743007,850,648,80,770,8740
15000US060375744001,625,465,10,615,8741
15000US060375744002,749,434,147,602,8742
15000US060375744003,1035,745,162,873,8743
15000US060375744004,1251,829,241,1010,8744
15000US060375744005,647,420,150,497,8745
15000US060375744006,708,513,139,569,8746
15000US060375745001,1569,947,340,1229,8747
15000US060375745002,2023,1528,280,1743,8748
15000US060375745003,1556,1076,228,1328,8749
15000US060375745004,1302,900,178,1124,8750
15000US060375746011,2206,886,559,1647,8751
15000US060375746021,1188,774,169,1019,8752
15000US060375747001,148,47,23,125,8753
15000US060375748001,842,677,68,774,8754
15000US060375748002,1259,761,91,1168,8755
15000US060375748003,583,517,27,556,8756
15000US060375749011,974,734,172,802,8757
15000US060375749012,723,423,66,657,8758
15000US060375749013,1202,739,284,918,8759
15000US060375749014,866,659,146,720,8760
15000US060375749021,1036,594,202,834,8761
15000US060375749022,1524,621,206,1318,8762
15000US060375749023,2305,1102,583,1722,8763
15000US060375750011,1086,516,327,759,8764
15000US060375750012,2554,972,629,1925,8765
15000US060375750021,1941,936,381,1560,8766
15000US060375750022,1743,587,771,972,8767
15000US060375750023,1280,756,298,982,8768
15000US060375751011,2518,168,1293,1225,8769
15000US060375751012,1947,437,1175,772,8770
15000US060375751021,2314,295,1555,759,8771
15000US060375751022,1990,105,1014,976,8772
15000US060375751031,2230,309,1078,1152,8773
15000US060375751032,1776,455,676,1100,8774
15000US060375751033,938,382,374,564,8775
15000US060375752011,1096,57,420,676,8776
15000US060375752012,1561,65,823,738,8777
15000US060375752013,2020,25,1221,799,8778
15000US060375752021,2002,32,1126,876,8779
15000US060375752022,1736,13,1107,629,8780
15000US060375752023,1338,53,1010,328,8781
15000US060375753001,1135,62,414,721,8782
15000US060375753002,2386,7,1685,701,8783
15000US060375753003,1747,57,1254,493,8784
15000US060375754011,530,137,274,256,8785
15000US060375754012,513,0,274,239,8786
15000US060375754013,949,60,879,70,8787
15000US060375754014,3292,240,2576,716,8788
15000US060375754021,3601,67,3186,415,8789
15000US060375754022,687,59,467,220,8790
15000US060375755001,43,13,30,13,8791
15000US060375758011,1561,98,1307,254,8792
15000US060375758012,613,93,461,152,8793
15000US060375758021,3002,236,2174,828,8794
15000US060375758022,2313,253,1563,750,8795
15000US060375758031,1578,233,993,585,8796
15000US060375758032,1440,202,960,480,8797
15000US060375759011,1179,295,644,535,8798
15000US060375759012,711,111,376,335,8799
15000US060375759013,587,111,261,326,8800
15000US060375759014,987,151,658,329,8801
15000US060375759021,1414,498,465,949,8802
15000US060375759022,1865,815,479,1386,8803
15000US060375759023,1418,318,690,728,8804
15000US060375760011,1845,746,85,1760,8805
15000US060375760012,2915,1041,505,2410,8806
15000US060375760013,827,335,327,500,8807
15000US060375762001,1543,245,1128,415,8808
15000US060375762002,1060,317,441,619,8809
15000US060375762003,1140,302,434,706,8810
15000US060375762004,695,134,418,277,8811
15000US060375762005,1288,553,400,888,8812
15000US060375763011,885,81,662,223,8813
15000US060375763012,1099,299,345,754,8814
15000US060375763013,1342,209,625,717,8815
15000US060375763014,808,57,422,386,8816
15000US060375763021,1715,56,692,1023,8817
15000US060375763022,1189,151,736,453,8818
15000US060375763023,2426,46,1086,1340,8819
15000US060375764011,2067,128,1109,958,8820
15000US060375764012,3136,150,2464,672,8821
15000US060375764021,2359,161,1819,540,8822
15000US060375764022,2447,160,1521,926,8823
15000US060375764031,2602,190,1397,1205,8824
15000US060375764032,2643,205,1615,1028,8825
15000US060375765011,1473,275,906,567,8826
15000US060375765012,1478,534,617,861,8827
15000US060375765021,2834,610,1553,1281,8828
15000US060375765022,1090,206,313,777,8829
15000US060375765023,1033,309,438,595,8830
15000US060375765031,2363,615,1073,1290,8831
15000US060375765032,2052,765,746,1306,8832
15000US060375766011,2607,1441,753,1854,8833
15000US060375766012,750,453,104,646,8834
15000US060375766013,1072,389,393,679,8835
15000US060375766020,0,0,0,0,8836
15000US060375766021,1543,690,426,1117,8837
15000US060375766022,995,639,238,757,8838
15000US060375766023,845,472,135,710,8839
15000US060375766024,1033,621,240,793,8840
15000US060375767001,1231,873,65,1166,8841
15000US060375767002,797,381,284,513,8842
15000US060375767003,1893,1011,532,1361,8843
15000US060375768011,663,242,295,368,8844
15000US060375768012,1264,693,154,1110,8845
15000US060375768013,2282,612,1151,1131,8846
15000US060375768021,2320,961,815,1505,8847
15000US060375768022,1532,910,299,1233,8848
15000US060375769011,2330,144,1480,850,8849
15000US060375769012,2355,265,1766,589,8850
15000US060375769013,1723,106,1013,710,8851
15000US060375769031,1884,410,1130,754,8852
15000US060375769032,2128,277,1176,952,8853
15000US060375769041,1617,425,913,704,8854
15000US060375769042,1670,601,540,1130,8855
15000US060375770001,2328,697,1087,1241,8856
15000US060375770002,1993,955,700,1293,8857
15000US060375770003,1199,717,311,888,8858
15000US060375770004,851,308,342,509,8859
15000US060375770005,848,660,72,776,8860
15000US060375771001,1532,982,304,1228,8861
15000US060375771002,1083,680,230,853,8862
15000US060375771003,1210,790,303,907,8863
15000US060375771004,1537,1014,226,1311,8864
15000US060375771005,1781,751,713,1068,8865
15000US060375772001,1254,867,301,953,8866
15000US060375772002,1088,622,319,769,8867
15000US060375772003,1006,545,283,723,8868
15000US060375772004,2026,1367,287,1739,8869
15000US060375773001,726,615,45,681,8870
15000US060375773002,1310,884,247,1063,8871
15000US060375773003,513,371,92,421,8872
15000US060375773004,1501,1095,226,1275,8873
15000US060375773005,902,659,158,744,8874
15000US060375773006,438,327,68,370,8875
15000US060375774001,625,433,124,501,8876
15000US060375774002,557,427,81,476,8877
15000US060375774003,961,740,114,847,8878
15000US060375774004,801,619,125,676,8879
15000US060375775011,1211,816,246,965,8880
15000US060375775012,1086,978,61,1025,8881
15000US060375775013,1219,956,66,1153,8882
15000US060375775041,716,524,86,630,8883
15000US060375775042,702,535,50,652,8884
15000US060375776021,1476,969,72,1404,8885
15000US060375776022,1816,1441,220,1596,8886
15000US060375776031,2168,1510,454,1714,8887
15000US060375776032,1653,1258,155,1498,8888
15000US060375776033,1242,1141,44,1198,8889
15000US060375776034,1876,1153,386,1490,8890
15000US060375776035,1025,804,121,904,8891
15000US060375776041,1368,948,231,1137,8892
15000US060375990001,514,73,440,74,8893
15000US060375990002,420,260,148,272,8894
15000US060375990003,654,188,466,188,8895
15000US060375990004,1993,443,1499,494,8896
15000US060375991001,148,115,17,131,8897
15000US060375991002,331,192,119,212,8898
15000US060376001001,2902,4,1539,1363,8899
15000US060376001002,1754,15,1271,483,8900
15000US060376001003,2035,109,959,1076,8901
15000US060376002011,1487,43,868,619,8902
15000US060376002012,1599,0,1073,526,8903
15000US060376002013,1309,5,894,415,8904
15000US060376002021,1999,21,1358,641,8905
15000US060376002022,2878,0,922,1956,8906
15000US060376002023,1820,60,832,988,8907
15000US060376003021,1269,8,499,770,8908
15000US060376003022,674,0,134,540,8909
15000US060376003023,929,31,127,802,8910
15000US060376003031,595,36,364,231,8911
15000US060376003032,1092,18,465,627,8912
15000US060376003033,2167,14,1207,960,8913
15000US060376003041,1622,77,975,647,8914
15000US060376003042,964,0,749,215,8915
15000US060376003043,826,11,330,496,8916
15000US060376004001,990,0,0,990,8917
15000US060376004002,530,45,26,504,8918
15000US060376004003,1588,3,629,959,8919
15000US060376004004,1118,39,103,1015,8920
15000US060376005011,1360,0,262,1098,8921
15000US060376005012,1300,19,361,939,8922
15000US060376005021,970,36,462,508,8923
15000US060376005022,1224,31,564,660,8924
15000US060376006011,685,16,72,613,8925
15000US060376006012,1321,46,67,1254,8926
15000US060376006013,609,0,8,601,8927
15000US060376006021,2546,37,1522,1024,8928
15000US060376007021,1090,34,4,1086,8929
15000US060376007022,865,18,197,668,8930
15000US060376007023,3012,129,585,2427,8931
15000US060376007031,1966,52,23,1943,8932
15000US060376007041,1352,21,144,1208,8933
15000US060376007042,1733,74,286,1447,8934
15000US060376008011,763,68,123,640,8935
15000US060376008012,607,0,229,378,8936
15000US060376008013,1012,9,324,688,8937
15000US060376008014,1084,0,188,896,8938
15000US060376008021,818,7,4,814,8939
15000US060376008022,717,20,42,675,8940
15000US060376008023,823,8,313,510,8941
15000US060376009021,1024,24,491,533,8942
15000US060376009022,1950,77,979,971,8943
15000US060376009023,1866,28,1212,654,8944
15000US060376009024,2034,163,552,1482,8945
15000US060376009111,1444,19,1155,289,8946
15000US060376009112,1907,207,951,956,8947
15000US060376009121,2479,116,1764,715,8948
15000US060376009122,2131,116,1772,359,8949
15000US060376009123,1084,24,791,293,8950
15000US060376010011,668,32,9,659,8951
15000US060376010012,1281,115,331,950,8952
15000US060376010021,1320,6,826,494,8953
15000US060376010022,1864,7,940,924,8954
15000US060376010023,1869,66,374,1495,8955
15000US060376011001,2010,2,1152,858,8956
15000US060376011002,2350,40,1319,1031,8957
15000US060376011003,2024,84,1170,854,8958
15000US060376012021,1790,18,1676,114,8959
15000US060376012022,1016,97,836,180,8960
15000US060376012023,1062,34,912,150,8961
15000US060376012111,1426,26,731,695,8962
15000US060376012112,1627,88,845,782,8963
15000US060376012121,3880,149,2534,1346,8964
15000US060376012122,2590,0,1886,704,8965
15000US060376013011,755,98,114,641,8966
15000US060376013012,1187,204,278,909,8967
15000US060376013021,920,27,196,724,8968
15000US060376013022,2026,190,260,1766,8969
15000US060376013023,1882,92,369,1513,8970
15000US060376013024,2706,158,998,1708,8971
15000US060376013031,1559,53,374,1185,8972
15000US060376013032,1148,77,339,809,8973
15000US060376013033,2285,144,748,1537,8974
15000US060376014011,1968,63,696,1272,8975
15000US060376014012,1169,31,965,204,8976
15000US060376014013,2209,213,1386,823,8977
15000US060376014021,1591,24,1501,90,8978
15000US060376014022,1268,51,1106,162,8979
15000US060376014023,1019,28,936,83,8980
15000US060376014024,1261,55,1144,117,8981
15000US060376015011,1474,62,1396,78,8982
15000US060376015012,2508,59,1935,573,8983
15000US060376015021,3008,52,2763,245,8984
15000US060376015022,1048,49,999,49,8985
15000US060376016001,892,0,853,39,8986
15000US060376016002,1991,0,1991,0,8987
15000US060376016003,1473,55,1267,206,8988
15000US060376017001,454,0,454,0,8989
15000US060376017002,1887,51,1630,257,8990
15000US060376017003,1371,23,1131,240,8991
15000US060376017004,1798,56,1691,107,8992
15000US060376018011,2392,13,2320,72,8993
15000US060376018012,1158,4,1124,34,8994
15000US060376018021,2654,33,2614,40,8995
15000US060376018022,1470,24,1438,32,8996
15000US060376019001,2930,56,1912,1018,8997
15000US060376019002,2241,17,1933,308,8998
15000US060376020021,989,6,870,119,8999
15000US060376020022,2193,121,1653,540,9000
15000US060376020031,2499,42,2033,466,9001
15000US060376020032,2206,7,1946,260,9002
15000US060376020041,2433,167,1777,656,9003
15000US060376020042,1320,19,936,384,9004
15000US060376021031,1951,186,1387,564,9005
15000US060376021032,2049,308,1355,694,9006
15000US060376021033,2839,12,2344,495,9007
15000US060376021041,3380,195,2420,960,9008
15000US060376021042,2380,71,1839,541,9009
15000US060376021051,1022,78,716,306,9010
15000US060376021052,2684,162,1954,730,9011
15000US060376021053,786,24,609,177,9012
15000US060376021061,2896,177,1826,1070,9013
15000US060376021062,1610,208,902,708,9014
15000US060376021063,960,31,827,133,9015
15000US060376022001,1944,485,717,1227,9016
15000US060376022002,644,306,307,337,9017
15000US060376022003,485,276,161,324,9018
15000US060376022004,2026,677,756,1270,9019
15000US060376022005,3103,241,2058,1045,9020
15000US060376023011,1601,236,1121,480,9021
15000US060376023012,1313,520,600,713,9022
15000US060376023013,1451,362,1022,429,9023
15000US060376023014,840,165,444,396,9024
15000US060376023015,1231,511,557,674,9025
15000US060376023021,962,799,141,821,9026
15000US060376023022,571,261,109,462,9027
15000US060376023023,764,438,217,547,9028
15000US060376023024,1439,836,307,1132,9029
15000US060376024021,1225,125,768,457,9030
15000US060376024022,1434,106,935,499,9031
15000US060376024023,713,89,352,361,9032
15000US060376024024,1146,235,742,404,9033
15000US060376024025,614,217,250,364,9034
15000US060376024026,1243,167,859,384,9035
15000US060376024031,1574,65,1021,553,9036
15000US060376024032,2096,74,1316,780,9037
15000US060376024033,1718,66,765,953,9038
15000US060376024041,1995,134,1161,834,9039
15000US060376024042,1545,284,835,710,9040
15000US060376024043,2705,92,1684,1021,9041
15000US060376025041,3104,101,1464,1640,9042
15000US060376025042,1424,75,544,880,9043
15000US060376025051,3071,163,1390,1681,9044
15000US060376025052,1308,114,891,417,9045
15000US060376025061,1740,65,943,797,9046
15000US060376025062,2390,86,1047,1343,9047
15000US060376025071,2644,119,745,1899,9048
15000US060376025072,1923,61,870,1053,9049
15000US060376025081,1452,70,824,628,9050
15000US060376025082,1988,113,888,1100,9051
15000US060376025083,1862,43,1261,601,9052
15000US060376025084,1813,175,542,1271,9053
15000US060376025091,1830,16,1370,460,9054
15000US060376025092,996,84,564,432,9055
15000US060376025093,753,52,319,434,9056
15000US060376025094,558,0,401,157,9057
15000US060376026001,980,98,66,914,9058
15000US060376026002,1457,33,175,1282,9059
15000US060376026003,1312,26,262,1050,9060
15000US060376026004,1137,53,7,1130,9061
15000US060376026005,591,25,38,553,9062
15000US060376026006,1263,77,190,1073,9063
15000US060376026007,1964,13,963,1001,9064
15000US060376027001,998,14,152,846,9065
15000US060376027002,805,54,0,805,9066
15000US060376027003,727,0,250,477,9067
15000US060376027004,1158,57,424,734,9068
15000US060376028011,2931,47,1963,968,9069
15000US060376028012,588,0,247,341,9070
15000US060376028021,1097,4,381,716,9071
15000US060376028022,906,8,339,567,9072
15000US060376028023,643,8,177,466,9073
15000US060376028024,1119,0,255,864,9074
15000US060376029001,1359,81,1041,318,9075
15000US060376029002,1496,106,1163,333,9076
15000US060376029003,1381,92,977,404,9077
15000US060376030011,1150,76,458,692,9078
15000US060376030012,1694,0,1022,672,9079
15000US060376030013,2045,179,750,1295,9080
15000US060376030014,2527,9,982,1545,9081
15000US060376030041,1466,64,332,1134,9082
15000US060376030051,1956,121,999,957,9083
15000US060376030052,2124,175,942,1182,9084
15000US060376030053,1558,50,587,971,9085
15000US060376030061,1316,151,380,936,9086
15000US060376030062,619,47,94,525,9087
15000US060376031011,1186,207,415,771,9088
15000US060376031012,1318,160,387,931,9089
15000US060376031013,1493,180,406,1087,9090
15000US060376031021,1584,49,736,848,9091
15000US060376031022,1346,102,562,784,9092
15000US060376031023,806,84,324,482,9093
15000US060376032001,971,46,532,439,9094
15000US060376032002,1096,160,245,851,9095
15000US060376032003,1253,92,129,1124,9096
15000US060376033011,843,207,90,753,9097
15000US060376033012,1510,20,339,1171,9098
15000US060376033013,1278,31,398,880,9099
15000US060376033021,1098,83,541,557,9100
15000US060376033022,2053,289,575,1478,9101
15000US060376033023,955,213,505,450,9102
15000US060376034001,1785,126,1136,649,9103
15000US060376034002,1340,398,279,1061,9104
15000US060376034003,1298,130,390,908,9105
15000US060376035001,806,190,325,481,9106
15000US060376035002,1067,106,381,686,9107
15000US060376035003,1123,92,679,444,9108
15000US060376036001,1225,476,301,924,9109
15000US060376036002,1053,464,354,699,9110
15000US060376036003,2016,321,745,1271,9111
15000US060376037021,734,159,279,455,9112
15000US060376037022,1031,433,289,742,9113
15000US060376037023,1750,424,542,1208,9114
15000US060376037024,1457,496,379,1078,9115
15000US060376037031,669,138,288,381,9116
15000US060376037032,1029,358,437,592,9117
15000US060376037033,877,193,527,350,9118
15000US060376037041,1423,68,874,549,9119
15000US060376037042,3544,96,1587,1957,9120
15000US060376037043,1683,26,1214,469,9121
15000US060376038011,2440,112,1120,1320,9122
15000US060376038012,878,73,578,300,9123
15000US060376038013,1445,173,1058,387,9124
15000US060376038021,2298,277,1567,731,9125
15000US060376038022,1792,188,1083,709,9126
15000US060376039001,892,81,752,140,9127
15000US060376039002,629,63,353,276,9128
15000US060376039003,663,88,504,159,9129
15000US060376039004,1684,244,1035,649,9130
15000US060376039005,954,100,828,126,9131
15000US060376039006,2912,477,1751,1161,9132
15000US060376040011,2004,154,1563,441,9133
15000US060376040012,1581,423,833,748,9134
15000US060376040013,965,221,614,351,9135
15000US060376040021,1230,162,853,377,9136
15000US060376040022,2192,390,1222,970,9137
15000US060376040023,1021,194,551,470,9138
15000US060376040024,412,152,196,216,9139
15000US060376041001,1566,81,1066,500,9140
15000US060376041002,904,338,492,412,9141
15000US060376041003,910,65,771,139,9142
15000US060376041004,1982,447,706,1276,9143
15000US060376041005,1807,394,1164,643,9144
15000US060376099001,1165,277,827,338,9145
15000US060376099002,812,361,298,514,9146
15000US060376200011,1111,900,112,999,9147
15000US060376200012,1206,664,222,984,9148
15000US060376200013,1602,1017,412,1190,9149
15000US060376200021,1030,656,179,851,9150
15000US060376200022,1336,720,414,922,9151
15000US060376200023,1144,805,123,1021,9152
15000US060376201011,1377,859,264,1113,9153
15000US060376201012,1685,1388,197,1488,9154
15000US060376201013,2563,1519,496,2067,9155
15000US060376201021,1072,666,255,817,9156
15000US060376201022,915,647,166,749,9157
15000US060376201023,1860,1434,234,1626,9158
15000US060376202011,640,518,49,591,9159
15000US060376202012,782,575,124,658,9160
15000US060376203011,1272,910,177,1095,9161
15000US060376203012,1489,1066,289,1200,9162
15000US060376203013,1164,1006,62,1102,9163
15000US060376203014,1118,983,36,1082,9164
15000US060376203031,1427,1097,143,1284,9165
15000US060376203032,1093,774,27,1066,9166
15000US060376203033,958,838,72,886,9167
15000US060376203034,793,711,6,787,9168
15000US060376203051,465,359,66,399,9169
15000US060376203052,1349,1065,70,1279,9170
15000US060376203053,624,446,16,608,9171
15000US060376203054,581,429,122,459,9172
15000US060376203055,877,709,64,813,9173
15000US060376203056,612,583,0,612,9174
15000US060376203057,1234,1070,31,1203,9175
15000US060376204001,1540,998,134,1406,9176
15000US060376204002,986,818,50,936,9177
15000US060376204003,1293,828,96,1197,9178
15000US060376204004,1394,1128,37,1357,9179
15000US060376205011,1186,714,36,1150,9180
15000US060376205012,708,487,41,667,9181
15000US060376205013,1296,661,223,1073,9182
15000US060376205014,844,351,291,553,9183
15000US060376205015,566,465,81,485,9184
15000US060376205016,1654,747,360,1294,9185
15000US060376205211,953,561,205,748,9186
15000US060376205212,1183,570,101,1082,9187
15000US060376205213,894,278,275,619,9188
15000US060376205214,933,473,319,614,9189
15000US060376205221,1130,661,142,988,9190
15000US060376205222,1988,1215,209,1779,9191
15000US060376205223,1723,832,370,1353,9192
15000US060376206011,874,313,301,573,9193
15000US060376206012,1307,631,253,1054,9194
15000US060376206013,1493,933,248,1245,9195
15000US060376206014,1636,921,338,1298,9196
15000US060376206021,954,575,277,677,9197
15000US060376206022,886,690,170,716,9198
15000US060376206023,767,360,321,446,9199
15000US060376206024,1513,689,345,1168,9200
15000US060376206025,1398,837,229,1169,9201
15000US060376207011,2270,1247,372,1898,9202
15000US060376207012,1464,999,349,1115,9203
15000US060376207013,1100,901,70,1030,9204
15000US060376207014,1715,1041,86,1629,9205
15000US060376207021,821,480,178,643,9206
15000US060376207022,2022,1039,543,1479,9207
15000US060376207023,1459,1021,105,1354,9208
15000US060376207024,1543,1206,33,1510,9209
15000US060376207025,1159,572,219,940,9210
15000US060376208001,839,573,93,746,9211
15000US060376208002,921,615,78,843,9212
15000US060376208003,1179,662,205,974,9213
15000US060376208004,1224,821,53,1171,9214
15000US060376208005,1242,1026,89,1153,9215
15000US060376208006,1176,639,162,1014,9216
15000US060376208007,751,478,127,624,9217
15000US060376208008,858,344,79,779,9218
15000US060376209011,1310,902,212,1098,9219
15000US060376209012,748,560,43,705,9220
15000US060376209013,782,693,56,726,9221
15000US060376209041,632,579,0,632,9222
15000US060376209042,500,446,32,468,9223
15000US060376209043,620,513,15,605,9224
15000US060376209044,1100,1057,19,1081,9225
15000US060376210011,3238,2531,376,2862,9226
15000US060376210012,1302,967,124,1178,9227
15000US060376210021,1005,916,13,992,9228
15000US060376210041,860,826,0,860,9229
15000US060376210042,1141,986,2,1139,9230
15000US060376210043,658,539,72,586,9231
15000US060376210044,862,748,98,764,9232
15000US060376210045,782,659,76,706,9233
15000US060376211021,1154,1022,98,1056,9234
15000US060376211022,1843,1559,121,1722,9235
15000US060376211041,1661,1442,75,1586,9236
15000US060376211042,630,587,28,602,9237
15000US060376211043,873,525,108,765,9238
15000US060376211044,2586,1870,296,2290,9239
15000US060376211045,1131,950,75,1056,9240
15000US060376212011,1668,951,423,1245,9241
15000US060376212012,2445,1958,382,2063,9242
15000US060376212013,2179,1209,505,1674,9243
15000US060376212041,2470,1495,388,2082,9244
15000US060376212042,691,392,211,480,9245
15000US060376213011,3286,1948,699,2587,9246
15000US060376213012,1321,1025,206,1115,9247
15000US060376213013,1394,831,75,1319,9248
15000US060376213014,1436,1186,95,1341,9249
15000US060376213241,2688,2188,257,2431,9250
15000US060376213242,1289,813,329,960,9251
15000US060376213261,825,632,104,721,9252
15000US060376213262,855,519,149,706,9253
15000US060376213263,1310,1054,115,1195,9254
15000US060376214001,1434,975,144,1290,9255
15000US060376214002,1436,1078,145,1291,9256
15000US060376214003,572,527,13,559,9257
15000US060376214004,926,709,151,775,9258
15000US060376500011,1409,165,357,1052,9259
15000US060376500012,677,131,206,471,9260
15000US060376500013,2052,548,229,1823,9261
15000US060376500014,958,123,406,552,9262
15000US060376500015,889,280,241,648,9263
15000US060376500031,1938,385,524,1414,9264
15000US060376500032,1247,329,467,780,9265
15000US060376500041,1160,357,177,983,9266
15000US060376500042,1091,237,170,921,9267
15000US060376500043,1119,317,155,964,9268
15000US060376500044,592,152,237,355,9269
15000US060376501011,1785,203,173,1612,9270
15000US060376501012,758,110,97,661,9271
15000US060376501013,2026,591,361,1665,9272
15000US060376501014,1343,290,332,1011,9273
15000US060376501021,691,251,205,486,9274
15000US060376501022,1681,588,420,1261,9275
15000US060376502001,935,507,176,759,9276
15000US060376502002,936,264,126,810,9277
15000US060376502003,2249,868,782,1467,9278
15000US060376502004,2236,911,930,1306,9279
15000US060376503001,937,172,459,478,9280
15000US060376503002,1608,673,539,1069,9281
15000US060376503003,1359,307,369,990,9282
15000US060376503004,1580,247,206,1374,9283
15000US060376503005,1406,626,96,1310,9284
15000US060376504011,1114,532,83,1031,9285
15000US060376504012,793,312,59,734,9286
15000US060376504013,1116,388,251,865,9287
15000US060376504014,860,472,53,807,9288
15000US060376504015,724,450,143,581,9289
15000US060376505011,1391,784,292,1099,9290
15000US060376505012,928,383,52,876,9291
15000US060376505013,787,468,114,673,9292
15000US060376505021,1070,519,19,1051,9293
15000US060376505022,697,438,73,624,9294
15000US060376505023,2513,1113,591,1922,9295
15000US060376506021,2483,947,332,2151,9296
15000US060376506022,1895,760,296,1599,9297
15000US060376506023,2851,655,91,2760,9298
15000US060376506031,2265,1101,264,2001,9299
15000US060376506032,1475,734,152,1323,9300
15000US060376506041,3096,1464,659,2437,9301
15000US060376506042,2845,620,160,2685,9302
15000US060376506051,2755,1224,184,2571,9303
15000US060376507011,803,490,92,711,9304
15000US060376507012,1591,798,261,1330,9305
15000US060376507021,1273,581,178,1095,9306
15000US060376507022,571,264,170,401,9307
15000US060376507023,1618,889,96,1522,9308
15000US060376507024,742,447,148,594,9309
15000US060376507025,528,442,39,489,9310
15000US060376508001,2075,640,0,2075,9311
15000US060376508002,1467,499,23,1444,9312
15000US060376508003,3187,354,249,2938,9313
15000US060376509011,2442,864,928,1514,9314
15000US060376509012,1784,593,859,925,9315
15000US060376509013,932,446,243,689,9316
15000US060376509014,989,473,164,825,9317
15000US060376509021,1561,664,444,1117,9318
15000US060376509022,2027,475,1026,1001,9319
15000US060376509023,2762,957,478,2284,9320
15000US060376510011,1341,402,600,741,9321
15000US060376510012,1282,391,291,991,9322
15000US060376510013,2642,861,1001,1641,9323
15000US060376510014,926,555,102,824,9324
15000US060376510021,1312,532,423,889,9325
15000US060376510022,1459,577,189,1270,9326
15000US060376510023,958,353,69,889,9327
15000US060376510024,1285,275,349,936,9328
15000US060376511011,2708,1301,281,2427,9329
15000US060376511012,2483,970,350,2133,9330
15000US060376511021,2294,774,637,1657,9331
15000US060376511022,1670,1013,93,1577,9332
15000US060376512011,859,666,42,817,9333
15000US060376512012,1179,821,62,1117,9334
15000US060376512013,627,422,51,576,9335
15000US060376512014,989,604,94,895,9336
15000US060376512015,1131,736,68,1063,9337
15000US060376512211,3373,1144,471,2902,9338
15000US060376512221,3137,951,598,2539,9339
15000US060376512222,2944,1101,369,2575,9340
15000US060376513021,1440,949,173,1267,9341
15000US060376513022,1835,1095,251,1584,9342
15000US060376513023,714,456,85,629,9343
15000US060376513024,589,498,0,589,9344
15000US060376513025,874,796,58,816,9345
15000US060376513026,836,698,0,836,9346
15000US060376513041,884,562,157,727,9347
15000US060376513042,902,794,39,863,9348
15000US060376513043,1290,835,153,1137,9349
15000US060376513044,834,798,36,798,9350
15000US060376513045,940,644,60,880,9351
15000US060376514011,1228,827,150,1078,9352
15000US060376514012,1375,861,57,1318,9353
15000US060376514021,1125,197,307,818,9354
15000US060376514022,1619,719,237,1382,9355
15000US060376514023,2255,955,152,2103,9356
15000US060376514024,1296,385,204,1092,9357
15000US060376700011,1938,862,495,1443,9358
15000US060376700012,1376,657,450,926,9359
15000US060376700021,1437,528,571,866,9360
15000US060376700022,2572,1198,755,1817,9361
15000US060376700031,546,397,129,417,9362
15000US060376700032,1403,349,481,922,9363
15000US060376700033,1018,596,218,800,9364
15000US060376700034,2568,1072,1197,1371,9365
15000US060376701001,3257,1107,1111,2146,9366
15000US060376701002,755,461,185,570,9367
15000US060376701003,2139,1227,132,2007,9368
15000US060376701004,742,302,288,454,9369
15000US060376702011,1218,763,95,1123,9370
15000US060376702012,2592,1593,309,2283,9371
15000US060376702021,2728,1665,353,2375,9372
15000US060376703241,1320,1095,76,1244,9373
15000US060376703242,724,607,45,679,9374
15000US060376703243,1314,952,18,1296,9375
15000US060376703244,1784,1203,160,1624,9376
15000US060376703261,1364,653,100,1264,9377
15000US060376703262,1578,806,207,1371,9378
15000US060376703263,534,446,8,526,9379
15000US060376703281,1102,850,22,1080,9380
15000US060376703282,1224,824,205,1019,9381
15000US060376703283,2638,1596,67,2571,9382
15000US060376704031,2685,1484,139,2546,9383
15000US060376704051,3012,1478,220,2792,9384
15000US060376704061,1950,869,81,1869,9385
15000US060376704071,3475,1335,376,3099,9386
15000US060376704072,1033,541,130,903,9387
15000US060376704073,1693,583,136,1557,9388
15000US060376704111,2447,1462,107,2340,9389
15000US060376704112,2031,1283,104,1927,9390
15000US060376704131,2162,831,210,1952,9391
15000US060376704132,2724,1199,318,2406,9392
15000US060376704161,1436,798,154,1282,9393
15000US060376704162,2678,1098,172,2506,9394
15000US060376705001,1760,1267,120,1640,9395
15000US060376706021,2826,1875,255,2571,9396
15000US060376706022,1522,1120,39,1483,9397
15000US060376706023,2701,1427,178,2523,9398
15000US060376707011,3048,1298,1070,1978,9399
15000US060376707012,2129,1226,457,1672,9400
15000US060376707013,1219,531,205,1014,9401
15000US060376707014,931,573,73,858,9402
15000US060376707021,1844,1209,189,1655,9403
15000US060376707022,654,524,94,560,9404
15000US060376707023,1426,863,243,1183,9405
15000US060376707024,1443,1164,208,1235,9406
15000US060377001011,505,437,37,468,9407
15000US060377001012,1286,918,205,1081,9408
15000US060377001013,1022,876,70,952,9409
15000US060377001014,1367,1192,114,1253,9410
15000US060377001015,879,701,130,749,9411
15000US060377001021,943,643,154,789,9412
15000US060377001022,1329,772,310,1019,9413
15000US060377001023,1415,972,206,1209,9414
15000US060377002001,3168,2395,245,2923,9415
15000US060377002002,408,336,40,368,9416
15000US060377002003,375,333,18,357,9417
15000US060377002004,576,394,160,416,9418
15000US060377002005,2417,1981,178,2239,9419
15000US060377003001,1584,1196,165,1419,9420
15000US060377003002,1454,1063,177,1277,9421
15000US060377003003,951,745,138,813,9422
15000US060377003004,2320,1898,173,2147,9423
15000US060377004001,2114,1547,237,1877,9424
15000US060377004002,670,625,16,654,9425
15000US060377004003,1714,1065,185,1529,9426
15000US060377004004,1020,822,110,910,9427
15000US060377005011,1391,777,317,1074,9428
15000US060377005012,996,605,124,872,9429
15000US060377005013,1362,928,239,1123,9430
15000US060377005021,3229,2310,391,2838,9431
15000US060377005022,1166,931,68,1098,9432
15000US060377006001,1176,1166,0,1176,9433
15000US060377006002,1088,1034,54,1034,9434
15000US060377006003,420,400,12,408,9435
15000US060377006004,1415,1030,34,1381,9436
15000US060377006005,623,602,0,623,9437
15000US060377007001,937,738,7,930,9438
15000US060377007002,602,489,97,505,9439
15000US060377007003,1900,1710,2,1898,9440
15000US060377008011,3848,2536,237,3611,9441
15000US060377008012,1092,927,73,1019,9442
15000US060377008013,923,812,60,863,9443
15000US060377008021,1170,810,45,1125,9444
15000US060377008022,1468,1266,55,1413,9445
15000US060377008023,1251,910,153,1098,9446
15000US060377009011,1052,785,104,948,9447
15000US060377009012,635,472,27,608,9448
15000US060377009013,833,604,78,755,9449
15000US060377009014,1372,1137,43,1329,9450
15000US060377009021,1967,1561,110,1857,9451
15000US060377009022,1333,974,203,1130,9452
15000US060377009023,2470,1835,83,2387,9453
15000US060377009024,1407,1111,165,1242,9454
15000US060377010001,687,687,0,687,9455
15000US060377010002,1119,977,48,1071,9456
15000US060377010003,828,486,38,790,9457
15000US060377010004,2334,1788,176,2158,9458
15000US060377010005,677,537,54,623,9459
15000US060377011001,1015,386,190,825,9460
15000US060377012011,688,518,17,671,9461
15000US060377012012,725,624,74,651,9462
15000US060377012013,795,731,0,795,9463
15000US060377012014,796,611,54,742,9464
15000US060377012015,726,616,25,701,9465
15000US060377012021,1760,1259,294,1466,9466
15000US060377012022,1552,1224,80,1472,9467
15000US060377013021,1747,1346,127,1620,9468
15000US060377013022,3170,2420,349,2821,9469
15000US060377013041,1696,1355,34,1662,9470
15000US060377013042,1883,1562,129,1754,9471
15000US060377013043,1856,1426,238,1618,9472
15000US060377013044,823,636,94,729,9473
15000US060377014021,809,645,35,774,9474
15000US060377014022,1926,1387,161,1765,9475
15000US060377014023,1558,1085,313,1245,9476
15000US060377014024,1668,1517,117,1551,9477
15000US060377015011,1481,1217,100,1381,9478
15000US060377015012,1106,854,80,1026,9479
15000US060377015013,2330,1760,173,2157,9480
15000US060377015021,1052,740,116,936,9481
15000US060377015022,1562,894,294,1268,9482
15000US060377015023,1388,1016,183,1205,9483
15000US060377016011,622,435,0,622,9484
15000US060377016012,1977,1486,249,1728,9485
15000US060377016013,773,415,45,728,9486
15000US060377016014,1370,966,43,1327,9487
15000US060377016021,1690,1069,292,1398,9488
15000US060377016022,1678,977,372,1306,9489
15000US060377016023,920,729,68,852,9490
15000US060377017011,1445,1007,252,1193,9491
15000US060377017012,1586,733,462,1124,9492
15000US060377017013,339,279,21,318,9493
15000US060377017021,850,433,234,616,9494
15000US060377017022,1071,428,432,639,9495
15000US060377017023,1391,782,405,986,9496
15000US060377018011,1002,521,191,811,9497
15000US060377018012,729,427,213,516,9498
15000US060377018013,776,161,306,470,9499
15000US060377018014,1908,361,965,943,9500
15000US060377018015,1829,480,741,1088,9501
15000US060377018021,1866,562,719,1147,9502
15000US060377018022,1000,397,256,744,9503
15000US060377018023,1035,573,318,717,9504
15000US060377018024,687,293,165,522,9505
15000US060377019021,2894,1871,361,2533,9506
15000US060377019022,521,436,21,500,9507
15000US060377019023,1102,444,215,887,9508
15000US060377020021,1668,1361,104,1564,9509
15000US060377020022,1350,753,403,947,9510
15000US060377020023,1661,1063,450,1211,9511
15000US060377020024,1695,1021,348,1347,9512
15000US060377021021,1111,871,50,1061,9513
15000US060377021022,939,805,57,882,9514
15000US060377021023,386,219,95,291,9515
15000US060377021024,903,661,49,854,9516
15000US060377021025,693,534,53,640,9517
15000US060377021026,515,345,170,345,9518
15000US060377021027,1434,974,250,1184,9519
15000US060377022011,1118,585,444,674,9520
15000US060377022012,794,440,83,711,9521
15000US060377022013,906,672,35,871,9522
15000US060377022014,1096,565,162,934,9523
15000US060377022015,895,802,31,864,9524
15000US060377022021,890,555,236,654,9525
15000US060377022022,599,330,83,516,9526
15000US060377022023,815,598,97,718,9527
15000US060377022024,898,679,46,852,9528
15000US060377022025,749,391,201,548,9529
15000US060377023001,1275,613,146,1129,9530
15000US060377023002,1141,736,304,837,9531
15000US060377023003,1035,682,110,925,9532
15000US060377023004,1474,942,117,1357,9533
15000US060377023005,2049,1392,320,1729,9534
15000US060377024001,1142,629,273,869,9535
15000US060377024002,765,349,145,620,9536
15000US060377024003,793,214,438,355,9537
15000US060377024004,1139,488,350,789,9538
15000US060377024005,699,422,208,491,9539
15000US060377025011,956,535,250,706,9540
15000US060377025012,444,381,37,407,9541
15000US060377025013,987,690,18,969,9542
15000US060377025014,1615,1109,251,1364,9543
15000US060377025015,484,362,70,414,9544
15000US060377025021,873,380,73,800,9545
15000US060377025022,1358,842,148,1210,9546
15000US060377025023,2065,1249,358,1707,9547
15000US060377026001,504,347,46,458,9548
15000US060377026002,1114,512,373,741,9549
15000US060377026003,773,317,218,555,9550
15000US060377026004,1291,752,119,1172,9551
15000US060377026005,430,172,42,388,9552
15000US060377026006,1525,336,289,1236,9553
15000US060377027001,994,410,336,658,9554
15000US060377027002,1073,593,98,975,9555
15000US060377027003,653,420,74,579,9556
15000US060377027004,1149,669,239,910,9557
15000US060377028011,2239,640,859,1380,9558
15000US060377028012,1526,703,374,1152,9559
15000US060377028013,1477,723,368,1109,9560
15000US060377028021,1082,410,475,607,9561
15000US060377028022,1441,621,587,854,9562
15000US060377028031,667,209,341,326,9563
15000US060377028032,1002,331,473,529,9564
15000US060377028033,1522,797,472,1050,9565
15000US060377029011,2951,1915,535,2416,9566
15000US060377029012,2326,2012,165,2161,9567
15000US060377029013,3391,2345,180,3211,9568
15000US060377029014,1114,747,21,1093,9569
15000US060377030011,2437,968,317,2120,9570
15000US060377030012,2060,828,394,1666,9571
15000US060377030013,1493,716,105,1388,9572
15000US060377030021,1817,241,230,1587,9573
15000US060377030022,1284,84,24,1260,9574
15000US060377030023,2615,260,86,2529,9575
15000US060377030024,1779,415,157,1622,9576
15000US060377031001,761,0,0,761,9577
15000US060377031002,1159,59,35,1124,9578
15000US060377031003,1366,159,87,1279,9579
15000US060377031004,744,81,178,566,9580
15000US060377031005,793,39,10,783,9581
15000US060377031006,782,57,299,483,9582
15000US060377032001,1166,71,57,1109,9583
15000US060377032002,1186,4,0,1186,9584
15000US060377032003,975,146,203,772,9585
15000US060377032004,832,82,9,823,9586
15000US060377032005,846,71,16,830,9587
15000US060377032006,1030,103,27,1003,9588
15000US060378001011,2537,2014,80,2457,9589
15000US060378001012,2972,2510,68,2904,9590
15000US060378001021,2451,1954,254,2197,9591
15000US060378001022,2308,2131,112,2196,9592
15000US060378001023,1820,1590,137,1683,9593
15000US060378002021,883,710,158,725,9594
15000US060378002022,5051,3842,224,4827,9595
15000US060378002031,1613,1442,84,1529,9596
15000US060378002032,4136,3009,381,3755,9597
15000US060378002041,1872,1286,154,1718,9598
15000US060378002042,2831,2181,237,2594,9599
15000US060378003241,733,622,17,716,9600
15000US060378003242,2468,2025,87,2381,9601
15000US060378003243,1402,1255,101,1301,9602
15000US060378003244,2063,1757,97,1966,9603
15000US060378003251,1786,1465,162,1624,9604
15000US060378003252,1739,1562,71,1668,9605
15000US060378003261,2015,1318,216,1799,9606
15000US060378003262,1067,930,97,970,9607
15000US060378003263,1975,1604,101,1874,9608
15000US060378003271,2570,1530,663,1907,9609
15000US060378003272,1052,761,248,804,9610
15000US060378003273,1965,989,803,1162,9611
15000US060378003281,1542,1078,177,1365,9612
15000US060378003282,1382,999,58,1324,9613
15000US060378003291,838,679,77,761,9614
15000US060378003292,2983,2485,196,2787,9615
15000US060378003293,2734,2035,294,2440,9616
15000US060378003301,1097,869,176,921,9617
15000US060378003311,805,519,101,704,9618
15000US060378003321,1104,812,156,948,9619
15000US060378003322,996,791,67,929,9620
15000US060378003323,533,387,27,506,9621
15000US060378003324,1446,1246,163,1283,9622
15000US060378003325,1184,917,50,1134,9623
15000US060378003326,1342,1236,0,1342,9624
15000US060378004061,1764,1137,413,1351,9625
15000US060378004062,559,555,0,559,9626
15000US060378004063,493,445,21,472,9627
15000US060378004081,819,599,70,749,9628
15000US060378004082,2956,2397,210,2746,9629
15000US060378004083,1728,1509,91,1637,9630
15000US060378004084,1692,1404,239,1453,9631
15000US060378004101,4100,2251,615,3485,9632
15000US060378005041,2420,2170,59,2361,9633
15000US060378005061,1395,1208,75,1320,9634
15000US060378005062,585,430,53,532,9635
15000US060378005063,1263,1015,13,1250,9636
15000US060379001021,666,270,363,303,9637
15000US060379001031,1968,511,1002,966,9638
15000US060379001032,1506,519,848,658,9639
15000US060379001033,2463,914,1318,1145,9640
15000US060379001041,2056,639,1222,834,9641
15000US060379001042,1633,568,959,674,9642
15000US060379001043,1981,484,953,1028,9643
15000US060379002011,1033,673,319,714,9644
15000US060379003001,4686,1387,2084,2602,9645
15000US060379005011,1721,372,774,947,9646
15000US060379005012,1961,412,914,1047,9647
15000US060379005013,3163,603,1656,1507,9648
15000US060379005041,1338,481,532,806,9649
15000US060379005042,5032,973,2600,2432,9650
15000US060379005051,1529,514,684,845,9651
15000US060379005052,2427,813,1007,1420,9652
15000US060379005061,2072,570,937,1135,9653
15000US060379005062,2507,281,967,1540,9654
15000US060379005071,3521,938,1701,1820,9655
15000US060379005072,1672,252,593,1079,9656
15000US060379005073,2412,802,1021,1391,9657
15000US060379005081,3612,1115,1678,1934,9658
15000US060379006021,2745,795,1811,934,9659
15000US060379006022,2832,506,1795,1037,9660
15000US060379006051,1919,884,916,1003,9661
15000US060379006052,2892,773,1618,1274,9662
15000US060379006053,3059,1425,851,2208,9663
15000US060379006061,2735,835,793,1942,9664
15000US060379006062,876,160,551,325,9665
15000US060379006071,2604,648,836,1768,9666
15000US060379006072,1399,370,548,851,9667
15000US060379006081,2468,572,1133,1335,9668
15000US060379006082,1153,308,452,701,9669
15000US060379006091,3500,817,2025,1475,9670
15000US060379006092,2023,287,753,1270,9671
15000US060379007011,1255,333,267,988,9672
15000US060379007012,1121,270,610,511,9673
15000US060379007013,1230,572,381,849,9674
15000US060379007014,912,337,259,653,9675
15000US060379007031,1256,546,319,937,9676
15000US060379007032,949,440,274,675,9677
15000US060379007033,1799,515,961,838,9678
15000US060379007041,1978,356,581,1397,9679
15000US060379007042,855,252,220,635,9680
15000US060379007051,1149,882,128,1021,9681
15000US060379007052,2125,1189,553,1572,9682
15000US060379007053,462,93,178,284,9683
15000US060379008031,2172,516,1055,1117,9684
15000US060379008032,2277,977,673,1604,9685
15000US060379008033,2055,389,1057,998,9686
15000US060379008034,2869,1163,1079,1790,9687
15000US060379008041,2260,242,1288,972,9688
15000US060379008042,1087,244,575,512,9689
15000US060379008051,1268,501,559,709,9690
15000US060379008052,2012,731,672,1340,9691
15000US060379008053,1155,559,377,778,9692
15000US060379008061,2587,298,1101,1486,9693
15000US060379008062,2304,717,589,1715,9694
15000US060379009001,2550,1968,468,2082,9695
15000US060379009002,1456,794,266,1190,9696
15000US060379010031,5322,650,2295,3027,9697
15000US060379010041,675,363,217,458,9698
15000US060379010042,1700,1082,297,1403,9699
15000US060379010043,10013,3838,3063,6950,9700
15000US060379010071,975,550,304,671,9701
15000US060379010072,1045,713,260,785,9702
15000US060379010081,2260,740,990,1270,9703
15000US060379010082,703,326,316,387,9704
15000US060379010091,2122,1317,468,1654,9705
15000US060379010092,1253,203,476,777,9706
15000US060379010093,2398,1289,745,1653,9707
15000US060379010101,1009,533,403,606,9708
15000US060379010102,1582,789,142,1440,9709
15000US060379010103,2193,485,1005,1188,9710
15000US060379010104,1111,590,444,667,9711
15000US060379010111,2318,1027,762,1556,9712
15000US060379010112,1253,601,374,879,9713
15000US060379010113,1482,914,408,1074,9714
15000US060379011011,3162,1462,969,2193,9715
15000US060379011012,2083,944,760,1323,9716
15000US060379011021,2198,1246,691,1507,9717
15000US060379011022,1530,696,690,840,9718
15000US060379011023,1702,1029,495,1207,9719
15000US060379012051,4674,1887,1554,3120,9720
15000US060379012052,2150,1353,306,1844,9721
15000US060379012053,2196,1006,283,1913,9722
15000US060379012054,2597,2003,423,2174,9723
15000US060379012091,1323,1010,175,1148,9724
15000US060379012101,1608,1222,311,1297,9725
15000US060379012131,3904,3097,436,3468,9726
15000US060379100011,1615,323,955,660,9727
15000US060379100012,1786,606,1037,749,9728
15000US060379100013,2636,382,2053,583,9729
15000US060379100021,2858,1004,1489,1369,9730
15000US060379100022,2469,998,1096,1373,9731
15000US060379100023,2024,224,1498,526,9732
15000US060379101011,1585,162,1197,388,9733
15000US060379102011,2420,976,777,1643,9734
15000US060379102012,1159,163,874,285,9735
15000US060379102021,3901,2282,778,3123,9736
15000US060379102022,1336,671,552,784,9737
15000US060379102051,1324,531,514,810,9738
15000US060379102061,3598,1008,1387,2211,9739
15000US060379102071,2316,693,873,1443,9740
15000US060379102072,1797,675,708,1089,9741
15000US060379102073,1889,726,697,1192,9742
15000US060379102081,2556,832,1187,1369,9743
15000US060379102082,3721,807,2148,1573,9744
15000US060379102091,4460,2170,1264,3196,9745
15000US060379102101,7148,3187,2075,5073,9746
15000US060379103011,2436,1554,609,1827,9747
15000US060379103012,1539,932,380,1159,9748
15000US060379103021,1260,681,347,913,9749
15000US060379103022,2665,1231,966,1699,9750
15000US060379103023,1965,1472,401,1564,9751
15000US060379104011,4315,1891,1467,2848,9752
15000US060379104012,2670,491,1465,1205,9753
15000US060379104021,2329,169,1974,355,9754
15000US060379104022,1385,108,741,644,9755
15000US060379104031,2287,107,1957,330,9756
15000US060379104041,1465,323,830,635,9757
15000US060379104042,2656,482,1992,664,9758
15000US060379105011,1312,250,654,658,9759
15000US060379105012,2090,186,1169,921,9760
15000US060379105013,2059,137,1265,794,9761
15000US060379105021,1949,253,1322,627,9762
15000US060379105022,2031,260,1388,643,9763
15000US060379105041,1261,319,844,417,9764
15000US060379105042,2261,243,1776,485,9765
15000US060379105043,1277,21,1107,170,9766
15000US060379105051,1616,285,1289,327,9767
15000US060379105052,1460,213,1087,373,9768
15000US060379106011,1405,262,731,674,9769
15000US060379106012,2108,239,1813,295,9770
15000US060379106013,3344,612,1946,1398,9771
15000US060379106021,4002,592,2426,1576,9772
15000US060379106031,1844,369,1377,467,9773
15000US060379106032,1490,213,1033,457,9774
15000US060379106033,1514,283,1027,487,9775
15000US060379106034,1931,121,1443,488,9776
15000US060379106051,3215,360,2380,835,9777
15000US060379106052,1743,301,1064,679,9778
15000US060379106061,2083,322,1575,508,9779
15000US060379106062,1279,74,690,589,9780
15000US060379107051,6580,821,4665,1915,9781
15000US060379107052,6042,752,4045,1997,9782
15000US060379107061,6296,353,4547,1749,9783
15000US060379107071,4787,845,2971,1816,9784
15000US060379107091,1754,659,893,861,9785
15000US060379107111,5145,863,3579,1566,9786
15000US060379107112,3149,309,2096,1053,9787
15000US060379107121,2630,395,1741,889,9788
15000US060379107131,1835,290,1230,605,9789
15000US060379107132,4008,537,2862,1146,9790
15000US060379107141,2974,253,2424,550,9791
15000US060379107142,1021,91,806,215,9792
15000US060379107151,1890,166,1500,390,9793
15000US060379107152,1636,99,1150,486,9794
15000US060379107153,2904,385,1728,1176,9795
15000US060379107161,2637,912,1335,1302,9796
15000US060379107162,3228,850,1781,1447,9797
15000US060379108041,2914,2313,488,2426,9798
15000US060379108051,1894,1089,491,1403,9799
15000US060379108052,2963,2303,438,2525,9800
15000US060379108071,3684,1773,1032,2652,9801
15000US060379108072,2843,1233,1096,1747,9802
15000US060379108081,1837,1246,488,1349,9803
15000US060379108082,1468,941,221,1247,9804
15000US060379108091,2241,1711,366,1875,9805
15000US060379108101,2847,1662,656,2191,9806
15000US060379108111,121,121,0,121,9807
15000US060379108121,407,380,27,380,9808
15000US060379108131,1938,1583,302,1636,9809
15000US060379108132,1781,1168,342,1439,9810
15000US060379110011,1599,871,617,982,9811
15000US060379110012,637,574,39,598,9812
15000US060379110013,1841,923,790,1051,9813
15000US060379200111,261,144,61,200,9814
15000US060379200121,1001,844,88,913,9815
15000US060379200131,1081,769,256,825,9816
15000US060379200132,2062,1246,407,1655,9817
15000US060379200133,1936,749,721,1215,9818
15000US060379200151,2964,2051,455,2509,9819
15000US060379200152,3043,1798,626,2417,9820
15000US060379200161,1084,782,180,904,9821
15000US060379200162,4022,2298,772,3250,9822
15000US060379200171,1702,995,444,1258,9823
15000US060379200172,2143,765,1225,918,9824
15000US060379200173,1177,938,100,1077,9825
15000US060379200181,1104,680,240,864,9826
15000US060379200182,795,549,187,608,9827
15000US060379200183,464,363,92,372,9828
15000US060379200201,1982,1241,381,1601,9829
15000US060379200202,581,460,78,503,9830
15000US060379200203,4814,2650,1645,3169,9831
15000US060379200231,2880,1069,1693,1187,9832
15000US060379200261,429,326,57,372,9833
15000US060379200281,6589,3396,2010,4579,9834
15000US060379200291,1499,626,608,891,9835
15000US060379200292,1176,694,371,805,9836
15000US060379200293,678,230,323,355,9837
15000US060379200301,3947,1404,1560,2387,9838
15000US060379200302,2022,1039,493,1529,9839
15000US060379200311,796,347,418,378,9840
15000US060379200312,2128,1693,155,1973,9841
15000US060379200313,1103,784,219,884,9842
15000US060379200314,1771,779,366,1405,9843
15000US060379200321,3440,1870,787,2653,9844
15000US060379200331,732,294,302,430,9845
15000US060379200341,2702,1154,994,1708,9846
15000US060379200342,1180,537,491,689,9847
15000US060379200351,2843,1161,1572,1271,9848
15000US060379200352,1098,140,917,181,9849
15000US060379200353,1144,398,602,542,9850
15000US060379200354,895,408,371,524,9851
15000US060379200355,1951,528,742,1209,9852
15000US060379200361,1043,378,643,400,9853
15000US060379200362,756,135,574,182,9854
15000US060379200363,747,408,237,510,9855
15000US060379200364,782,226,482,300,9856
15000US060379200371,2295,827,1255,1040,9857
15000US060379200372,3122,211,2522,600,9858
15000US060379200373,2125,525,1231,894,9859
15000US060379200381,3185,953,1523,1662,9860
15000US060379200382,1617,258,1250,367,9861
15000US060379200391,2075,1015,896,1179,9862
15000US060379200401,3563,1586,970,2593,9863
15000US060379200411,2909,913,1097,1812,9864
15000US060379200421,1467,723,382,1085,9865
15000US060379200422,4009,1450,1372,2637,9866
15000US060379200423,808,292,382,426,9867
15000US060379200424,1029,468,330,699,9868
15000US060379200431,6529,2577,1607,4922,9869
15000US060379200441,2299,1321,535,1764,9870
15000US060379200442,571,321,189,382,9871
15000US060379200451,937,474,219,718,9872
15000US060379200452,2978,1995,625,2353,9873
15000US060379200453,1001,372,277,724,9874
15000US060379201021,2185,586,953,1232,9875
15000US060379201022,569,400,132,437,9876
15000US060379201023,3018,1974,947,2071,9877
15000US060379201041,2972,2066,572,2400,9878
15000US060379201061,3291,917,2067,1224,9879
15000US060379201071,4802,1846,867,3935,9880
15000US060379201081,4844,2326,728,4116,9881
15000US060379201091,5694,3218,1078,4616,9882
15000US060379201101,3367,2272,390,2977,9883
15000US060379201111,1609,906,346,1263,9884
15000US060379201112,1450,904,288,1162,9885
15000US060379201121,1060,771,155,905,9886
15000US060379201122,1700,1041,416,1284,9887
15000US060379201123,1224,867,120,1104,9888
15000US060379201141,6742,3669,1189,5553,9889
15000US060379201151,1076,850,27,1049,9890
15000US060379201152,2968,1283,963,2005,9891
15000US060379201161,482,391,68,414,9892
15000US060379201162,4731,2736,998,3733,9893
15000US060379201181,1920,1042,809,1111,9894
15000US060379201182,4306,2252,1117,3189,9895
15000US060379201191,2051,1108,513,1538,9896
15000US060379202001,5799,816,3377,2422,9897
15000US060379203031,1542,635,441,1101,9898
15000US060379203121,863,672,143,720,9899
15000US060379203122,2039,1059,592,1447,9900
15000US060379203123,2752,1178,928,1824,9901
15000US060379203131,1842,885,796,1046,9902
15000US060379203132,942,226,583,359,9903
15000US060379203133,884,477,334,550,9904
15000US060379203134,2056,1502,367,1689,9905
15000US060379203141,2081,1251,593,1488,9906
15000US060379203142,902,629,105,797,9907
15000US060379203221,1116,586,259,857,9908
15000US060379203222,1383,1105,182,1201,9909
15000US060379203223,406,160,166,240,9910
15000US060379203261,3282,1575,426,2856,9911
15000US060379203262,3690,2043,582,3108,9912
15000US060379203281,2045,1318,202,1843,9913
15000US060379203291,1532,855,340,1192,9914
15000US060379203292,2408,1302,540,1868,9915
15000US060379203293,1621,1089,194,1427,9916
15000US060379203301,2035,745,669,1366,9917
15000US060379203302,919,625,160,759,9918
15000US060379203303,1281,791,384,897,9919
15000US060379203304,1588,934,433,1155,9920
15000US060379203311,1709,1165,356,1353,9921
15000US060379203312,1704,1184,214,1490,9922
15000US060379203313,790,569,178,612,9923
15000US060379203321,1623,989,372,1251,9924
15000US060379203322,851,544,230,621,9925
15000US060379203341,755,690,0,755,9926
15000US060379203342,1047,851,172,875,9927
15000US060379203343,2960,1476,835,2125,9928
15000US060379203344,1415,948,233,1182,9929
15000US060379203361,1109,616,446,663,9930
15000US060379203362,1433,200,1121,312,9931
15000US060379203363,2200,93,2032,168,9932
15000US060379203364,1735,201,1499,236,9933
15000US060379203371,2500,231,1917,583,9934
15000US060379203372,1591,239,1234,357,9935
15000US060379203373,1758,433,412,1346,9936
15000US060379203374,2098,0,2098,0,9937
15000US060379203381,6167,3502,1070,5097,9938
15000US060379203391,7514,4451,1053,6461,9939
15000US060379301011,111,48,47,64,9940
15000US060379302001,267,118,123,144,9941
15000US060379302002,218,165,44,174,9942
15000US060379303011,433,248,108,325,9943
15000US060379303012,355,260,50,305,9944
15000US060379800011,0,0,0,0,9945
15000US060379800021,0,0,0,0,9946
15000US060379800031,0,0,0,0,9947
15000US060379800041,0,0,0,0,9948
15000US060379800051,0,0,0,0,9949
15000US060379800061,0,0,0,0,9950
15000US060379800071,0,0,0,0,9951
15000US060379800081,73,0,73,0,9952
15000US060379800091,5,1,1,4,9953
15000US060379800101,150,40,61,89,9954
15000US060379800131,0,0,0,0,9955
15000US060379800141,0,0,0,0,9956
15000US060379800151,329,77,72,257,9957
15000US060379800181,0,0,0,0,9958
15000US060379800191,197,162,0,197,9959
15000US060379800201,0,0,0,0,9960
15000US060379800211,0,0,0,0,9961
15000US060379800221,0,0,0,0,9962
15000US060379800231,9,0,9,0,9963
15000US060379800241,237,148,31,206,9964
15000US060379800251,0,0,0,0,9965
15000US060379800261,41,12,16,25,9966
15000US060379800281,0,0,0,0,9967
15000US060379800301,0,0,0,0,9968
15000US060379800311,1124,412,334,790,9969
15000US060379800331,0,0,0,0,9970
15000US060379901000,0,0,0,0,9971
15000US060379902000,0,0,0,0,9972
15000US060379903000,0,0,0,0,9973
15000US060390001021,614,471,16,598,9974
15000US060390001022,613,474,38,575,9975
15000US060390001023,2051,1285,419,1632,9976
15000US060390001024,785,525,129,656,9977
15000US060390001031,1132,733,399,733,9978
15000US060390001032,1056,735,300,756,9979
15000US060390001033,1125,1078,47,1078,9980
15000US060390001034,1775,1743,0,1775,9981
15000US060390001041,756,429,9,747,9982
15000US060390001042,1848,1548,172,1676,9983
15000US060390001043,638,510,21,617,9984
15000US060390001044,816,773,26,790,9985
15000US060390001061,2807,2392,292,2515,9986
15000US060390001062,2353,1959,266,2087,9987
15000US060390001081,2137,2075,51,2086,9988
15000US060390001082,2445,2018,127,2318,9989
15000US060390001083,2002,1814,19,1983,9990
15000US060390001091,1545,1189,240,1305,9991
15000US060390001092,634,436,121,513,9992
15000US060390002011,6392,2045,2391,4001,9993
15000US060390002012,1927,365,1251,676,9994
15000US060390002021,2280,1219,1001,1279,9995
15000US060390002022,828,299,511,317,9996
15000US060390002023,997,413,581,416,9997
15000US060390002024,1921,862,695,1226,9998
15000US060390003001,1567,522,1000,567,9999
15000US060390003002,661,213,387,274,10000
15000US060390003003,1297,122,1079,218,10001
15000US060390003004,878,380,404,474,10002
15000US060390003005,278,245,0,278,10003
15000US060390003006,3540,1712,1512,2028,10004
15000US060390003007,668,355,254,414,10005
15000US060390004001,580,156,404,176,10006
15000US060390004002,973,205,767,206,10007
15000US060390005021,951,63,888,63,10008
15000US060390005022,3270,210,2920,350,10009
15000US060390005023,4922,656,3932,990,10010
15000US060390005024,2576,558,1783,793,10011
15000US060390005031,4629,1452,2880,1749,10012
15000US060390005032,3058,755,1820,1238,10013
15000US060390005033,1086,714,327,759,10014
15000US060390005061,1951,459,1340,611,10015
15000US060390005062,2417,276,2019,398,10016
15000US060390005063,2310,550,1620,690,10017
15000US060390005071,1392,457,935,457,10018
15000US060390005072,3068,1092,1701,1367,10019
15000US060390005073,3458,348,2791,667,10020
15000US060390005074,3582,1316,2200,1382,10021
15000US060390005081,2406,885,1206,1200,10022
15000US060390005082,3022,495,2443,579,10023
15000US060390005083,2032,1247,659,1373,10024
15000US060390005091,3038,1919,991,2047,10025
15000US060390005092,1732,1229,311,1421,10026
15000US060390005093,1185,804,216,969,10027
15000US060390006021,1044,237,775,269,10028
15000US060390006022,1581,115,1466,115,10029
15000US060390006023,1714,48,1616,98,10030
15000US060390006031,3517,361,2750,767,10031
15000US060390006032,2397,20,2377,20,10032
15000US060390006041,3478,163,3230,248,10033
15000US060390006042,2358,121,2189,169,10034
15000US060390007001,532,150,367,165,10035
15000US060390007002,4927,1418,3028,1899,10036
15000US060390007003,2933,887,1336,1597,10037
15000US060390007004,1473,431,928,545,10038
15000US060390007005,1217,442,756,461,10039
15000US060390007006,1109,207,851,258,10040
15000US060390008001,634,185,449,185,10041
15000US060390008002,1585,121,1433,152,10042
15000US060390008003,1143,295,839,304,10043
15000US060390008004,734,20,714,20,10044
15000US060390008005,1099,137,947,152,10045
15000US060390008006,1496,392,1082,414,10046
15000US060390009001,3274,84,2984,290,10047
15000US060390009002,2973,159,2758,215,10048
15000US060390009003,3156,15,2833,323,10049
15000US060390010001,1203,325,862,341,10050
15000US060390010002,1896,1382,351,1545,10051
15000US060390010003,975,197,719,256,10052
15000US060390010004,914,190,714,200,10053
15000US060411011001,2717,2466,61,2656,10054
15000US060411012001,3023,1996,839,2184,10055
15000US060411021001,643,586,31,612,10056
15000US060411021002,1676,1394,136,1540,10057
15000US060411022021,649,181,445,204,10058
15000US060411022022,879,829,0,879,10059
15000US060411022023,2180,1618,270,1910,10060
15000US060411022024,1034,636,366,668,10061
15000US060411022025,1766,1140,472,1294,10062
15000US060411022031,2465,730,1294,1171,10063
15000US060411022032,1719,943,512,1207,10064
15000US060411022033,1557,989,221,1336,10065
15000US060411031001,2492,2351,17,2475,10066
15000US060411031002,1844,1479,87,1757,10067
15000US060411031003,1721,1530,88,1633,10068
15000US060411031004,1734,1301,114,1620,10069
15000US060411032001,1263,767,409,854,10070
15000US060411032002,2251,1390,322,1929,10071
15000US060411032003,3258,2430,139,3119,10072
15000US060411041011,1889,1625,141,1748,10073
15000US060411041012,1576,1130,208,1368,10074
15000US060411041013,2202,1685,312,1890,10075
15000US060411041014,2609,1386,643,1966,10076
15000US060411041021,1757,1150,186,1571,10077
15000US060411041022,3728,1364,1737,1991,10078
15000US060411042001,1949,1397,339,1610,10079
15000US060411042002,1673,1189,354,1319,10080
15000US060411042003,1904,1498,84,1820,10081
15000US060411043001,1624,1341,95,1529,10082
15000US060411050001,2755,1067,1240,1515,10083
15000US060411050002,3639,2706,345,3294,10084
15000US060411060011,416,179,144,272,10085
15000US060411060012,2255,1575,138,2117,10086
15000US060411060013,1566,967,181,1385,10087
15000US060411060021,3278,1263,1169,2109,10088
15000US060411060022,2169,1653,128,2041,10089
15000US060411060023,1363,846,378,985,10090
15000US060411070001,1704,1457,145,1559,10091
15000US060411070002,837,795,0,837,10092
15000US060411070003,822,649,104,718,10093
15000US060411070004,1605,1531,58,1547,10094
15000US060411070005,1751,1147,221,1530,10095
15000US060411081001,2847,2226,166,2681,10096
15000US060411081002,856,639,217,639,10097
15000US060411081003,1201,1016,115,1086,10098
15000US060411081004,1885,1606,74,1811,10099
15000US060411082001,1241,725,129,1112,10100
15000US060411082002,2980,2097,550,2430,10101
15000US060411082003,1753,825,327,1426,10102
15000US060411082004,782,668,56,726,10103
15000US060411090011,1126,633,252,874,10104
15000US060411090012,1218,877,61,1157,10105
15000US060411090013,1664,806,707,957,10106
15000US060411090021,1477,1364,45,1432,10107
15000US060411090022,1794,1606,77,1717,10108
15000US060411090023,853,735,66,787,10109
15000US060411101001,2051,1518,91,1960,10110
15000US060411101002,2065,1549,243,1822,10111
15000US060411101003,1708,1077,400,1308,10112
15000US060411102001,2419,2000,148,2271,10113
15000US060411102002,930,793,21,909,10114
15000US060411102003,1789,1594,175,1614,10115
15000US060411110001,1150,785,105,1045,10116
15000US060411110002,706,327,260,446,10117
15000US060411110003,1749,1201,461,1288,10118
15000US060411110004,2271,1482,608,1663,10119
15000US060411121001,2270,438,1641,629,10120
15000US060411121002,904,658,143,761,10121
15000US060411121003,800,679,89,711,10122
15000US060411121004,1151,979,23,1128,10123
15000US060411122011,4712,339,3882,830,10124
15000US060411122012,2734,27,2567,167,10125
15000US060411122021,3779,672,2365,1414,10126
15000US060411122022,891,123,730,161,10127
15000US060411130001,919,901,9,910,10128
15000US060411130002,1220,1135,76,1144,10129
15000US060411130003,920,762,47,873,10130
15000US060411130004,610,512,90,520,10131
15000US060411141001,1853,1562,112,1741,10132
15000US060411141002,1605,1445,37,1568,10133
15000US060411141003,1756,1623,57,1699,10134
15000US060411142001,2085,1807,127,1958,10135
15000US060411142002,1036,793,159,877,10136
15000US060411150001,2348,2000,120,2228,10137
15000US060411150002,1455,1321,17,1438,10138
15000US060411150003,1704,1336,229,1475,10139
15000US060411150004,1670,1537,133,1537,10140
15000US060411160001,1926,1564,108,1818,10141
15000US060411160002,1301,1227,20,1281,10142
15000US060411170001,1121,937,28,1093,10143
15000US060411170002,736,679,0,736,10144
15000US060411170003,1522,1421,48,1474,10145
15000US060411170004,1157,989,112,1045,10146
15000US060411181001,841,659,50,791,10147
15000US060411181002,1544,1411,55,1489,10148
15000US060411191001,764,710,19,745,10149
15000US060411191002,1034,866,95,939,10150
15000US060411191003,841,755,78,763,10151
15000US060411191004,1313,1277,0,1313,10152
15000US060411191005,1104,1075,19,1085,10153
15000US060411192011,1393,856,278,1115,10154
15000US060411192012,499,369,60,439,10155
15000US060411192013,1444,1202,109,1335,10156
15000US060411192021,1732,1447,154,1578,10157
15000US060411192022,1730,1485,49,1681,10158
15000US060411200001,979,782,10,969,10159
15000US060411200002,1020,1020,0,1020,10160
15000US060411200003,1653,1514,28,1625,10161
15000US060411200004,1703,1192,278,1425,10162
15000US060411200005,979,852,0,979,10163
15000US060411211001,1393,1094,243,1150,10164
15000US060411211002,688,519,0,688,10165
15000US060411211003,1648,954,488,1160,10166
15000US060411211004,796,651,74,722,10167
15000US060411211005,676,629,16,660,10168
15000US060411212001,1241,1109,59,1182,10169
15000US060411212002,1960,1336,298,1662,10170
15000US060411212003,1882,1669,13,1869,10171
15000US060411212004,902,775,0,902,10172
15000US060411220001,2912,485,906,2006,10173
15000US060411230001,689,614,23,666,10174
15000US060411230002,1334,1155,55,1279,10175
15000US060411241001,1557,1188,52,1505,10176
15000US060411241002,1203,912,112,1091,10177
15000US060411241003,463,405,58,405,10178
15000US060411241004,2178,1701,235,1943,10179
15000US060411242001,0,0,0,0,10180
15000US060411242002,1108,877,140,968,10181
15000US060411242003,1224,1115,29,1195,10182
15000US060411242004,2005,1761,68,1937,10183
15000US060411242005,1632,1314,111,1521,10184
15000US060411250001,1119,975,52,1067,10185
15000US060411250002,1607,1052,136,1471,10186
15000US060411250003,1918,1292,159,1759,10187
15000US060411261001,1493,1283,164,1329,10188
15000US060411261002,1476,1192,141,1335,10189
15000US060411261003,1139,1085,13,1126,10190
15000US060411261004,865,810,18,847,10191
15000US060411261005,841,700,29,812,10192
15000US060411262001,2086,1798,152,1934,10193
15000US060411262002,1842,1565,169,1673,10194
15000US060411262003,465,238,143,322,10195
15000US060411270001,1035,842,105,930,10196
15000US060411270002,638,460,148,490,10197
15000US060411270003,691,529,0,691,10198
15000US060411270004,966,791,159,807,10199
15000US060411270005,1426,1313,12,1414,10200
15000US060411281001,2148,1713,155,1993,10201
15000US060411281002,1460,1252,0,1460,10202
15000US060411281003,2835,2434,103,2732,10203
15000US060411282001,584,555,11,573,10204
15000US060411282002,1988,1742,97,1891,10205
15000US060411282003,2027,1518,122,1905,10206
15000US060411290001,1369,232,373,996,10207
15000US060411290002,1362,365,470,892,10208
15000US060411302011,1144,982,84,1060,10209
15000US060411302012,1346,1217,75,1271,10210
15000US060411302013,1025,926,46,979,10211
15000US060411302021,554,505,0,554,10212
15000US060411302022,898,801,65,833,10213
15000US060411302023,1662,1269,196,1466,10214
15000US060411302024,1026,872,49,977,10215
15000US060411311001,209,199,6,203,10216
15000US060411311002,469,451,0,469,10217
15000US060411311003,434,403,0,434,10218
15000US060411321001,672,636,6,666,10219
15000US060411321002,1284,1080,83,1201,10220
15000US060411322001,531,427,85,446,10221
15000US060411322002,543,531,12,531,10222
15000US060411322003,598,351,142,456,10223
15000US060411330001,905,779,85,820,10224
15000US060411330002,697,554,121,576,10225
15000US060411330003,753,496,138,615,10226
15000US060411330004,522,440,61,461,10227
15000US060419901000,0,0,0,0,10228
15000US060430001011,864,706,83,781,10229
15000US060430001012,1124,907,42,1082,10230
15000US060430001013,1096,711,165,931,10231
15000US060430001014,637,503,93,544,10232
15000US060430001021,1413,1301,70,1343,10233
15000US060430001022,1164,1035,80,1084,10234
15000US060430002001,1988,1462,380,1608,10235
15000US060430002002,479,439,7,472,10236
15000US060430002003,541,420,72,469,10237
15000US060430003011,639,494,52,587,10238
15000US060430003012,1801,1474,125,1676,10239
15000US060430003013,1172,939,176,996,10240
15000US060430003021,556,481,66,490,10241
15000US060430003022,1179,1026,120,1059,10242
15000US060430003023,905,864,0,905,10243
15000US060430004001,1548,1205,195,1353,10244
15000US060430004002,539,414,63,476,10245
15000US060450101001,404,298,11,393,10246
15000US060450101002,1381,528,281,1100,10247
15000US060450101003,793,319,183,610,10248
15000US060450102001,474,413,25,449,10249
15000US060450102002,679,509,133,546,10250
15000US060450102003,440,394,34,406,10251
15000US060450102004,596,488,9,587,10252
15000US060450102005,1265,737,177,1088,10253
15000US060450103001,589,455,134,455,10254
15000US060450103002,2200,1597,342,1858,10255
15000US060450103003,691,659,17,674,10256
15000US060450103004,808,728,73,735,10257
15000US060450104001,482,308,140,342,10258
15000US060450104002,409,374,29,380,10259
15000US060450104003,1259,645,570,689,10260
15000US060450104004,1063,953,66,997,10261
15000US060450105001,1342,690,556,786,10262
15000US060450105002,1053,284,696,357,10263
15000US060450105003,1458,991,428,1030,10264
15000US060450105004,675,626,15,660,10265
15000US060450106001,808,659,103,705,10266
15000US060450106002,3316,2712,337,2979,10267
15000US060450106003,631,535,30,601,10268
15000US060450106004,1657,1541,84,1573,10269
15000US060450107001,517,271,199,318,10270
15000US060450107002,1492,1150,124,1368,10271
15000US060450107003,940,874,66,874,10272
15000US060450107004,638,370,213,425,10273
15000US060450107005,1458,1050,253,1205,10274
15000US060450107006,1086,669,373,713,10275
15000US060450107007,437,329,20,417,10276
15000US060450108011,842,699,34,808,10277
15000US060450108012,1560,793,509,1051,10278
15000US060450108013,1638,1357,177,1461,10279
15000US060450108014,2204,1135,786,1418,10280
15000US060450108021,629,499,106,523,10281
15000US060450108022,1297,1136,145,1152,10282
15000US060450109001,750,647,80,670,10283
15000US060450109002,427,229,174,253,10284
15000US060450109003,2840,1177,1523,1317,10285
15000US060450109004,1027,817,184,843,10286
15000US060450110011,1799,1496,136,1663,10287
15000US060450110021,1094,871,31,1063,10288
15000US060450110022,719,658,0,719,10289
15000US060450110023,1075,937,48,1027,10290
15000US060450110024,514,402,37,477,10291
15000US060450110025,2198,1589,544,1654,10292
15000US060450111021,645,407,177,468,10293
15000US060450111022,1522,667,498,1024,10294
15000US060450111023,1707,1429,209,1498,10295
15000US060450112001,1030,870,160,870,10296
15000US060450112002,1043,491,485,558,10297
15000US060450112003,765,241,516,249,10298
15000US060450113001,2047,895,874,1173,10299
15000US060450113002,2564,1390,959,1605,10300
15000US060450113003,1092,823,175,917,10301
15000US060450114001,421,355,0,421,10302
15000US060450114002,1198,820,185,1013,10303
15000US060450114003,828,610,159,669,10304
15000US060450114004,472,350,36,436,10305
15000US060450114005,811,748,58,753,10306
15000US060450114006,654,455,109,545,10307
15000US060450115001,1388,849,349,1039,10308
15000US060450115002,2385,1435,783,1602,10309
15000US060450115003,1332,741,463,869,10310
15000US060450115004,397,225,172,225,10311
15000US060450115005,1114,591,389,725,10312
15000US060450116001,996,533,375,621,10313
15000US060450116002,1841,1016,694,1147,10314
15000US060450116003,1044,138,906,138,10315
15000US060450116004,1933,1040,587,1346,10316
15000US060450117001,918,622,58,860,10317
15000US060450117002,934,831,37,897,10318
15000US060450117003,635,513,92,543,10319
15000US060450117004,1334,526,570,764,10320
15000US060450117005,534,345,181,353,10321
15000US060450118001,1195,761,279,916,10322
15000US060450118002,976,703,185,791,10323
15000US060459901000,0,0,0,0,10324
15000US060470002011,2800,934,1721,1079,10325
15000US060470002012,635,248,328,307,10326
15000US060470002021,1746,556,1121,625,10327
15000US060470002031,1959,408,1202,757,10328
15000US060470002032,3532,781,2628,904,10329
15000US060470002033,1065,241,824,241,10330
15000US060470002034,922,140,771,151,10331
15000US060470002035,1994,217,1777,217,10332
15000US060470003011,1141,122,767,374,10333
15000US060470003012,1216,20,1017,199,10334
15000US060470003013,2864,210,2014,850,10335
15000US060470003031,1276,647,582,694,10336
15000US060470003032,901,407,472,429,10337
15000US060470003041,1820,37,1206,614,10338
15000US060470003042,845,19,713,132,10339
15000US060470003043,676,0,676,0,10340
15000US060470003044,1758,87,1175,583,10341
15000US060470003045,4509,304,3063,1446,10342
15000US060470004011,1625,901,697,928,10343
15000US060470004021,1228,875,315,913,10344
15000US060470004022,1709,1417,268,1441,10345
15000US060470004023,2663,1984,590,2073,10346
15000US060470004024,2566,1763,662,1904,10347
15000US060470005031,3231,1203,1382,1849,10348
15000US060470005041,1934,361,1530,404,10349
15000US060470005042,2065,181,1766,299,10350
15000US060470005043,2641,403,2097,544,10351
15000US060470005051,2228,988,988,1240,10352
15000US060470005052,977,310,476,501,10353
15000US060470005053,3383,632,2305,1078,10354
15000US060470006011,1117,471,529,588,10355
15000US060470006012,1154,277,704,450,10356
15000US060470006013,1476,54,1379,97,10357
15000US060470006014,1191,587,451,740,10358
15000US060470006021,2327,688,1266,1061,10359
15000US060470006022,1779,660,1083,696,10360
15000US060470006031,1344,861,314,1030,10361
15000US060470006032,868,443,375,493,10362
15000US060470006033,1551,366,974,577,10363
15000US060470006034,1360,210,1132,228,10364
15000US060470006035,837,236,418,419,10365
15000US060470007011,1858,569,1232,626,10366
15000US060470007012,1398,576,724,674,10367
15000US060470007021,1328,857,349,979,10368
15000US060470007022,1765,940,561,1204,10369
15000US060470007023,2134,952,722,1412,10370
15000US060470008011,3878,1198,2031,1847,10371
15000US060470008012,1712,690,727,985,10372
15000US060470008021,2012,629,1116,896,10373
15000US060470008022,2172,1051,966,1206,10374
15000US060470009011,1060,758,302,758,10375
15000US060470009012,1164,321,746,418,10376
15000US060470009013,1475,547,747,728,10377
15000US060470009021,2415,1014,1138,1277,10378
15000US060470009022,3377,563,1377,2000,10379
15000US060470009023,1975,709,1062,913,10380
15000US060470009024,1988,694,1241,747,10381
15000US060470010021,9352,3015,2833,6519,10382
15000US060470010022,1368,768,503,865,10383
15000US060470010023,2058,883,928,1130,10384
15000US060470010024,2144,1058,879,1265,10385
15000US060470010031,781,305,366,415,10386
15000US060470010032,2132,288,1279,853,10387
15000US060470010033,1542,261,921,621,10388
15000US060470010041,1410,384,570,840,10389
15000US060470010042,797,446,181,616,10390
15000US060470010043,1411,533,724,687,10391
15000US060470010051,2166,478,1085,1081,10392
15000US060470011011,1747,537,807,940,10393
15000US060470011012,1663,776,601,1062,10394
15000US060470011013,1380,524,718,662,10395
15000US060470011014,1127,757,222,905,10396
15000US060470012001,1380,340,938,442,10397
15000US060470012002,1193,561,390,803,10398
15000US060470012003,1015,282,507,508,10399
15000US060470012004,1861,1236,445,1416,10400
15000US060470013011,499,141,284,215,10401
15000US060470013012,1718,561,1016,702,10402
15000US060470013013,653,349,214,439,10403
15000US060470013021,884,314,471,413,10404
15000US060470013022,991,418,449,542,10405
15000US060470013023,1075,429,503,572,10406
15000US060470014011,2157,904,877,1280,10407
15000US060470014012,2329,877,1238,1091,10408
15000US060470014021,1898,303,1080,818,10409
15000US060470014022,518,261,153,365,10410
15000US060470014023,1211,597,417,794,10411
15000US060470014024,1469,566,730,739,10412
15000US060470015011,2821,702,1705,1116,10413
15000US060470015021,1219,161,815,404,10414
15000US060470015022,1518,11,1459,59,10415
15000US060470015031,1334,371,777,557,10416
15000US060470015032,1720,89,1276,444,10417
15000US060470015033,1796,67,1407,389,10418
15000US060470016011,2094,231,1648,446,10419
15000US060470016012,812,0,618,194,10420
15000US060470016013,1010,22,958,52,10421
15000US060470016021,3773,519,2198,1575,10422
15000US060470016022,3840,288,2614,1226,10423
15000US060470017001,4503,940,2839,1664,10424
15000US060470017002,997,362,375,622,10425
15000US060470017003,1019,350,617,402,10426
15000US060470018011,5349,2053,2124,3225,10427
15000US060470019011,1694,369,1251,443,10428
15000US060470019012,867,15,839,28,10429
15000US060470019013,1564,36,1528,36,10430
15000US060470019014,1506,117,1366,140,10431
15000US060470019021,1734,178,1528,206,10432
15000US060470019022,644,363,248,396,10433
15000US060470020001,1832,674,1133,699,10434
15000US060470020002,1036,546,490,546,10435
15000US060470020003,1325,462,757,568,10436
15000US060470020004,1024,363,661,363,10437
15000US060470020005,1428,473,955,473,10438
15000US060470020006,999,466,533,466,10439
15000US060470021001,1795,516,1091,704,10440
15000US060470021002,469,126,306,163,10441
15000US060470021003,1965,357,1352,613,10442
15000US060470022011,532,36,496,36,10443
15000US060470022012,1140,77,1003,137,10444
15000US060470022013,1055,268,754,301,10445
15000US060470022014,1387,268,1071,316,10446
15000US060470022015,1427,384,1005,422,10447
15000US060470022021,2706,439,2116,590,10448
15000US060470022022,1679,282,1376,303,10449
15000US060470022023,1640,0,1597,43,10450
15000US060470022024,474,32,423,51,10451
15000US060470022025,3369,1071,1971,1398,10452
15000US060470023011,4505,1722,2465,2040,10453
15000US060470023012,1478,876,564,914,10454
15000US060470023013,916,499,307,609,10455
15000US060470023021,968,128,827,141,10456
15000US060470023022,8561,1551,6257,2304,10457
15000US060470023023,2295,583,1573,722,10458
15000US060470023024,3185,593,2216,969,10459
15000US060470024011,1531,657,750,781,10460
15000US060470024021,1604,24,1301,303,10461
15000US060470024022,1751,591,1080,671,10462
15000US060470024023,1738,585,1141,597,10463
15000US060470024024,3249,398,2579,670,10464
15000US060470025001,956,544,374,582,10465
15000US060470025002,1267,673,316,951,10466
15000US060470026001,2114,755,1288,826,10467
15000US060470026002,3234,1387,1029,2205,10468
15000US060490001001,1096,1006,54,1042,10469
15000US060490001002,574,442,99,475,10470
15000US060490001003,393,348,35,358,10471
15000US060490001004,379,324,55,324,10472
15000US060490001005,998,820,132,866,10473
15000US060490002001,808,578,212,596,10474
15000US060490002002,696,620,38,658,10475
15000US060490003001,1101,687,277,824,10476
15000US060490003002,1092,812,192,900,10477
15000US060490003003,664,469,137,527,10478
15000US060490004001,881,605,84,797,10479
15000US060490004002,351,303,20,331,10480
15000US060510001011,1076,906,27,1049,10481
15000US060510001012,631,533,98,533,10482
15000US060510001013,398,358,35,363,10483
15000US060510001014,1171,867,293,878,10484
15000US060510001021,493,267,226,267,10485
15000US060510001022,838,616,43,795,10486
15000US060510001023,909,463,258,651,10487
15000US060510001024,500,428,61,439,10488
15000US060510002001,1727,822,896,831,10489
15000US060510002002,895,584,279,616,10490
15000US060510002003,573,391,182,391,10491
15000US060510002004,572,287,285,287,10492
15000US060510002005,1582,962,581,1001,10493
15000US060510002006,928,780,32,896,10494
15000US060510002007,968,522,413,555,10495
15000US060510002008,790,468,156,634,10496
15000US060510002009,0,0,0,0,10497
15000US060530001011,1362,285,993,369,10498
15000US060530001012,746,204,517,229,10499
15000US060530001021,3229,124,2598,631,10500
15000US060530001022,3467,504,2146,1321,10501
15000US060530001023,3227,279,2296,931,10502
15000US060530001031,1633,283,1009,624,10503
15000US060530001032,2277,159,1366,911,10504
15000US060530001041,758,54,561,197,10505
15000US060530001042,2930,476,2114,816,10506
15000US060530002001,2549,166,2189,360,10507
15000US060530002002,1372,390,956,416,10508
15000US060530002003,2158,268,1794,364,10509
15000US060530002004,1591,6,1564,27,10510
15000US060530003001,2226,456,1527,699,10511
15000US060530003002,2379,392,1767,612,10512
15000US060530004001,3039,479,2241,798,10513
15000US060530004002,2922,355,2214,708,10514
15000US060530004003,1565,458,886,679,10515
15000US060530005011,2113,131,1982,131,10516
15000US060530005012,2286,0,2286,0,10517
15000US060530005021,2484,116,2329,155,10518
15000US060530005022,1659,257,1371,288,10519
15000US060530006001,1764,103,1661,103,10520
15000US060530006002,1480,21,1427,53,10521
15000US060530006003,2924,117,2798,126,10522
15000US060530006004,1022,65,957,65,10523
15000US060530007011,1881,67,1805,76,10524
15000US060530007012,2325,50,2275,50,10525
15000US060530007013,1766,54,1703,63,10526
15000US060530007021,1994,39,1946,48,10527
15000US060530007022,2160,0,2160,0,10528
15000US060530007023,2015,0,2015,0,10529
15000US060530008001,2454,18,2414,40,10530
15000US060530008002,1665,40,1611,54,10531
15000US060530008003,1526,7,1519,7,10532
15000US060530009001,952,109,806,146,10533
15000US060530009002,1360,0,1352,8,10534
15000US060530009003,3055,79,2976,79,10535
15000US060530012001,1865,1016,742,1123,10536
15000US060530012002,1205,611,465,740,10537
15000US060530013001,2786,181,2412,374,10538
15000US060530014001,1330,571,642,688,10539
15000US060530014002,1309,638,582,727,10540
15000US060530015001,2539,1305,979,1560,10541
15000US060530015002,1126,715,287,839,10542
15000US060530015003,2275,653,1412,863,10543
15000US060530016001,1758,607,1029,729,10544
15000US060530016002,1014,588,237,777,10545
15000US060530017001,2315,544,1605,710,10546
15000US060530017002,1526,451,1021,505,10547
15000US060530018011,1721,262,1251,470,10548
15000US060530018012,2494,561,1166,1328,10549
15000US060530018021,1807,274,1283,524,10550
15000US060530018022,1536,39,1403,133,10551
15000US060530018023,1665,360,1193,472,10552
15000US060530101011,2346,96,2168,178,10553
15000US060530101012,2595,279,2213,382,10554
15000US060530101021,1971,683,1236,735,10555
15000US060530101022,1665,1118,442,1223,10556
15000US060530102021,1037,240,668,369,10557
15000US060530102022,2185,992,967,1218,10558
15000US060530102023,1895,641,1159,736,10559
15000US060530103051,1974,1115,694,1280,10560
15000US060530103052,1754,1052,419,1335,10561
15000US060530103053,917,334,577,340,10562
15000US060530103061,1448,625,784,664,10563
15000US060530104001,1685,176,1451,234,10564
15000US060530104002,2076,151,1842,234,10565
15000US060530104003,1826,82,1602,224,10566
15000US060530104004,1391,0,1391,0,10567
15000US060530105011,1179,486,688,491,10568
15000US060530105012,2758,1518,1019,1739,10569
15000US060530105013,1055,538,507,548,10570
15000US060530105014,1156,503,626,530,10571
15000US060530105041,2229,432,1781,448,10572
15000US060530105042,2716,492,1563,1153,10573
15000US060530105051,2435,284,1936,499,10574
15000US060530105052,3801,947,2691,1110,10575
15000US060530105061,2897,234,2481,416,10576
15000US060530105062,1830,387,1134,696,10577
15000US060530106031,4088,1000,2143,1945,10578
15000US060530106032,3136,351,1741,1395,10579
15000US060530106041,3172,185,2523,649,10580
15000US060530106042,2775,288,2154,621,10581
15000US060530106051,4638,181,4162,476,10582
15000US060530106061,2308,838,1219,1089,10583
15000US060530106062,4925,108,4528,397,10584
15000US060530106071,2317,79,2119,198,10585
15000US060530106072,2298,8,2290,8,10586
15000US060530106081,1175,253,666,509,10587
15000US060530106082,1011,0,1011,0,10588
15000US060530106083,995,12,983,12,10589
15000US060530107011,1241,875,251,990,10590
15000US060530107012,3212,2125,702,2510,10591
15000US060530107013,1368,1143,16,1352,10592
15000US060530107014,548,436,61,487,10593
15000US060530107021,1857,1551,262,1595,10594
15000US060530107022,1674,1324,133,1541,10595
15000US060530108041,1448,134,1314,134,10596
15000US060530108042,1612,38,1574,38,10597
15000US060530108043,2670,91,2530,140,10598
15000US060530109001,9130,2061,3969,5161,10599
15000US060530110001,1188,1013,70,1118,10600
15000US060530110002,992,957,0,992,10601
15000US060530110003,1533,1104,341,1192,10602
15000US060530110004,1040,763,137,903,10603
15000US060530110005,1304,903,389,915,10604
15000US060530111011,906,321,561,345,10605
15000US060530111012,1317,66,1221,96,10606
15000US060530111013,3048,256,2757,291,10607
15000US060530111021,3925,624,3224,701,10608
15000US060530111022,3281,371,2693,588,10609
15000US060530111023,5240,261,4484,756,10610
15000US060530112021,1443,329,1099,344,10611
15000US060530112022,3077,241,2710,367,10612
15000US060530112023,2547,138,2313,234,10613
15000US060530112031,1426,14,1412,14,10614
15000US060530112032,2840,171,2618,222,10615
15000US060530112033,2968,406,2522,446,10616
15000US060530112041,1170,433,720,450,10617
15000US060530112042,2718,77,2628,90,10618
15000US060530113021,2149,73,2076,73,10619
15000US060530113022,1321,270,997,324,10620
15000US060530113023,2165,230,1869,296,10621
15000US060530113031,2873,1390,1320,1553,10622
15000US060530113032,1122,179,943,179,10623
15000US060530113041,1303,110,1173,130,10624
15000US060530113042,3127,67,2987,140,10625
15000US060530113043,2777,149,2444,333,10626
15000US060530114001,2173,1098,989,1184,10627
15000US060530114002,2671,1767,601,2070,10628
15000US060530115021,1514,996,462,1052,10629
15000US060530116021,1455,1243,121,1334,10630
15000US060530116022,1303,1252,35,1268,10631
15000US060530116023,976,890,17,959,10632
15000US060530116024,1839,1453,177,1662,10633
15000US060530116041,1710,1641,37,1673,10634
15000US060530117001,992,881,23,969,10635
15000US060530117002,1767,1437,240,1527,10636
15000US060530117003,1367,964,193,1174,10637
15000US060530118011,1446,1194,110,1336,10638
15000US060530118012,725,510,36,689,10639
15000US060530118021,712,512,168,544,10640
15000US060530118022,969,747,137,832,10641
15000US060530119001,995,781,115,880,10642
15000US060530119002,1824,1464,194,1630,10643
15000US060530119003,954,716,93,861,10644
15000US060530119004,941,816,34,907,10645
15000US060530120001,2045,1431,306,1739,10646
15000US060530120002,1932,1381,180,1752,10647
15000US060530121001,1082,827,195,887,10648
15000US060530121002,1024,805,66,958,10649
15000US060530122001,624,573,43,581,10650
15000US060530122002,1999,1736,161,1838,10651
15000US060530123021,1992,1703,176,1816,10652
15000US060530124011,1063,802,137,926,10653
15000US060530124012,586,514,60,526,10654
15000US060530124021,1080,942,108,972,10655
15000US060530124022,794,424,270,524,10656
15000US060530124023,1325,975,111,1214,10657
15000US060530125021,1433,953,266,1167,10658
15000US060530125022,1119,601,347,772,10659
15000US060530125023,1034,807,56,978,10660
15000US060530125024,786,579,112,674,10661
15000US060530125025,622,336,195,427,10662
15000US060530126001,2215,1359,436,1779,10663
15000US060530127001,759,576,111,648,10664
15000US060530127002,458,353,35,423,10665
15000US060530127003,1327,926,106,1221,10666
15000US060530127004,1155,586,131,1024,10667
15000US060530128001,966,806,78,888,10668
15000US060530128002,1707,1311,294,1413,10669
15000US060530128003,1025,941,56,969,10670
15000US060530128004,738,583,121,617,10671
15000US060530128005,836,709,99,737,10672
15000US060530130001,1649,1126,176,1473,10673
15000US060530130002,718,343,102,616,10674
15000US060530130003,1064,703,155,909,10675
15000US060530131001,1726,1190,217,1509,10676
15000US060530132001,1941,1520,121,1820,10677
15000US060530132002,2054,1716,230,1824,10678
15000US060530133001,1834,934,551,1283,10679
15000US060530133002,1352,747,333,1019,10680
15000US060530133003,2011,575,938,1073,10681
15000US060530133004,911,655,82,829,10682
15000US060530134001,1683,1192,252,1431,10683
15000US060530135001,905,206,130,775,10684
15000US060530135002,1372,704,548,824,10685
15000US060530135003,2622,718,944,1678,10686
15000US060530136001,2827,391,1951,876,10687
15000US060530136002,1487,610,660,827,10688
15000US060530137001,1599,340,1030,569,10689
15000US060530137002,2359,152,1987,372,10690
15000US060530137003,936,115,436,500,10691
15000US060530138001,1230,356,199,1031,10692
15000US060530138002,3140,761,1359,1781,10693
15000US060530138003,1374,194,782,592,10694
15000US060530139001,1489,641,342,1147,10695
15000US060530139002,1291,285,741,550,10696
15000US060530140001,2621,785,1377,1244,10697
15000US060530141021,2008,756,386,1622,10698
15000US060530141022,260,77,162,98,10699
15000US060530141041,1874,943,585,1289,10700
15000US060530141042,0,0,0,0,10701
15000US060530141043,0,0,0,0,10702
15000US060530141051,3035,1711,712,2323,10703
15000US060530141071,2991,884,1576,1415,10704
15000US060530141072,2293,1364,411,1882,10705
15000US060530141073,2522,1400,336,2186,10706
15000US060530142011,1265,507,324,941,10707
15000US060530142012,1379,637,151,1228,10708
15000US060530142013,3167,713,1617,1550,10709
15000US060530142021,1310,436,303,1007,10710
15000US060530142022,3083,1142,696,2387,10711
15000US060530143011,2018,847,432,1586,10712
15000US060530143012,1334,632,221,1113,10713
15000US060530143021,1544,867,254,1290,10714
15000US060530143022,2729,1003,656,2073,10715
15000US060530145001,1195,229,966,229,10716
15000US060530145002,2104,848,1057,1047,10717
15000US060530145003,1231,697,290,941,10718
15000US060530146011,2511,142,2365,146,10719
15000US060530146012,1706,331,1316,390,10720
15000US060530146013,1396,431,948,448,10721
15000US060530147001,604,361,201,403,10722
15000US060530147002,1738,806,547,1191,10723
15000US060530147003,1488,643,801,687,10724
15000US060530147004,3169,321,2757,412,10725
15000US060530148001,1316,412,861,455,10726
15000US060530148002,1238,21,1214,24,10727
15000US060530148003,3596,216,3282,314,10728
15000US060539800001,38,0,38,0,10729
15000US060539900000,0,0,0,0,10730
15000US060552002011,1149,632,490,659,10731
15000US060552002012,1237,688,501,736,10732
15000US060552002013,978,514,464,514,10733
15000US060552002021,596,459,97,499,10734
15000US060552002022,649,285,286,363,10735
15000US060552002023,1793,770,904,889,10736
15000US060552002031,1266,744,469,797,10737
15000US060552002032,1068,569,460,608,10738
15000US060552003011,1302,946,277,1025,10739
15000US060552003012,1761,498,1178,583,10740
15000US060552003013,2167,741,1390,777,10741
15000US060552003021,1539,801,613,926,10742
15000US060552003022,1255,572,558,697,10743
15000US060552004001,1577,1154,387,1190,10744
15000US060552004002,1265,916,237,1028,10745
15000US060552004003,1362,859,398,964,10746
15000US060552005011,1712,590,1060,652,10747
15000US060552005012,1515,574,897,618,10748
15000US060552005013,2067,1038,931,1136,10749
15000US060552005031,1100,700,374,726,10750
15000US060552005032,623,153,441,182,10751
15000US060552005041,1628,477,859,769,10752
15000US060552005042,3885,2043,1713,2172,10753
15000US060552005043,888,583,305,583,10754
15000US060552005051,1865,508,1149,716,10755
15000US060552005052,1129,718,326,803,10756
15000US060552006011,1585,741,642,943,10757
15000US060552006012,1348,813,504,844,10758
15000US060552006013,1262,669,512,750,10759
15000US060552006014,1054,592,390,664,10760
15000US060552006021,2286,1423,720,1566,10761
15000US060552006022,1124,682,367,757,10762
15000US060552006023,805,664,113,692,10763
15000US060552007031,2164,1913,199,1965,10764
15000US060552007032,570,525,16,554,10765
15000US060552007041,1643,1138,425,1218,10766
15000US060552007042,1862,936,840,1022,10767
15000US060552007043,1710,431,1197,513,10768
15000US060552007051,1675,1126,489,1186,10769
15000US060552007052,1163,382,648,515,10770
15000US060552007061,1174,779,220,954,10771
15000US060552007062,1360,848,434,926,10772
15000US060552007063,800,494,232,568,10773
15000US060552007071,1810,1221,467,1343,10774
15000US060552007072,1261,911,300,961,10775
15000US060552008021,758,624,111,647,10776
15000US060552008022,1220,1057,6,1214,10777
15000US060552008023,3443,1957,1219,2224,10778
15000US060552008031,1001,537,448,553,10779
15000US060552008032,1091,1018,67,1024,10780
15000US060552008041,1460,502,893,567,10781
15000US060552008042,1827,430,1298,529,10782
15000US060552008043,1045,261,784,261,10783
15000US060552008044,1672,270,1291,381,10784
15000US060552009001,767,408,109,658,10785
15000US060552010031,931,729,180,751,10786
15000US060552010032,4174,529,946,3228,10787
15000US060552010041,3190,746,909,2281,10788
15000US060552010042,3293,629,787,2506,10789
15000US060552010051,1029,311,168,861,10790
15000US060552010052,1226,527,361,865,10791
15000US060552010061,1945,738,714,1231,10792
15000US060552010062,1281,397,335,946,10793
15000US060552010071,2585,782,715,1870,10794
15000US060552010072,1824,382,592,1232,10795
15000US060552011011,1385,1071,209,1176,10796
15000US060552011012,841,707,50,791,10797
15000US060552011021,1203,1043,104,1099,10798
15000US060552011022,646,591,46,600,10799
15000US060552012001,661,342,248,413,10800
15000US060552012002,860,700,131,729,10801
15000US060552012003,1873,1083,736,1137,10802
15000US060552012004,1440,738,481,959,10803
15000US060552013001,1289,1025,198,1091,10804
15000US060552013002,1107,935,103,1004,10805
15000US060552013003,595,481,36,559,10806
15000US060552014011,1233,1044,57,1176,10807
15000US060552014012,1186,1040,27,1159,10808
15000US060552014013,759,684,75,684,10809
15000US060552014021,769,698,50,719,10810
15000US060552014022,891,825,10,881,10811
15000US060552014023,1437,1122,216,1221,10812
15000US060552014031,394,262,91,303,10813
15000US060552014032,232,194,24,208,10814
15000US060552015001,1230,847,333,897,10815
15000US060552015002,868,457,383,485,10816
15000US060552016011,1086,704,280,806,10817
15000US060552016012,1429,691,708,721,10818
15000US060552016021,939,804,77,862,10819
15000US060552016022,824,603,166,658,10820
15000US060552016023,286,250,36,250,10821
15000US060552016024,1431,974,357,1074,10822
15000US060552017001,763,434,259,504,10823
15000US060552017002,2257,901,580,1677,10824
15000US060552017003,933,573,215,718,10825
15000US060552017004,990,711,172,818,10826
15000US060552017005,755,677,46,709,10827
15000US060552017006,265,223,34,231,10828
15000US060552018001,806,502,246,560,10829
15000US060552018002,875,716,104,771,10830
15000US060552019001,628,378,195,433,10831
15000US060552019002,582,457,88,494,10832
15000US060552020001,1322,441,881,441,10833
15000US060552020002,797,360,413,384,10834
15000US060552020003,1642,811,661,981,10835
15000US060552020004,1520,894,626,894,10836
15000US060570001021,1398,1388,10,1388,10837
15000US060570001022,1734,1647,35,1699,10838
15000US060570001023,1914,1778,61,1853,10839
15000US060570001024,1456,1240,154,1302,10840
15000US060570001031,929,905,12,917,10841
15000US060570001032,1302,1208,8,1294,10842
15000US060570001033,742,717,15,727,10843
15000US060570001034,575,539,0,575,10844
15000US060570001035,1509,1115,367,1142,10845
15000US060570001036,880,861,19,861,10846
15000US060570001037,1702,1538,133,1569,10847
15000US060570001041,788,700,17,771,10848
15000US060570001042,1416,1394,15,1401,10849
15000US060570001043,987,873,61,926,10850
15000US060570001051,805,788,0,805,10851
15000US060570001052,661,459,180,481,10852
15000US060570001053,1149,1019,128,1021,10853
15000US060570002001,1162,1061,53,1109,10854
15000US060570002002,1369,1159,82,1287,10855
15000US060570003001,519,475,18,501,10856
15000US060570003002,1907,1692,178,1729,10857
15000US060570004011,689,572,0,689,10858
15000US060570004012,1578,1409,39,1539,10859
15000US060570004013,1947,1495,168,1779,10860
15000US060570004014,1764,1447,203,1561,10861
15000US060570004021,1627,1297,114,1513,10862
15000US060570004022,2085,1678,201,1884,10863
15000US060570004023,2106,1442,329,1777,10864
15000US060570004024,928,894,34,894,10865
15000US060570005011,1269,1136,10,1259,10866
15000US060570005012,2032,1539,392,1640,10867
15000US060570005013,1306,1249,57,1249,10868
15000US060570005014,947,888,34,913,10869
15000US060570005015,517,423,58,459,10870
15000US060570005021,892,746,146,746,10871
15000US060570005022,1282,1106,119,1163,10872
15000US060570005023,1614,1220,233,1381,10873
15000US060570005024,1110,999,111,999,10874
15000US060570006001,1456,1303,140,1316,10875
15000US060570006002,1139,1093,2,1137,10876
15000US060570006003,1509,1312,130,1379,10877
15000US060570006004,935,647,260,675,10878
15000US060570006005,1638,1472,66,1572,10879
15000US060570007011,878,815,32,846,10880
15000US060570007012,1422,1271,116,1306,10881
15000US060570007013,1246,1069,91,1155,10882
15000US060570007014,808,765,0,808,10883
15000US060570007015,1479,1368,65,1414,10884
15000US060570007016,1494,1403,61,1433,10885
15000US060570007021,2190,2058,51,2139,10886
15000US060570007022,1758,1473,65,1693,10887
15000US060570008011,1395,1319,65,1330,10888
15000US060570008012,1746,1528,137,1609,10889
15000US060570008013,1992,1878,47,1945,10890
15000US060570008021,1213,831,242,971,10891
15000US060570008022,2178,1982,68,2110,10892
15000US060570008023,930,897,0,930,10893
15000US060570008024,2115,1625,414,1701,10894
15000US060570009001,1497,1130,97,1400,10895
15000US060570009002,2035,1722,81,1954,10896
15000US060570009003,598,585,0,598,10897
15000US060570012031,987,880,65,922,10898
15000US060570012032,860,808,34,826,10899
15000US060570012033,977,818,54,923,10900
15000US060570012041,717,668,49,668,10901
15000US060570012042,1014,932,42,972,10902
15000US060570012043,621,505,101,520,10903
15000US060570012051,2133,2027,64,2069,10904
15000US060570012052,2506,2364,102,2404,10905
15000US060570012053,404,349,17,387,10906
15000US060570012061,974,461,453,521,10907
15000US060570012062,1354,371,952,402,10908
15000US060570012063,1542,1114,350,1192,10909
15000US060570012064,907,565,316,591,10910
15000US060570012065,1395,965,396,999,10911
15000US060590011011,1641,608,776,865,10912
15000US060590011012,909,304,471,438,10913
15000US060590011013,1307,626,556,751,10914
15000US060590011014,742,437,295,447,10915
15000US060590011021,1126,308,792,334,10916
15000US060590011022,991,329,509,482,10917
15000US060590011023,973,511,252,721,10918
15000US060590011031,1535,656,833,702,10919
15000US060590011032,1591,402,898,693,10920
15000US060590011033,1241,355,865,376,10921
15000US060590012011,1792,326,1383,409,10922
15000US060590012012,1970,251,1588,382,10923
15000US060590012013,1598,276,1232,366,10924
15000US060590012021,1797,194,1569,228,10925
15000US060590012022,820,209,558,262,10926
15000US060590012023,1324,88,1223,101,10927
15000US060590013011,1578,437,250,1328,10928
15000US060590013012,949,342,373,576,10929
15000US060590013013,1090,357,673,417,10930
15000US060590013014,1272,591,535,737,10931
15000US060590013015,1740,532,742,998,10932
15000US060590013031,2308,640,1096,1212,10933
15000US060590013032,2079,602,1223,856,10934
15000US060590013033,1669,226,1302,367,10935
15000US060590013041,865,116,695,170,10936
15000US060590013042,2921,536,2146,775,10937
15000US060590014011,1384,619,688,696,10938
15000US060590014012,973,340,456,517,10939
15000US060590014013,1090,192,828,262,10940
15000US060590014014,1553,283,1160,393,10941
15000US060590014021,4345,1014,3098,1247,10942
15000US060590014022,1437,813,381,1056,10943
15000US060590014031,1446,734,530,916,10944
15000US060590014032,1773,737,979,794,10945
15000US060590014041,1288,349,849,439,10946
15000US060590014042,1045,68,931,114,10947
15000US060590014043,1783,209,1468,315,10948
15000US060590015011,2301,1382,538,1763,10949
15000US060590015012,2153,1062,489,1664,10950
15000US060590015013,1799,1032,172,1627,10951
15000US060590015031,2041,1130,490,1551,10952
15000US060590015032,937,466,345,592,10953
15000US060590015033,1761,519,1004,757,10954
15000US060590015034,870,653,60,810,10955
15000US060590015041,1189,404,594,595,10956
15000US060590015042,1065,624,156,909,10957
15000US060590015043,907,490,239,668,10958
15000US060590015044,1486,540,631,855,10959
15000US060590015051,1210,396,106,1104,10960
15000US060590015052,3480,1741,1092,2388,10961
15000US060590015053,1649,813,327,1322,10962
15000US060590015054,858,518,193,665,10963
15000US060590015061,2069,900,734,1335,10964
15000US060590015062,2160,1149,437,1723,10965
15000US060590015071,1626,793,487,1139,10966
15000US060590015072,1107,495,369,738,10967
15000US060590015073,2065,1094,598,1467,10968
15000US060590016011,980,290,399,581,10969
15000US060590016012,925,479,171,754,10970
15000US060590016013,864,357,29,835,10971
15000US060590016014,841,552,60,781,10972
15000US060590016015,2973,975,686,2287,10973
15000US060590016016,1732,770,171,1561,10974
15000US060590016021,1040,342,231,809,10975
15000US060590016022,1150,643,142,1008,10976
15000US060590016023,793,534,66,727,10977
15000US060590016024,1179,723,156,1023,10978
15000US060590016025,710,327,92,618,10979
15000US060590017041,4679,598,182,4497,10980
15000US060590017042,997,432,57,940,10981
15000US060590017043,1965,714,405,1560,10982
15000US060590017051,2454,723,1335,1119,10983
15000US060590017052,936,283,546,390,10984
15000US060590017053,1010,469,98,912,10985
15000US060590017061,1314,564,124,1190,10986
15000US060590017062,840,672,134,706,10987
15000US060590017063,972,511,159,813,10988
15000US060590017064,622,359,23,599,10989
15000US060590017071,2490,610,708,1782,10990
15000US060590017072,2026,133,0,2026,10991
15000US060590017073,1264,297,278,986,10992
15000US060590017074,1647,226,12,1635,10993
15000US060590017081,1025,339,482,543,10994
15000US060590017082,1005,392,41,964,10995
15000US060590017083,1359,530,147,1212,10996
15000US060590018011,1735,226,1140,595,10997
15000US060590018012,1112,267,821,291,10998
15000US060590018013,1094,242,591,503,10999
15000US060590018014,1258,86,869,389,11000
15000US060590018021,1756,198,1379,377,11001
15000US060590018022,1726,393,632,1094,11002
15000US060590018023,1413,395,610,803,11003
15000US060590018024,1678,75,1458,220,11004
15000US060590018025,1487,157,885,602,11005
15000US060590019011,1580,370,934,646,11006
15000US060590019012,1290,493,580,710,11007
15000US060590019021,1741,617,859,882,11008
15000US060590019022,1275,388,579,696,11009
15000US060590019031,1917,542,1111,806,11010
15000US060590019032,1720,321,1123,597,11011
15000US060590110001,705,365,180,525,11012
15000US060590110002,898,574,138,760,11013
15000US060590110003,432,295,45,387,11014
15000US060590110004,1651,702,562,1089,11015
15000US060590110005,957,413,112,845,11016
15000US060590110006,1487,531,635,852,11017
15000US060590111011,3107,605,2293,814,11018
15000US060590111012,1480,541,736,744,11019
15000US060590111021,1136,317,687,449,11020
15000US060590111022,1031,355,379,652,11021
15000US060590111023,2360,372,1356,1004,11022
15000US060590112001,1032,478,215,817,11023
15000US060590112002,822,430,340,482,11024
15000US060590112003,563,399,107,456,11025
15000US060590112004,1439,640,704,735,11026
15000US060590113001,2760,1225,698,2062,11027
15000US060590113002,1492,1061,353,1139,11028
15000US060590113003,1057,643,325,732,11029
15000US060590114011,768,277,323,445,11030
15000US060590114012,1263,910,193,1070,11031
15000US060590114021,1111,675,283,828,11032
15000US060590114022,1224,854,136,1088,11033
15000US060590114031,380,235,110,270,11034
15000US060590114032,1044,330,590,454,11035
15000US060590114033,1861,450,1006,855,11036
15000US060590114034,989,165,701,288,11037
15000US060590114035,1770,727,843,927,11038
15000US060590115021,860,239,511,349,11039
15000US060590115022,1263,463,550,713,11040
15000US060590115023,1751,601,727,1024,11041
15000US060590115031,849,457,84,765,11042
15000US060590115032,877,533,217,660,11043
15000US060590115041,894,353,319,575,11044
15000US060590115042,1503,629,385,1118,11045
15000US060590115043,1148,446,553,595,11046
15000US060590115044,1501,813,456,1045,11047
15000US060590115045,1237,357,252,985,11048
15000US060590116011,943,139,685,258,11049
15000US060590116012,2326,187,1968,358,11050
15000US060590116013,551,215,121,430,11051
15000US060590116014,936,160,556,380,11052
15000US060590116015,1063,157,620,443,11053
15000US060590116016,1981,106,1725,256,11054
15000US060590116021,1973,22,1750,223,11055
15000US060590116022,2290,362,1784,506,11056
15000US060590116023,1086,304,732,354,11057
15000US060590117071,3539,1701,468,3071,11058
15000US060590117072,1237,780,240,997,11059
15000US060590117073,1570,531,560,1010,11060
15000US060590117081,1786,684,500,1286,11061
15000US060590117082,1343,564,512,831,11062
15000US060590117083,1048,706,132,916,11063
15000US060590117091,1291,831,220,1071,11064
15000US060590117092,1273,1021,190,1083,11065
15000US060590117093,1947,1164,281,1666,11066
15000US060590117101,1163,823,234,929,11067
15000US060590117102,2491,1360,596,1895,11068
15000US060590117111,1289,783,213,1076,11069
15000US060590117112,1957,788,463,1494,11070
15000US060590117113,856,322,123,733,11071
15000US060590117114,1026,311,169,857,11072
15000US060590117115,3144,593,2512,632,11073
15000US060590117121,1600,411,976,624,11074
15000US060590117122,1872,343,853,1019,11075
15000US060590117123,1714,707,356,1358,11076
15000US060590117141,991,305,533,458,11077
15000US060590117151,1732,613,758,974,11078
15000US060590117152,3164,2057,545,2619,11079
15000US060590117153,1508,1038,201,1307,11080
15000US060590117161,2102,439,1024,1078,11081
15000US060590117162,3271,1284,453,2818,11082
15000US060590117171,2226,1292,517,1709,11083
15000US060590117172,944,638,144,800,11084
15000US060590117181,1373,890,321,1052,11085
15000US060590117182,1835,1300,262,1573,11086
15000US060590117201,2610,47,2488,122,11087
15000US060590117202,2996,287,2530,466,11088
15000US060590117203,1395,62,1211,184,11089
15000US060590117211,1353,105,1169,184,11090
15000US060590117212,2012,49,1809,203,11091
15000US060590117213,1657,654,637,1020,11092
15000US060590117221,1098,297,515,583,11093
15000US060590117222,593,440,143,450,11094
15000US060590117223,803,390,341,462,11095
15000US060590218021,1681,1064,293,1388,11096
15000US060590218022,1071,629,243,828,11097
15000US060590218023,1601,1044,374,1227,11098
15000US060590218024,946,626,264,682,11099
15000US060590218025,1724,1023,634,1090,11100
15000US060590218071,1768,928,652,1116,11101
15000US060590218072,2081,1391,432,1649,11102
15000US060590218091,2130,1412,470,1660,11103
15000US060590218092,931,783,110,821,11104
15000US060590218101,1495,591,806,689,11105
15000US060590218102,1691,756,499,1192,11106
15000US060590218103,999,679,243,756,11107
15000US060590218121,687,654,9,678,11108
15000US060590218122,2623,1428,1017,1606,11109
15000US060590218123,1345,757,205,1140,11110
15000US060590218124,1501,842,352,1149,11111
15000US060590218131,102,16,57,45,11112
15000US060590218141,1881,1024,458,1423,11113
15000US060590218142,2803,1304,943,1860,11114
15000US060590218143,1051,477,297,754,11115
15000US060590218144,1096,679,192,904,11116
15000US060590218151,3235,508,657,2578,11117
15000US060590218152,668,348,275,393,11118
15000US060590218153,4427,2692,599,3828,11119
15000US060590218161,1350,882,264,1086,11120
15000US060590218162,1844,1316,305,1539,11121
15000US060590218163,1972,1329,281,1691,11122
15000US060590218171,3105,1858,828,2277,11123
15000US060590218172,827,519,246,581,11124
15000US060590218201,1088,598,209,879,11125
15000US060590218202,3442,1746,578,2864,11126
15000US060590218211,2112,850,600,1512,11127
15000US060590218212,3024,958,1469,1555,11128
15000US060590218213,1973,1252,330,1643,11129
15000US060590218221,1215,680,105,1110,11130
15000US060590218222,4298,1545,402,3896,11131
15000US060590218223,1487,696,141,1346,11132
15000US060590218224,2455,1759,184,2271,11133
15000US060590218231,3725,2301,626,3099,11134
15000US060590218241,1206,783,201,1005,11135
15000US060590218242,1493,1102,150,1343,11136
15000US060590218251,1690,1139,172,1518,11137
15000US060590218252,1511,863,457,1054,11138
15000US060590218261,1667,853,307,1360,11139
15000US060590218262,1235,770,300,935,11140
15000US060590218271,1362,705,372,990,11141
15000US060590218272,1893,972,348,1545,11142
15000US060590218281,1227,709,242,985,11143
15000US060590218282,1379,723,327,1052,11144
15000US060590218283,1892,1056,165,1727,11145
15000US060590218291,1864,1236,188,1676,11146
15000US060590218292,1551,971,182,1369,11147
15000US060590218293,2020,974,180,1840,11148
15000US060590218301,899,632,196,703,11149
15000US060590218302,1414,926,176,1238,11150
15000US060590218303,2205,1456,171,2034,11151
15000US060590218304,1120,819,102,1018,11152
15000US060590219031,1414,776,348,1066,11153
15000US060590219032,1103,639,260,843,11154
15000US060590219033,1452,712,400,1052,11155
15000US060590219051,2159,1078,761,1398,11156
15000US060590219052,2112,1225,363,1749,11157
15000US060590219053,1244,975,125,1119,11158
15000US060590219121,1877,859,205,1672,11159
15000US060590219122,1499,987,274,1225,11160
15000US060590219123,1005,817,115,890,11161
15000US060590219131,843,471,122,721,11162
15000US060590219132,1935,495,1119,816,11163
15000US060590219133,2028,798,1015,1013,11164
15000US060590219134,3135,52,2889,246,11165
15000US060590219141,2650,1252,896,1754,11166
15000US060590219142,1420,1025,260,1160,11167
15000US060590219151,1699,948,457,1242,11168
15000US060590219152,2249,1330,287,1962,11169
15000US060590219161,1521,975,44,1477,11170
15000US060590219162,1802,1141,289,1513,11171
15000US060590219171,1663,1021,339,1324,11172
15000US060590219172,786,506,178,608,11173
15000US060590219173,868,722,101,767,11174
15000US060590219181,1600,979,326,1274,11175
15000US060590219182,2190,1428,384,1806,11176
15000US060590219183,967,381,520,447,11177
15000US060590219191,1345,666,354,991,11178
15000US060590219192,1443,816,381,1062,11179
15000US060590219201,463,181,21,442,11180
15000US060590219202,1352,842,303,1049,11181
15000US060590219203,939,621,160,779,11182
15000US060590219204,4035,2290,541,3494,11183
15000US060590219211,1088,838,170,918,11184
15000US060590219212,3460,1899,458,3002,11185
15000US060590219221,1730,960,394,1336,11186
15000US060590219222,582,436,84,498,11187
15000US060590219223,944,349,14,930,11188
15000US060590219224,1365,725,200,1165,11189
15000US060590219231,3023,1674,348,2675,11190
15000US060590219232,1440,613,89,1351,11191
15000US060590219233,1417,1107,133,1284,11192
15000US060590219234,950,461,233,717,11193
15000US060590219241,0,0,0,0,11194
15000US060590219242,1172,587,258,914,11195
15000US060590219243,3094,1407,701,2393,11196
15000US060590320021,801,543,82,719,11197
15000US060590320022,1560,1402,94,1466,11198
15000US060590320023,2644,1580,699,1945,11199
15000US060590320024,1480,840,341,1139,11200
15000US060590320031,1787,1176,404,1383,11201
15000US060590320032,1615,1232,213,1402,11202
15000US060590320033,1459,1149,155,1304,11203
15000US060590320111,762,626,101,661,11204
15000US060590320112,884,704,163,721,11205
15000US060590320121,1790,1199,431,1359,11206
15000US060590320122,1588,1243,170,1418,11207
15000US060590320123,761,327,338,423,11208
15000US060590320131,2343,1674,135,2208,11209
15000US060590320132,1743,1517,71,1672,11210
15000US060590320133,1116,679,99,1017,11211
15000US060590320141,3135,836,1820,1315,11212
15000US060590320142,2491,1140,979,1512,11213
15000US060590320151,2195,1389,400,1795,11214
15000US060590320152,1501,867,427,1074,11215
15000US060590320153,983,654,171,812,11216
15000US060590320154,2166,1356,285,1881,11217
15000US060590320201,2049,1625,258,1791,11218
15000US060590320202,2379,1549,387,1992,11219
15000US060590320203,1375,935,324,1051,11220
15000US060590320221,2470,999,1429,1041,11221
15000US060590320222,1765,1076,544,1221,11222
15000US060590320223,2593,977,1254,1339,11223
15000US060590320231,8790,6451,1008,7782,11224
15000US060590320232,3398,2816,180,3218,11225
15000US060590320233,2139,1827,273,1866,11226
15000US060590320271,3221,1638,1104,2117,11227
15000US060590320272,3606,1389,1576,2030,11228
15000US060590320281,923,659,182,741,11229
15000US060590320282,2197,1315,539,1658,11230
15000US060590320291,1336,955,140,1196,11231
15000US060590320292,1603,1093,166,1437,11232
15000US060590320293,1629,761,424,1205,11233
15000US060590320301,1170,800,236,934,11234
15000US060590320302,2575,1704,574,2001,11235
15000US060590320311,1459,999,263,1196,11236
15000US060590320312,2094,1389,361,1733,11237
15000US060590320321,1126,850,110,1016,11238
15000US060590320322,1901,1197,441,1460,11239
15000US060590320331,1915,902,467,1448,11240
15000US060590320332,1092,688,193,899,11241
15000US060590320333,645,555,55,590,11242
15000US060590320341,1292,967,105,1187,11243
15000US060590320342,3567,2556,514,3053,11244
15000US060590320343,1022,585,134,888,11245
15000US060590320351,1481,1158,129,1352,11246
15000US060590320352,1028,701,170,858,11247
15000US060590320361,1342,715,409,933,11248
15000US060590320362,2811,1766,655,2156,11249
15000US060590320371,1853,1607,199,1654,11250
15000US060590320372,2185,1551,101,2084,11251
15000US060590320373,1250,1187,42,1208,11252
15000US060590320381,3224,1983,465,2759,11253
15000US060590320382,854,476,66,788,11254
15000US060590320383,2450,1623,230,2220,11255
15000US060590320391,1148,886,93,1055,11256
15000US060590320392,2741,1822,105,2636,11257
15000US060590320393,1481,804,453,1028,11258
15000US060590320394,1608,808,463,1145,11259
15000US060590320401,1533,1217,102,1431,11260
15000US060590320402,1131,914,109,1022,11261
15000US060590320411,1032,713,169,863,11262
15000US060590320421,3130,2504,335,2795,11263
15000US060590320422,878,623,200,678,11264
15000US060590320423,1859,1413,314,1545,11265
15000US060590320431,2329,1622,293,2036,11266
15000US060590320432,1452,1246,110,1342,11267
15000US060590320441,1606,1298,83,1523,11268
15000US060590320442,1431,1202,41,1390,11269
15000US060590320443,951,652,154,797,11270
15000US060590320444,1870,1250,328,1542,11271
15000US060590320451,1338,1062,96,1242,11272
15000US060590320452,1801,1353,316,1485,11273
15000US060590320461,812,708,68,744,11274
15000US060590320462,1270,1041,164,1106,11275
15000US060590320463,2266,1704,139,2127,11276
15000US060590320464,1500,1213,81,1419,11277
15000US060590320471,994,605,334,660,11278
15000US060590320472,1108,724,242,866,11279
15000US060590320473,658,451,20,638,11280
15000US060590320474,1358,852,169,1189,11281
15000US060590320481,958,717,117,841,11282
15000US060590320482,1461,1340,49,1412,11283
15000US060590320483,1082,577,41,1041,11284
15000US060590320484,1673,939,440,1233,11285
15000US060590320491,4379,3016,577,3802,11286
15000US060590320492,875,418,5,870,11287
15000US060590320493,2411,1319,452,1959,11288
15000US060590320494,2218,1368,312,1906,11289
15000US060590320501,541,394,40,501,11290
15000US060590320502,1572,1089,252,1320,11291
15000US060590320503,2723,1805,489,2234,11292
15000US060590320511,953,480,382,571,11293
15000US060590320512,1033,640,99,934,11294
15000US060590320513,1410,873,434,976,11295
15000US060590320514,1224,287,758,466,11296
15000US060590320531,3848,2974,271,3577,11297
15000US060590320532,1746,1100,244,1502,11298
15000US060590320533,1234,839,292,942,11299
15000US060590320534,1475,915,222,1253,11300
15000US060590320541,2127,1602,164,1963,11301
15000US060590320542,794,386,392,402,11302
15000US060590320543,1112,773,261,851,11303
15000US060590320544,1438,1052,232,1206,11304
15000US060590320551,464,352,52,412,11305
15000US060590320552,1572,270,1096,476,11306
15000US060590320553,652,523,82,570,11307
15000US060590320554,1158,647,158,1000,11308
15000US060590320561,1721,1022,426,1295,11309
15000US060590320562,933,643,77,856,11310
15000US060590320563,2312,1905,167,2145,11311
15000US060590320564,908,448,222,686,11312
15000US060590320565,1884,907,535,1349,11313
15000US060590320571,3536,2277,701,2835,11314
15000US060590320572,3941,2841,462,3479,11315
15000US060590320573,718,458,0,718,11316
15000US060590320581,3648,2556,479,3169,11317
15000US060590320582,4060,2612,713,3347,11318
15000US060590320591,2079,1312,242,1837,11319
15000US060590320592,2412,2036,179,2233,11320
15000US060590320593,1742,1009,543,1199,11321
15000US060590320594,2527,1303,734,1793,11322
15000US060590320595,1933,1161,405,1528,11323
15000US060590320611,3764,3351,310,3454,11324
15000US060590320612,464,257,0,464,11325
15000US060590421031,2222,1619,598,1624,11326
15000US060590421032,703,607,96,607,11327
15000US060590421033,1825,1424,79,1746,11328
15000US060590421034,1869,1379,311,1558,11329
15000US060590421035,1207,854,296,911,11330
15000US060590421061,723,667,15,708,11331
15000US060590421062,597,533,55,542,11332
15000US060590421071,1888,643,1181,707,11333
15000US060590421072,2502,1279,1094,1408,11334
15000US060590421081,1259,530,705,554,11335
15000US060590421082,517,438,57,460,11336
15000US060590421083,1023,873,124,899,11337
15000US060590421084,1444,1055,362,1082,11338
15000US060590421085,685,363,164,521,11339
15000US060590421091,1862,1146,487,1375,11340
15000US060590421092,1219,1142,57,1162,11341
15000US060590421093,953,564,179,774,11342
15000US060590421094,1042,695,139,903,11343
15000US060590421111,1057,779,149,908,11344
15000US060590421112,1339,1197,93,1246,11345
15000US060590421113,867,803,34,833,11346
15000US060590421114,2816,2328,325,2491,11347
15000US060590421121,2704,1926,336,2368,11348
15000US060590421122,1535,963,301,1234,11349
15000US060590421123,2190,1834,194,1996,11350
15000US060590421131,962,780,135,827,11351
15000US060590421132,1149,1084,57,1092,11352
15000US060590421133,1052,752,270,782,11353
15000US060590421134,948,779,147,801,11354
15000US060590421141,1755,1074,633,1122,11355
15000US060590421142,1058,960,22,1036,11356
15000US060590421143,1446,1205,128,1318,11357
15000US060590422011,744,551,172,572,11358
15000US060590422012,489,438,51,438,11359
15000US060590422013,2633,1509,1001,1632,11360
15000US060590422014,743,630,62,681,11361
15000US060590422015,711,637,29,682,11362
15000US060590422031,1757,1484,105,1652,11363
15000US060590422032,971,760,137,834,11364
15000US060590422033,1078,789,229,849,11365
15000US060590422034,877,631,163,714,11366
15000US060590422035,960,715,156,804,11367
15000US060590422036,1675,1546,59,1616,11368
15000US060590422051,1805,1436,318,1487,11369
15000US060590422052,3102,1832,1064,2038,11370
15000US060590422053,1233,962,169,1064,11371
15000US060590422054,1035,764,32,1003,11372
15000US060590422061,1219,852,323,896,11373
15000US060590422062,1950,1533,294,1656,11374
15000US060590423051,1322,1096,115,1207,11375
15000US060590423052,1129,966,104,1025,11376
15000US060590423053,983,878,52,931,11377
15000US060590423071,2344,1421,547,1797,11378
15000US060590423072,1376,795,189,1187,11379
15000US060590423073,1018,519,342,676,11380
15000US060590423074,887,575,17,870,11381
15000US060590423075,1259,582,397,862,11382
15000US060590423101,870,572,245,625,11383
15000US060590423102,901,723,73,828,11384
15000US060590423103,1831,1533,203,1628,11385
15000US060590423104,2607,662,1945,662,11386
15000US060590423105,1828,1077,716,1112,11387
15000US060590423106,894,620,173,721,11388
15000US060590423111,1584,749,677,907,11389
15000US060590423112,807,674,113,694,11390
15000US060590423113,1256,957,177,1079,11391
15000US060590423114,2048,1749,196,1852,11392
15000US060590423121,2409,1082,1306,1103,11393
15000US060590423122,1518,1028,247,1271,11394
15000US060590423123,3636,146,3490,146,11395
15000US060590423124,2165,83,1665,500,11396
15000US060590423131,955,819,136,819,11397
15000US060590423132,1369,896,438,931,11398
15000US060590423133,2210,1247,840,1370,11399
15000US060590423134,1286,1020,175,1111,11400
15000US060590423135,1831,1234,584,1247,11401
15000US060590423151,918,733,159,759,11402
15000US060590423152,1193,625,506,687,11403
15000US060590423153,1200,941,134,1066,11404
15000US060590423154,1256,979,172,1084,11405
15000US060590423155,1343,901,424,919,11406
15000US060590423171,783,666,34,749,11407
15000US060590423172,910,805,35,875,11408
15000US060590423173,1558,1313,133,1425,11409
15000US060590423191,2275,1705,392,1883,11410
15000US060590423192,948,623,224,724,11411
15000US060590423201,2548,1140,681,1867,11412
15000US060590423202,476,284,73,403,11413
15000US060590423203,1021,801,69,952,11414
15000US060590423204,1697,861,503,1194,11415
15000US060590423231,1233,1182,23,1210,11416
15000US060590423232,1210,908,154,1056,11417
15000US060590423233,1149,1073,33,1116,11418
15000US060590423234,935,835,0,935,11419
15000US060590423241,1062,897,120,942,11420
15000US060590423242,993,945,48,945,11421
15000US060590423243,1228,1032,66,1162,11422
15000US060590423244,1378,1091,172,1206,11423
15000US060590423251,1940,1505,117,1823,11424
15000US060590423252,1802,1301,229,1573,11425
15000US060590423261,1951,947,640,1311,11426
15000US060590423262,2887,2091,205,2682,11427
15000US060590423271,2240,1532,412,1828,11428
15000US060590423272,646,347,152,494,11429
15000US060590423273,1808,1376,98,1710,11430
15000US060590423281,1502,1232,133,1369,11431
15000US060590423282,861,669,102,759,11432
15000US060590423291,1319,803,313,1006,11433
15000US060590423292,1266,970,158,1108,11434
15000US060590423293,1455,1035,94,1361,11435
15000US060590423301,2362,1070,466,1896,11436
15000US060590423302,620,321,299,321,11437
15000US060590423303,3614,1339,1602,2012,11438
15000US060590423311,2303,1670,200,2103,11439
15000US060590423312,2056,718,1181,875,11440
15000US060590423313,1362,1045,259,1103,11441
15000US060590423321,1131,963,102,1029,11442
15000US060590423322,1731,1056,123,1608,11443
15000US060590423323,2361,1953,248,2113,11444
15000US060590423331,1640,1325,56,1584,11445
15000US060590423332,2207,1437,88,2119,11446
15000US060590423341,1256,579,270,986,11447
15000US060590423342,1028,479,314,714,11448
15000US060590423343,1673,1077,261,1412,11449
15000US060590423344,1104,853,156,948,11450
15000US060590423351,1259,989,195,1064,11451
15000US060590423352,5224,3410,443,4781,11452
15000US060590423361,3368,2645,177,3191,11453
15000US060590423362,1312,1066,141,1171,11454
15000US060590423371,1100,757,143,957,11455
15000US060590423372,1425,955,124,1301,11456
15000US060590423373,1060,951,15,1045,11457
15000US060590423381,2690,2227,248,2442,11458
15000US060590423382,1969,1501,242,1727,11459
15000US060590423391,957,747,55,902,11460
15000US060590423392,1406,917,414,992,11461
15000US060590423393,1260,847,374,886,11462
15000US060590524041,895,266,285,610,11463
15000US060590524081,1336,889,204,1132,11464
15000US060590524082,1882,1288,190,1692,11465
15000US060590524083,1833,1502,124,1709,11466
15000US060590524084,1267,972,88,1179,11467
15000US060590524101,1409,737,263,1146,11468
15000US060590524102,679,640,39,640,11469
15000US060590524103,2219,716,830,1389,11470
15000US060590524104,1137,918,115,1022,11471
15000US060590524111,2197,753,1133,1064,11472
15000US060590524112,1723,721,583,1140,11473
15000US060590524113,1407,786,282,1125,11474
15000US060590524151,2101,1471,107,1994,11475
15000US060590524152,2162,1479,351,1811,11476
15000US060590524161,938,267,506,432,11477
15000US060590524162,2081,479,1168,913,11478
15000US060590524163,1306,1012,155,1151,11479
15000US060590524171,5204,1744,393,4811,11480
15000US060590524172,746,633,54,692,11481
15000US060590524173,3059,967,404,2655,11482
15000US060590524174,1205,404,120,1085,11483
15000US060590524181,1728,603,110,1618,11484
15000US060590524182,4784,1506,358,4426,11485
15000US060590524183,6124,1205,448,5676,11486
15000US060590524184,5072,2159,438,4634,11487
15000US060590524191,1632,687,168,1464,11488
15000US060590524192,1892,985,50,1842,11489
15000US060590524201,4345,1046,290,4055,11490
15000US060590524202,7005,2547,491,6514,11491
15000US060590524203,7499,2454,238,7261,11492
15000US060590524204,3878,1201,85,3793,11493
15000US060590524211,1961,924,219,1742,11494
15000US060590524212,1065,646,13,1052,11495
15000US060590524213,1252,531,134,1118,11496
15000US060590524214,1058,425,80,978,11497
15000US060590524221,1678,1214,263,1415,11498
15000US060590524222,1836,592,334,1502,11499
15000US060590524223,1075,794,89,986,11500
15000US060590524231,1512,1234,95,1417,11501
15000US060590524232,2792,1104,884,1908,11502
15000US060590524233,1767,756,476,1291,11503
15000US060590524241,1780,945,471,1309,11504
15000US060590524242,2174,1166,335,1839,11505
15000US060590524243,1211,687,242,969,11506
15000US060590524251,1587,1092,275,1312,11507
15000US060590524252,771,578,97,674,11508
15000US060590524253,1230,910,258,972,11509
15000US060590524254,2424,1152,665,1759,11510
15000US060590524261,1449,1066,147,1302,11511
15000US060590524262,8796,3515,630,8166,11512
15000US060590524263,1712,1234,95,1617,11513
15000US060590524271,2455,1470,309,2146,11514
15000US060590524272,2970,1577,332,2638,11515
15000US060590524281,1046,800,0,1046,11516
15000US060590524282,866,639,170,696,11517
15000US060590524283,1314,904,358,956,11518
15000US060590524284,2265,1534,208,2057,11519
15000US060590524285,1029,472,116,913,11520
15000US060590525021,1292,648,321,971,11521
15000US060590525022,1566,943,136,1430,11522
15000US060590525023,2321,853,887,1434,11523
15000US060590525024,1092,639,234,858,11524
15000US060590525051,735,198,95,640,11525
15000US060590525052,1900,804,427,1473,11526
15000US060590525053,1008,402,249,759,11527
15000US060590525054,1556,857,141,1415,11528
15000US060590525061,881,567,135,746,11529
15000US060590525062,1584,761,155,1429,11530
15000US060590525111,1375,869,0,1375,11531
15000US060590525112,493,317,26,467,11532
15000US060590525113,714,399,30,684,11533
15000US060590525114,1330,663,185,1145,11534
15000US060590525115,882,443,56,826,11535
15000US060590525116,1146,697,29,1117,11536
15000US060590525131,964,308,131,833,11537
15000US060590525132,700,295,78,622,11538
15000US060590525133,1073,749,68,1005,11539
15000US060590525134,915,614,34,881,11540
15000US060590525135,1089,808,34,1055,11541
15000US060590525136,1103,743,92,1011,11542
15000US060590525141,1616,864,187,1429,11543
15000US060590525142,1769,1046,213,1556,11544
15000US060590525143,1207,667,109,1098,11545
15000US060590525144,1151,587,133,1018,11546
15000US060590525151,2249,1119,140,2109,11547
15000US060590525152,1651,295,300,1351,11548
15000US060590525153,2398,731,460,1938,11549
15000US060590525154,1813,856,22,1791,11550
15000US060590525155,1242,223,81,1161,11551
15000US060590525171,2503,1249,150,2353,11552
15000US060590525172,6830,3341,449,6381,11553
15000US060590525173,2755,680,29,2726,11554
15000US060590525181,5223,3171,437,4786,11555
15000US060590525191,1036,597,60,976,11556
15000US060590525192,1105,680,80,1025,11557
15000US060590525193,1001,623,56,945,11558
15000US060590525194,1265,753,91,1174,11559
15000US060590525201,1425,907,88,1337,11560
15000US060590525202,1424,909,126,1298,11561
15000US060590525203,703,333,16,687,11562
15000US060590525211,1829,1088,151,1678,11563
15000US060590525212,1251,509,259,992,11564
15000US060590525213,1090,276,67,1023,11565
15000US060590525214,1169,176,447,722,11566
15000US060590525221,1243,421,127,1116,11567
15000US060590525222,1352,654,44,1308,11568
15000US060590525223,1722,537,201,1521,11569
15000US060590525231,943,548,207,736,11570
15000US060590525232,769,329,5,764,11571
15000US060590525233,1354,567,153,1201,11572
15000US060590525234,1033,414,65,968,11573
15000US060590525241,891,328,65,826,11574
15000US060590525242,1704,626,738,966,11575
15000US060590525243,1610,476,199,1411,11576
15000US060590525244,2624,557,1233,1391,11577
15000US060590525245,2214,881,739,1475,11578
15000US060590525251,3939,977,330,3609,11579
15000US060590525252,868,547,0,868,11580
15000US060590525253,966,448,16,950,11581
15000US060590525254,1936,390,121,1815,11582
15000US060590525255,1855,782,402,1453,11583
15000US060590525256,1232,238,37,1195,11584
15000US060590525257,1969,688,26,1943,11585
15000US060590525258,3454,512,536,2918,11586
15000US060590525259,715,446,57,658,11587
15000US060590525261,1670,606,387,1283,11588
15000US060590525262,2928,1168,311,2617,11589
15000US060590525271,3458,1365,70,3388,11590
15000US060590525272,3396,1462,231,3165,11591
15000US060590525273,1211,300,112,1099,11592
15000US060590525274,1229,318,196,1033,11593
15000US060590525281,575,274,108,467,11594
15000US060590525282,1186,497,168,1018,11595
15000US060590525283,1478,565,471,1007,11596
15000US060590525284,751,126,249,502,11597
15000US060590626041,810,751,0,810,11598
15000US060590626042,9100,4675,972,8128,11599
15000US060590626043,1887,1646,125,1762,11600
15000US060590626044,2810,1528,42,2768,11601
15000US060590626045,964,964,0,964,11602
15000US060590626051,496,425,27,469,11603
15000US060590626052,800,722,27,773,11604
15000US060590626053,416,379,37,379,11605
15000US060590626054,1327,1042,157,1170,11606
15000US060590626101,842,589,22,820,11607
15000US060590626102,7790,3910,868,6922,11608
15000US060590626111,616,225,0,616,11609
15000US060590626112,2132,416,226,1906,11610
15000US060590626113,1784,1017,271,1513,11611
15000US060590626121,1979,1325,85,1894,11612
15000US060590626122,995,672,59,936,11613
15000US060590626123,1519,837,11,1508,11614
15000US060590626124,505,417,17,488,11615
15000US060590626125,1955,990,61,1894,11616
15000US060590626126,1483,1097,121,1362,11617
15000US060590626141,6923,2566,1554,5369,11618
15000US060590626142,2388,1198,341,2047,11619
15000US060590626143,7631,2539,1804,5827,11620
15000US060590626191,1021,857,80,941,11621
15000US060590626192,918,706,174,744,11622
15000US060590626193,882,831,0,882,11623
15000US060590626194,1143,984,106,1037,11624
15000US060590626201,1098,1012,39,1059,11625
15000US060590626202,1874,1312,216,1658,11626
15000US060590626203,767,713,0,767,11627
15000US060590626204,1433,1290,19,1414,11628
15000US060590626211,1637,1048,376,1261,11629
15000US060590626212,1830,1044,399,1431,11630
15000US060590626213,4139,2340,315,3824,11631
15000US060590626221,435,373,14,421,11632
15000US060590626222,747,631,14,733,11633
15000US060590626223,1079,852,54,1025,11634
15000US060590626224,421,332,74,347,11635
15000US060590626225,1264,793,81,1183,11636
15000US060590626251,651,494,31,620,11637
15000US060590626252,897,752,82,815,11638
15000US060590626253,1247,703,269,978,11639
15000US060590626254,1589,70,1466,123,11640
15000US060590626261,1727,651,238,1489,11641
15000US060590626262,1506,423,290,1216,11642
15000US060590626271,1818,805,273,1545,11643
15000US060590626272,966,244,133,833,11644
15000US060590626273,803,303,84,719,11645
15000US060590626281,1241,458,128,1113,11646
15000US060590626282,2418,1134,285,2133,11647
15000US060590626291,2005,1292,96,1909,11648
15000US060590626292,745,429,5,740,11649
15000US060590626301,1937,1169,90,1847,11650
15000US060590626311,877,509,52,825,11651
15000US060590626312,575,381,10,565,11652
15000US060590626313,1011,579,26,985,11653
15000US060590626314,673,539,29,644,11654
15000US060590626321,965,836,86,879,11655
15000US060590626322,643,536,73,570,11656
15000US060590626323,846,666,33,813,11657
15000US060590626324,1214,1065,55,1159,11658
15000US060590626331,3544,2239,451,3093,11659
15000US060590626332,3079,2148,201,2878,11660
15000US060590626341,854,459,163,691,11661
15000US060590626342,2590,1567,346,2244,11662
15000US060590626343,1273,745,122,1151,11663
15000US060590626344,834,637,54,780,11664
15000US060590626351,1130,809,200,930,11665
15000US060590626352,1790,1140,245,1545,11666
15000US060590626353,1388,793,270,1118,11667
15000US060590626361,1464,798,202,1262,11668
15000US060590626362,1246,707,252,994,11669
15000US060590626363,1210,589,300,910,11670
15000US060590626371,1914,1024,451,1463,11671
15000US060590626372,1485,979,242,1243,11672
15000US060590626373,1008,710,148,860,11673
15000US060590626381,1128,746,137,991,11674
15000US060590626382,2840,1317,572,2268,11675
15000US060590626383,2505,1650,413,2092,11676
15000US060590626391,1465,1184,66,1399,11677
15000US060590626392,2664,1702,146,2518,11678
15000US060590626393,2075,1206,335,1740,11679
15000US060590626394,1709,1156,176,1533,11680
15000US060590626401,2278,1115,487,1791,11681
15000US060590626402,1471,1161,191,1280,11682
15000US060590626411,2971,1587,665,2306,11683
15000US060590626412,1421,673,548,873,11684
15000US060590626413,831,659,60,771,11685
15000US060590626421,610,495,0,610,11686
15000US060590626422,995,778,143,852,11687
15000US060590626423,1041,935,0,1041,11688
15000US060590626431,1320,729,0,1320,11689
15000US060590626432,1510,1253,81,1429,11690
15000US060590626433,1051,670,0,1051,11691
15000US060590626434,869,665,2,867,11692
15000US060590626435,1264,909,118,1146,11693
15000US060590626436,864,589,31,833,11694
15000US060590626441,2199,2037,0,2199,11695
15000US060590626442,2159,1889,211,1948,11696
15000US060590626443,3302,2447,239,3063,11697
15000US060590626444,1279,971,239,1040,11698
15000US060590626451,2171,1878,58,2113,11699
15000US060590626452,860,592,114,746,11700
15000US060590626453,975,706,86,889,11701
15000US060590626454,959,712,125,834,11702
15000US060590626455,1716,1172,115,1601,11703
15000US060590626461,569,413,33,536,11704
15000US060590626462,926,594,13,913,11705
15000US060590626463,1533,1194,56,1477,11706
15000US060590626464,702,592,15,687,11707
15000US060590626471,2239,823,626,1613,11708
15000US060590626472,484,376,33,451,11709
15000US060590626473,792,438,185,607,11710
15000US060590626474,911,724,0,911,11711
15000US060590626481,505,438,16,489,11712
15000US060590626482,875,663,27,848,11713
15000US060590626483,1253,1049,47,1206,11714
15000US060590626491,1290,1031,47,1243,11715
15000US060590626492,1311,867,287,1024,11716
15000US060590626493,605,454,61,544,11717
15000US060590627011,1775,1498,154,1621,11718
15000US060590627012,877,728,100,777,11719
15000US060590627021,896,677,204,692,11720
15000US060590627022,849,798,51,798,11721
15000US060590627023,1204,1009,112,1092,11722
15000US060590627024,626,407,118,508,11723
15000US060590627025,986,898,45,941,11724
15000US060590628001,801,694,107,694,11725
15000US060590628002,1290,1023,162,1128,11726
15000US060590628003,1061,930,33,1028,11727
15000US060590628004,913,897,0,913,11728
15000US060590629001,833,755,37,796,11729
15000US060590629002,686,615,40,646,11730
15000US060590630041,1792,1545,105,1687,11731
15000US060590630042,1867,1446,144,1723,11732
15000US060590630043,1103,963,55,1048,11733
15000US060590630044,1773,1567,143,1630,11734
15000US060590630051,698,666,24,674,11735
15000US060590630052,616,499,11,605,11736
15000US060590630061,1172,1101,52,1120,11737
15000US060590630062,1691,1592,80,1611,11738
15000US060590630071,1190,908,118,1072,11739
15000US060590630072,2287,1774,53,2234,11740
15000US060590630073,1893,1269,216,1677,11741
15000US060590630074,885,865,20,865,11742
15000US060590630081,830,722,38,792,11743
15000US060590630091,1721,1438,110,1611,11744
15000US060590630101,1050,835,57,993,11745
15000US060590630102,1809,1439,155,1654,11746
15000US060590630103,2741,2444,58,2683,11747
15000US060590630104,1776,1562,63,1713,11748
15000US060590631011,2181,1305,683,1498,11749
15000US060590631012,829,678,69,760,11750
15000US060590631021,2057,1485,394,1663,11751
15000US060590631022,1954,1326,529,1425,11752
15000US060590631023,1444,1038,314,1130,11753
15000US060590631024,1381,1185,147,1234,11754
15000US060590631031,1238,1021,174,1064,11755
15000US060590631032,1295,1041,197,1098,11756
15000US060590632011,1286,894,202,1084,11757
15000US060590632012,1157,713,324,833,11758
15000US060590632013,1494,1083,300,1194,11759
15000US060590632021,794,368,270,524,11760
15000US060590632022,912,690,108,804,11761
15000US060590632023,1268,1105,10,1258,11762
15000US060590632024,870,482,298,572,11763
15000US060590633011,1138,832,235,903,11764
15000US060590633012,1199,1034,91,1108,11765
15000US060590633013,675,485,143,532,11766
15000US060590633021,977,945,14,963,11767
15000US060590633022,856,712,95,761,11768
15000US060590633023,1347,1132,104,1243,11769
15000US060590633024,842,732,94,748,11770
15000US060590634001,866,756,61,805,11771
15000US060590634002,1151,985,13,1138,11772
15000US060590634003,1056,840,48,1008,11773
15000US060590634004,678,516,63,615,11774
15000US060590634005,1029,836,40,989,11775
15000US060590635001,1694,1193,276,1418,11776
15000US060590635002,1177,1118,7,1170,11777
15000US060590635003,870,591,251,619,11778
15000US060590635004,1123,948,67,1056,11779
15000US060590635005,767,643,46,721,11780
15000US060590635006,1257,1177,67,1190,11781
15000US060590636011,1916,1357,405,1511,11782
15000US060590636012,1566,689,769,797,11783
15000US060590636013,480,330,114,366,11784
15000US060590636031,1505,1197,151,1354,11785
15000US060590636032,1381,1235,108,1273,11786
15000US060590636033,1938,1368,148,1790,11787
15000US060590636034,1462,472,871,591,11788
15000US060590636041,1431,220,1180,251,11789
15000US060590636042,2381,1028,960,1421,11790
15000US060590636051,1473,183,1213,260,11791
15000US060590636052,2090,882,1086,1004,11792
15000US060590636053,1974,70,1845,129,11793
15000US060590637011,1062,221,793,269,11794
15000US060590637012,1428,350,1034,394,11795
15000US060590637013,1899,252,1602,297,11796
15000US060590637014,1400,141,1180,220,11797
15000US060590637021,1041,447,414,627,11798
15000US060590637022,559,353,152,407,11799
15000US060590637023,886,498,265,621,11800
15000US060590637024,2052,384,1592,460,11801
15000US060590637025,1151,463,669,482,11802
15000US060590638021,1847,851,798,1049,11803
15000US060590638022,1076,977,27,1049,11804
15000US060590638031,1090,966,31,1059,11805
15000US060590638032,1148,642,413,735,11806
15000US060590638033,1055,564,350,705,11807
15000US060590638034,1185,423,579,606,11808
15000US060590638051,1200,803,262,938,11809
15000US060590638052,1322,1163,105,1217,11810
15000US060590638061,1389,541,629,760,11811
15000US060590638062,1086,827,194,892,11812
15000US060590638063,1466,1258,89,1377,11813
15000US060590638071,2773,1693,346,2427,11814
15000US060590638072,1974,642,816,1158,11815
15000US060590638081,4125,477,3365,760,11816
15000US060590638082,1925,708,1118,807,11817
15000US060590639021,2161,1344,383,1778,11818
15000US060590639022,1679,1009,321,1358,11819
15000US060590639023,1254,508,458,796,11820
15000US060590639024,1956,663,907,1049,11821
15000US060590639031,2460,704,1190,1270,11822
15000US060590639032,1489,863,380,1109,11823
15000US060590639041,1738,1076,442,1296,11824
15000US060590639042,2011,791,801,1210,11825
15000US060590639043,1186,95,937,249,11826
15000US060590639051,1690,1199,248,1442,11827
15000US060590639052,1256,719,343,913,11828
15000US060590639053,1671,1047,383,1288,11829
15000US060590639061,2059,893,995,1064,11830
15000US060590639062,1445,408,964,481,11831
15000US060590639063,2627,1072,979,1648,11832
15000US060590639071,3350,1276,426,2924,11833
15000US060590639072,2455,1626,226,2229,11834
15000US060590639073,2448,1164,499,1949,11835
15000US060590639081,1224,385,218,1006,11836
15000US060590639082,2143,775,721,1422,11837
15000US060590639083,828,613,194,634,11838
15000US060590639084,1393,805,229,1164,11839
15000US060590740031,4023,960,2543,1480,11840
15000US060590740041,2721,686,1818,903,11841
15000US060590740042,1522,48,1381,141,11842
15000US060590740043,1381,836,308,1073,11843
15000US060590740044,2917,326,1399,1518,11844
15000US060590740051,1652,212,1331,321,11845
15000US060590740052,2215,131,1716,499,11846
15000US060590740053,2452,213,1866,586,11847
15000US060590740054,1524,327,948,576,11848
15000US060590740061,1283,139,840,443,11849
15000US060590740062,1558,375,825,733,11850
15000US060590740063,2888,394,2195,693,11851
15000US060590741021,2019,95,1597,422,11852
15000US060590741022,1896,157,1443,453,11853
15000US060590741023,2969,75,2789,180,11854
15000US060590741031,1620,159,1390,230,11855
15000US060590741032,1046,24,1002,44,11856
15000US060590741033,2498,114,2213,285,11857
15000US060590741061,2568,403,1878,690,11858
15000US060590741062,2766,453,1926,840,11859
15000US060590741063,1450,227,824,626,11860
15000US060590741071,2212,337,1820,392,11861
15000US060590741072,2381,1367,350,2031,11862
15000US060590741073,1971,654,402,1569,11863
15000US060590741081,3247,204,2752,495,11864
15000US060590741082,1659,44,1536,123,11865
15000US060590741091,2023,18,1724,299,11866
15000US060590741092,1565,54,1406,159,11867
15000US060590741101,2687,326,1289,1398,11868
15000US060590741102,1282,250,530,752,11869
15000US060590741111,1674,334,950,724,11870
15000US060590741112,1377,131,1062,315,11871
15000US060590741113,2676,507,1562,1114,11872
15000US060590742001,1407,9,1315,92,11873
15000US060590742002,1147,37,1083,64,11874
15000US060590742003,3489,281,3108,381,11875
15000US060590742004,3257,17,3195,62,11876
15000US060590743001,2392,104,2264,128,11877
15000US060590743002,1701,56,1608,93,11878
15000US060590744031,3388,117,3222,166,11879
15000US060590744032,2650,22,2497,153,11880
15000US060590744051,1752,17,1715,37,11881
15000US060590744052,2848,280,2321,527,11882
15000US060590744053,1321,0,1290,31,11883
15000US060590744061,956,98,759,197,11884
15000US060590744062,1243,38,1165,78,11885
15000US060590744063,1154,40,1076,78,11886
15000US060590744071,2701,88,2601,100,11887
15000US060590744072,3099,530,2244,855,11888
15000US060590744081,2918,162,2460,458,11889
15000US060590744082,1287,194,937,350,11890
15000US060590744083,1801,155,1601,200,11891
15000US060590745011,1848,14,1690,158,11892
15000US060590745012,2070,0,1988,82,11893
15000US060590745013,1282,0,1282,0,11894
15000US060590745014,1984,25,1673,311,11895
15000US060590745021,3189,74,2915,274,11896
15000US060590745022,2615,9,2539,76,11897
15000US060590746011,1409,14,1395,14,11898
15000US060590746012,1247,53,1153,94,11899
15000US060590746013,1193,42,1151,42,11900
15000US060590746014,1531,205,1230,301,11901
15000US060590746015,2251,91,2062,189,11902
15000US060590746021,792,0,792,0,11903
15000US060590746022,1944,3,1941,3,11904
15000US060590746023,1381,51,1330,51,11905
15000US060590746024,2064,49,1957,107,11906
15000US060590746025,2044,24,2010,34,11907
15000US060590747011,3090,65,2876,214,11908
15000US060590747012,2627,63,2381,246,11909
15000US060590747013,2668,26,2352,316,11910
15000US060590747021,1967,93,1874,93,11911
15000US060590747022,2270,52,2122,148,11912
15000US060590747023,2010,62,1922,88,11913
15000US060590748011,1823,12,1770,53,11914
15000US060590748012,2006,22,1927,79,11915
15000US060590748013,2496,35,2231,265,11916
15000US060590748021,1570,4,1202,368,11917
15000US060590748022,2701,64,2411,290,11918
15000US060590748023,2908,51,2740,168,11919
15000US060590748031,4940,245,3898,1042,11920
15000US060590748032,2744,137,1918,826,11921
15000US060590748033,1094,35,595,499,11922
15000US060590748051,3762,84,3631,131,11923
15000US060590748052,1780,59,1675,105,11924
15000US060590748061,2268,17,2166,102,11925
15000US060590748062,2851,96,2548,303,11926
15000US060590749011,2111,24,2057,54,11927
15000US060590749012,1777,31,1504,273,11928
15000US060590749013,2349,0,2311,38,11929
15000US060590749014,2109,8,2057,52,11930
15000US060590749015,1995,22,1950,45,11931
15000US060590749021,2460,79,2332,128,11932
15000US060590749022,1489,98,1382,107,11933
15000US060590749023,2332,11,2321,11,11934
15000US060590750021,1692,24,1546,146,11935
15000US060590750022,2670,196,2378,292,11936
15000US060590750023,2586,0,2586,0,11937
15000US060590750024,1288,215,691,597,11938
15000US060590750031,1529,57,1459,70,11939
15000US060590750032,2932,30,2872,60,11940
15000US060590750033,2730,77,2574,156,11941
15000US060590750041,3178,70,2977,201,11942
15000US060590750042,2143,120,2015,128,11943
15000US060590751001,4499,1080,3171,1328,11944
15000US060590751002,1221,254,899,322,11945
15000US060590751003,2568,234,2267,301,11946
15000US060590751004,1921,187,1461,460,11947
15000US060590752011,3842,124,3475,367,11948
15000US060590752012,2305,41,2050,255,11949
15000US060590752021,2496,74,2224,272,11950
15000US060590752022,3230,146,2974,256,11951
15000US060590753011,3272,213,2546,726,11952
15000US060590753012,1179,652,374,805,11953
15000US060590753013,1949,402,1346,603,11954
15000US060590753021,1991,223,1711,280,11955
15000US060590753022,2605,508,1982,623,11956
15000US060590753031,1112,75,1027,85,11957
15000US060590753032,929,657,148,781,11958
15000US060590753033,1166,498,448,718,11959
15000US060590754011,1615,781,589,1026,11960
15000US060590754012,2510,901,1336,1174,11961
15000US060590754031,1139,424,580,559,11962
15000US060590754032,1539,116,1385,154,11963
15000US060590754033,2870,705,1847,1023,11964
15000US060590754034,1740,259,1026,714,11965
15000US060590754041,1426,540,564,862,11966
15000US060590754042,1255,338,520,735,11967
15000US060590754043,1405,338,920,485,11968
15000US060590754044,2479,279,2135,344,11969
15000US060590754051,1714,648,915,799,11970
15000US060590754052,1518,604,860,658,11971
15000US060590755041,2617,1567,860,1757,11972
15000US060590755042,1613,835,486,1127,11973
15000US060590755051,1587,419,837,750,11974
15000US060590755052,2128,1136,568,1560,11975
15000US060590755061,1898,909,621,1277,11976
15000US060590755062,1607,799,317,1290,11977
15000US060590755071,1928,680,833,1095,11978
15000US060590755072,1074,290,462,612,11979
15000US060590755073,2621,727,1338,1283,11980
15000US060590755121,2430,223,1484,946,11981
15000US060590755122,1744,432,697,1047,11982
15000US060590755131,3089,285,2106,983,11983
15000US060590755132,2301,440,1180,1121,11984
15000US060590755141,2136,336,1191,945,11985
15000US060590755142,1650,117,1396,254,11986
15000US060590755151,4159,2195,487,3672,11987
15000US060590755152,2481,503,916,1565,11988
15000US060590755153,6594,621,5248,1346,11989
15000US060590755154,4882,1263,340,4542,11990
15000US060590756031,1159,855,46,1113,11991
15000US060590756032,1406,1181,167,1239,11992
15000US060590756033,1396,792,555,841,11993
15000US060590756041,1533,1250,36,1497,11994
15000US060590756042,1944,1350,261,1683,11995
15000US060590756043,751,534,105,646,11996
15000US060590756044,1137,685,420,717,11997
15000US060590756045,2623,1600,204,2419,11998
15000US060590756051,758,681,19,739,11999
15000US060590756052,1813,725,147,1666,12000
15000US060590756053,813,713,40,773,12001
15000US060590756054,1088,575,326,762,12002
15000US060590756055,1012,523,158,854,12003
15000US060590756061,1634,1347,35,1599,12004
15000US060590756062,628,270,0,628,12005
15000US060590756063,1630,1013,468,1162,12006
15000US060590756064,3231,1782,151,3080,12007
15000US060590756071,755,248,0,755,12008
15000US060590756072,2210,1115,269,1941,12009
15000US060590756073,1164,513,71,1093,12010
15000US060590756074,1158,485,157,1001,12011
15000US060590756075,583,321,82,501,12012
15000US060590757011,1437,1100,145,1292,12013
15000US060590757012,3020,369,2229,791,12014
15000US060590757013,1066,251,659,407,12015
15000US060590757014,1910,1246,306,1604,12016
15000US060590757021,1150,811,195,955,12017
15000US060590757022,1059,1002,24,1035,12018
15000US060590757023,1380,1097,177,1203,12019
15000US060590757031,2306,1334,296,2010,12020
15000US060590757032,1977,1563,127,1850,12021
15000US060590758051,1519,301,1173,346,12022
15000US060590758052,1690,1382,196,1494,12023
15000US060590758053,1414,581,756,658,12024
15000US060590758061,1092,694,389,703,12025
15000US060590758062,1082,708,163,919,12026
15000US060590758063,1361,179,1162,199,12027
15000US060590758064,2315,1133,1099,1216,12028
15000US060590758065,1005,207,684,321,12029
15000US060590758071,1165,671,461,704,12030
15000US060590758072,1949,920,652,1297,12031
15000US060590758073,821,224,551,270,12032
15000US060590758081,1263,902,174,1089,12033
15000US060590758082,1996,1210,661,1335,12034
15000US060590758091,1025,673,41,984,12035
15000US060590758092,919,676,134,785,12036
15000US060590758093,952,762,65,887,12037
15000US060590758101,1383,773,122,1261,12038
15000US060590758102,1762,1192,189,1573,12039
15000US060590758111,1779,1060,430,1349,12040
15000US060590758112,1349,98,1251,98,12041
15000US060590758121,2982,241,2597,385,12042
15000US060590758122,1294,908,233,1061,12043
15000US060590758123,1250,827,385,865,12044
15000US060590758124,1155,717,205,950,12045
15000US060590758131,1943,1333,206,1737,12046
15000US060590758132,816,248,526,290,12047
15000US060590758133,1999,1305,354,1645,12048
15000US060590758141,2166,1192,292,1874,12049
15000US060590758142,780,448,88,692,12050
15000US060590758151,2324,1289,806,1518,12051
15000US060590758152,1919,556,880,1039,12052
15000US060590758153,891,630,208,683,12053
15000US060590758161,2658,697,1675,983,12054
15000US060590758162,1207,668,183,1024,12055
15000US060590759011,486,437,42,444,12056
15000US060590759012,920,770,88,832,12057
15000US060590759013,2665,1083,1405,1260,12058
15000US060590759021,1215,870,301,914,12059
15000US060590759022,2114,970,993,1121,12060
15000US060590759023,1347,904,405,942,12061
15000US060590759024,1596,676,837,759,12062
15000US060590759025,490,325,135,355,12063
15000US060590760001,797,413,279,518,12064
15000US060590760002,3056,1453,811,2245,12065
15000US060590760003,1441,377,995,446,12066
15000US060590760004,1623,451,948,675,12067
15000US060590760005,1803,433,1322,481,12068
15000US060590761011,5174,1881,2146,3028,12069
15000US060590761012,1961,722,764,1197,12070
15000US060590761013,1135,342,546,589,12071
15000US060590761014,1870,662,1110,760,12072
15000US060590761021,1302,258,795,507,12073
15000US060590761022,3449,1493,1539,1910,12074
15000US060590761023,1831,243,919,912,12075
15000US060590761024,1236,491,257,979,12076
15000US060590761031,1944,321,1309,635,12077
15000US060590761032,1843,247,1251,592,12078
15000US060590761033,2943,420,1668,1275,12079
15000US060590761034,2148,415,1165,983,12080
15000US060590762011,1369,792,211,1158,12081
15000US060590762012,543,430,113,430,12082
15000US060590762013,1416,826,552,864,12083
15000US060590762014,980,531,298,682,12084
15000US060590762015,3153,912,1127,2026,12085
15000US060590762021,1602,520,962,640,12086
15000US060590762022,1159,650,353,806,12087
15000US060590762023,2059,1305,562,1497,12088
15000US060590762024,1245,816,338,907,12089
15000US060590762041,582,336,44,538,12090
15000US060590762042,2168,303,1774,394,12091
15000US060590762043,2017,95,1635,382,12092
15000US060590762051,3140,2027,656,2484,12093
15000US060590762052,1146,728,239,907,12094
15000US060590762053,2428,687,1479,949,12095
15000US060590762054,573,341,136,437,12096
15000US060590762061,1502,598,757,745,12097
15000US060590762062,1191,576,514,677,12098
15000US060590762063,730,559,155,575,12099
15000US060590762064,1195,787,391,804,12100
15000US060590762081,2130,965,986,1144,12101
15000US060590762082,765,479,177,588,12102
15000US060590762083,1657,867,436,1221,12103
15000US060590762084,1118,469,555,563,12104
15000US060590863011,2702,316,2201,501,12105
15000US060590863012,2349,521,1396,953,12106
15000US060590863013,2019,298,1497,522,12107
15000US060590863031,3181,675,1360,1821,12108
15000US060590863032,1905,808,663,1242,12109
15000US060590863033,1731,560,966,765,12110
15000US060590863041,1973,669,869,1104,12111
15000US060590863042,962,292,638,324,12112
15000US060590863043,2137,608,1314,823,12113
15000US060590863051,1884,792,671,1213,12114
15000US060590863052,1256,496,455,801,12115
15000US060590863053,1254,255,749,505,12116
15000US060590863061,895,449,374,521,12117
15000US060590863062,1973,136,1549,424,12118
15000US060590863063,1748,539,565,1183,12119
15000US060590864021,3018,538,1971,1047,12120
15000US060590864022,966,248,627,339,12121
15000US060590864023,1370,218,1017,353,12122
15000US060590864041,2976,286,2324,652,12123
15000US060590864042,2756,153,2467,289,12124
15000US060590864043,1331,180,781,550,12125
15000US060590864051,1638,117,1193,445,12126
15000US060590864052,1337,110,1164,173,12127
15000US060590864053,2603,262,2282,321,12128
15000US060590864054,2108,257,1737,371,12129
15000US060590864061,1153,258,719,434,12130
15000US060590864062,1086,217,676,410,12131
15000US060590864063,830,337,406,424,12132
15000US060590864064,1210,241,850,360,12133
15000US060590864071,2192,278,1385,807,12134
15000US060590864072,2533,605,1607,926,12135
15000US060590864073,1875,585,1011,864,12136
15000US060590865011,1963,198,1657,306,12137
15000US060590865012,1689,332,1332,357,12138
15000US060590865013,1186,107,1064,122,12139
15000US060590865021,1709,45,1661,48,12140
15000US060590865022,2101,288,1624,477,12141
15000US060590865023,2545,135,2190,355,12142
15000US060590866011,2069,86,1977,92,12143
15000US060590866012,1791,115,1569,222,12144
15000US060590866013,2541,212,2286,255,12145
15000US060590866014,1880,144,1523,357,12146
15000US060590866015,1830,317,1063,767,12147
15000US060590866021,1761,353,1305,456,12148
15000US060590866022,2342,234,1890,452,12149
15000US060590866023,2640,454,1283,1357,12150
15000US060590867011,1457,95,532,925,12151
15000US060590867012,2419,229,1929,490,12152
15000US060590867013,2450,656,770,1680,12153
15000US060590867014,3078,929,1673,1405,12154
15000US060590867021,1471,278,947,524,12155
15000US060590867022,3417,398,2673,744,12156
15000US060590867023,2434,384,1626,808,12157
15000US060590868011,1272,431,521,751,12158
15000US060590868012,1097,291,309,788,12159
15000US060590868013,1172,341,621,551,12160
15000US060590868021,1813,231,1055,758,12161
15000US060590868022,2347,398,1226,1121,12162
15000US060590868023,1660,355,966,694,12163
15000US060590868031,2025,688,928,1097,12164
15000US060590868032,2806,518,1157,1649,12165
15000US060590868033,3124,708,1548,1576,12166
15000US060590868034,993,332,298,695,12167
15000US060590869011,2261,271,1301,960,12168
15000US060590869012,1380,246,622,758,12169
15000US060590869013,1775,775,509,1266,12170
15000US060590869014,889,50,666,223,12171
15000US060590869015,2193,244,998,1195,12172
15000US060590869021,1495,519,684,811,12173
15000US060590869022,1559,476,587,972,12174
15000US060590869023,2560,1008,359,2201,12175
15000US060590869031,2591,275,2084,507,12176
15000US060590869032,1653,230,1098,555,12177
15000US060590869033,1124,359,289,835,12178
15000US060590869034,1812,479,941,871,12179
15000US060590870011,928,65,439,489,12180
15000US060590870012,1723,527,637,1086,12181
15000US060590870013,2118,368,1247,871,12182
15000US060590870021,1390,396,899,491,12183
15000US060590870022,1607,580,494,1113,12184
15000US060590870023,1894,306,1069,825,12185
15000US060590870024,2990,709,1639,1351,12186
15000US060590871011,961,322,70,891,12187
15000US060590871012,2278,336,826,1452,12188
15000US060590871013,1622,371,982,640,12189
15000US060590871021,1698,196,1088,610,12190
15000US060590871022,3142,839,1579,1563,12191
15000US060590871023,1221,48,1050,171,12192
15000US060590871031,2547,930,827,1720,12193
15000US060590871032,2278,397,1059,1219,12194
15000US060590871033,1106,231,676,430,12195
15000US060590871034,1802,621,953,849,12196
15000US060590871051,1363,271,502,861,12197
15000US060590871052,2721,879,1333,1388,12198
15000US060590871061,3067,245,2751,316,12199
15000US060590871062,2044,878,919,1125,12200
15000US060590872001,2527,757,1170,1357,12201
15000US060590872002,3107,696,1997,1110,12202
15000US060590872003,860,60,741,119,12203
15000US060590872004,1460,579,782,678,12204
15000US060590873001,1330,50,1280,50,12205
15000US060590873002,3768,793,2290,1478,12206
15000US060590873003,1209,155,659,550,12207
15000US060590873004,1354,346,893,461,12208
15000US060590873005,1771,419,1155,616,12209
15000US060590874011,2577,396,1211,1366,12210
15000US060590874012,2205,561,1546,659,12211
15000US060590874031,1353,145,1092,261,12212
15000US060590874032,1891,49,1741,150,12213
15000US060590874041,3119,100,2915,204,12214
15000US060590874042,1127,75,941,186,12215
15000US060590874051,1366,60,1276,90,12216
15000US060590874052,1793,169,1600,193,12217
15000US060590874053,2951,184,2595,356,12218
15000US060590875031,1367,46,1302,65,12219
15000US060590875032,2841,1025,1247,1594,12220
15000US060590875033,865,163,423,442,12221
15000US060590875034,1534,310,1002,532,12222
15000US060590875041,975,42,904,71,12223
15000US060590875042,3079,263,2549,530,12224
15000US060590875043,1820,0,1753,67,12225
15000US060590875044,1630,129,819,811,12226
15000US060590875051,1912,517,939,973,12227
15000US060590875052,1313,36,1228,85,12228
15000US060590875053,2031,308,1191,840,12229
15000US060590876011,1621,165,1268,353,12230
15000US060590876012,1546,482,676,870,12231
15000US060590876013,2116,543,1173,943,12232
15000US060590876021,828,423,145,683,12233
15000US060590876022,1621,583,862,759,12234
15000US060590876023,2477,242,1906,571,12235
15000US060590876024,1179,426,343,836,12236
15000US060590876025,1003,216,350,653,12237
15000US060590877011,1080,361,218,862,12238
15000US060590877012,2399,838,1237,1162,12239
15000US060590877013,1307,348,381,926,12240
15000US060590877014,970,168,675,295,12241
15000US060590877031,1744,557,753,991,12242
15000US060590877032,1898,444,954,944,12243
15000US060590877033,921,165,421,500,12244
15000US060590877034,1394,394,509,885,12245
15000US060590877041,1282,297,682,600,12246
15000US060590877042,1209,312,414,795,12247
15000US060590877043,1065,502,284,781,12248
15000US060590877044,1399,558,169,1230,12249
15000US060590878011,2528,647,909,1619,12250
15000US060590878012,2137,341,1074,1063,12251
15000US060590878013,836,387,294,542,12252
15000US060590878021,2284,367,866,1418,12253
15000US060590878022,3114,554,1835,1279,12254
15000US060590878023,2546,571,1333,1213,12255
15000US060590878031,3246,316,2148,1098,12256
15000US060590878032,2083,108,1484,599,12257
15000US060590878051,3317,733,1456,1861,12258
15000US060590878052,1884,68,1523,361,12259
15000US060590878053,1787,374,990,797,12260
15000US060590878061,1694,391,931,763,12261
15000US060590878062,1238,108,743,495,12262
15000US060590878063,2808,696,1368,1440,12263
15000US060590879011,1654,207,849,805,12264
15000US060590879012,1868,340,542,1326,12265
15000US060590879021,2067,239,1255,812,12266
15000US060590879022,1965,49,1329,636,12267
15000US060590879023,2199,354,1025,1174,12268
15000US060590880011,1272,276,400,872,12269
15000US060590880012,1229,304,505,724,12270
15000US060590880013,2108,254,739,1369,12271
15000US060590880021,1807,562,436,1371,12272
15000US060590880022,2065,577,725,1340,12273
15000US060590881011,2272,612,945,1327,12274
15000US060590881041,2693,799,968,1725,12275
15000US060590881042,2167,575,899,1268,12276
15000US060590881051,2789,351,883,1906,12277
15000US060590881052,1846,480,598,1248,12278
15000US060590881061,2112,542,667,1445,12279
15000US060590881062,3248,503,1313,1935,12280
15000US060590881071,3020,403,1003,2017,12281
15000US060590881072,3146,584,594,2552,12282
15000US060590882011,1769,274,1035,734,12283
15000US060590882012,1312,473,116,1196,12284
15000US060590882013,1095,271,609,486,12285
15000US060590882021,1439,432,493,946,12286
15000US060590882022,1629,650,238,1391,12287
15000US060590882031,2539,619,742,1797,12288
15000US060590882032,2548,690,918,1630,12289
15000US060590883011,2536,433,1733,803,12290
15000US060590883012,3047,876,841,2206,12291
15000US060590883013,1420,390,490,930,12292
15000US060590883021,2573,959,601,1972,12293
15000US060590883022,2004,501,371,1633,12294
15000US060590883023,1778,353,426,1352,12295
15000US060590884011,1527,306,785,742,12296
15000US060590884012,2889,615,1244,1645,12297
15000US060590884013,1548,362,629,919,12298
15000US060590884021,2544,731,1139,1405,12299
15000US060590884022,2560,202,1827,733,12300
15000US060590884031,4258,935,2302,1956,12301
15000US060590884032,3558,505,2001,1557,12302
15000US060590885011,3317,942,1625,1692,12303
15000US060590885012,2164,102,1512,652,12304
15000US060590885013,1097,197,546,551,12305
15000US060590885021,2861,412,1196,1665,12306
15000US060590885022,1144,193,530,614,12307
15000US060590885023,1202,39,844,358,12308
15000US060590886011,1659,276,859,800,12309
15000US060590886012,1448,307,535,913,12310
15000US060590886013,2898,283,691,2207,12311
15000US060590886014,947,351,297,650,12312
15000US060590886021,2447,384,1006,1441,12313
15000US060590886022,2050,424,599,1451,12314
15000US060590887011,1182,13,781,401,12315
15000US060590887012,1693,219,690,1003,12316
15000US060590887013,2366,451,984,1382,12317
15000US060590887014,838,213,0,838,12318
15000US060590887021,3436,472,701,2735,12319
15000US060590887022,2809,202,1206,1603,12320
15000US060590888011,1620,205,371,1249,12321
15000US060590888012,934,158,334,600,12322
15000US060590888013,1229,219,284,945,12323
15000US060590888014,2293,366,425,1868,12324
15000US060590888015,1485,168,384,1101,12325
15000US060590888021,1554,227,640,914,12326
15000US060590888022,1422,422,379,1043,12327
15000US060590888023,1354,140,322,1032,12328
15000US060590888024,984,0,441,543,12329
15000US060590889011,1488,215,202,1286,12330
15000US060590889012,1468,179,331,1137,12331
15000US060590889013,2010,95,391,1619,12332
15000US060590889014,1876,351,67,1809,12333
15000US060590889021,1517,53,294,1223,12334
15000US060590889022,2252,253,818,1434,12335
15000US060590889023,856,97,265,591,12336
15000US060590889031,2654,323,398,2256,12337
15000US060590889032,3352,240,457,2895,12338
15000US060590889033,2915,337,1224,1691,12339
15000US060590889041,927,50,75,852,12340
15000US060590889042,2278,317,288,1990,12341
15000US060590889043,770,118,72,698,12342
15000US060590889044,1698,132,140,1558,12343
15000US060590889051,1515,212,197,1318,12344
15000US060590889052,3141,200,362,2779,12345
15000US060590889053,1208,211,442,766,12346
15000US060590890011,1552,123,602,950,12347
15000US060590890012,1768,109,415,1353,12348
15000US060590890013,1334,84,557,777,12349
15000US060590890014,2812,139,1350,1462,12350
15000US060590890031,1378,90,942,436,12351
15000US060590890032,2571,175,1306,1265,12352
15000US060590890041,1991,100,1229,762,12353
15000US060590890042,3779,128,2170,1609,12354
15000US060590890043,2039,225,1189,850,12355
15000US060590891021,3122,225,2184,938,12356
15000US060590891022,1509,214,977,532,12357
15000US060590891023,2407,292,1442,965,12358
15000US060590891041,1281,29,1042,239,12359
15000US060590891042,3910,126,3095,815,12360
15000US060590891043,843,46,539,304,12361
15000US060590891051,1567,0,1328,239,12362
15000US060590891052,1940,20,1857,83,12363
15000US060590891053,2895,64,2581,314,12364
15000US060590891061,2643,348,1555,1088,12365
15000US060590891062,1774,12,1481,293,12366
15000US060590891071,2879,399,1586,1293,12367
15000US060590891072,2346,132,1274,1072,12368
15000US060590992021,2648,272,1282,1366,12369
15000US060590992022,3626,150,1895,1731,12370
15000US060590992023,2119,280,1341,778,12371
15000US060590992031,3181,291,955,2226,12372
15000US060590992032,3410,567,1323,2087,12373
15000US060590992041,1286,460,158,1128,12374
15000US060590992042,987,132,18,969,12375
15000US060590992043,2175,330,366,1809,12376
15000US060590992121,1568,628,537,1031,12377
15000US060590992122,972,630,93,879,12378
15000US060590992123,1646,761,701,945,12379
15000US060590992124,1098,640,261,837,12380
15000US060590992141,1103,695,285,818,12381
15000US060590992142,916,680,13,903,12382
15000US060590992143,976,771,76,900,12383
15000US060590992144,634,577,43,591,12384
15000US060590992151,2386,1128,805,1581,12385
15000US060590992152,1920,1434,69,1851,12386
15000US060590992153,776,350,75,701,12387
15000US060590992161,772,531,120,652,12388
15000US060590992162,1656,1150,251,1405,12389
15000US060590992163,904,622,124,780,12390
15000US060590992164,911,545,217,694,12391
15000US060590992171,1223,968,122,1101,12392
15000US060590992172,1210,917,140,1070,12393
15000US060590992201,1075,748,152,923,12394
15000US060590992202,1639,1004,385,1254,12395
15000US060590992203,1386,980,172,1214,12396
15000US060590992204,1445,1245,86,1359,12397
15000US060590992221,1664,187,554,1110,12398
15000US060590992222,1489,196,40,1449,12399
15000US060590992223,1322,145,294,1028,12400
15000US060590992224,1135,619,44,1091,12401
15000US060590992231,2009,359,251,1758,12402
15000US060590992232,1236,341,61,1175,12403
15000US060590992233,1359,535,221,1138,12404
15000US060590992241,1982,803,209,1773,12405
15000US060590992242,1592,591,217,1375,12406
15000US060590992251,1625,656,78,1547,12407
15000US060590992252,1689,1030,93,1596,12408
15000US060590992261,2559,589,260,2299,12409
15000US060590992262,1910,748,408,1502,12410
15000US060590992271,837,233,127,710,12411
15000US060590992272,1329,199,986,343,12412
15000US060590992273,1520,634,330,1190,12413
15000US060590992274,2357,721,615,1742,12414
15000US060590992291,1547,676,262,1285,12415
15000US060590992292,1831,887,166,1665,12416
15000US060590992293,2832,1439,722,2110,12417
15000US060590992301,1883,1165,105,1778,12418
15000US060590992302,2760,1714,483,2277,12419
15000US060590992311,1832,1301,106,1726,12420
15000US060590992312,1646,904,103,1543,12421
15000US060590992313,2065,1308,254,1811,12422
15000US060590992321,1728,1062,122,1606,12423
15000US060590992322,1405,812,244,1161,12424
15000US060590992323,1335,847,195,1140,12425
15000US060590992324,1145,740,130,1015,12426
15000US060590992331,1551,786,127,1424,12427
15000US060590992332,1635,953,219,1416,12428
15000US060590992341,1463,536,273,1190,12429
15000US060590992342,2147,1077,228,1919,12430
15000US060590992351,902,604,235,667,12431
15000US060590992352,555,402,11,544,12432
15000US060590992353,2093,1276,636,1457,12433
15000US060590992354,927,707,72,855,12434
15000US060590992371,1992,1429,142,1850,12435
15000US060590992372,1651,1207,250,1401,12436
15000US060590992381,2056,1074,213,1843,12437
15000US060590992382,2161,1706,275,1886,12438
15000US060590992391,680,524,30,650,12439
15000US060590992392,1029,606,75,954,12440
15000US060590992393,1005,663,66,939,12441
15000US060590992394,1019,807,158,861,12442
15000US060590992401,897,538,82,815,12443
15000US060590992402,1956,1470,143,1813,12444
15000US060590992403,663,622,41,622,12445
15000US060590992404,1700,1173,490,1210,12446
15000US060590992411,2016,963,304,1712,12447
15000US060590992412,2314,996,625,1689,12448
15000US060590992421,1758,1023,236,1522,12449
15000US060590992422,1992,774,954,1038,12450
15000US060590992431,2526,1867,163,2363,12451
15000US060590992432,1775,1354,275,1500,12452
15000US060590992441,1877,1466,177,1700,12453
15000US060590992442,1601,1302,136,1465,12454
15000US060590992451,1304,962,143,1161,12455
15000US060590992452,1640,1292,159,1481,12456
15000US060590992461,1033,803,89,944,12457
15000US060590992462,1562,934,98,1464,12458
15000US060590992463,992,653,218,774,12459
15000US060590992471,1601,137,469,1132,12460
15000US060590992472,1984,114,1092,892,12461
15000US060590992481,3083,81,2323,760,12462
15000US060590992482,2361,304,1443,918,12463
15000US060590992491,2571,0,2246,325,12464
15000US060590992492,1981,17,1521,460,12465
15000US060590992501,1733,884,391,1342,12466
15000US060590992502,1248,408,444,804,12467
15000US060590992511,1898,791,533,1365,12468
15000US060590992512,2276,704,729,1547,12469
15000US060590992513,1610,427,5,1605,12470
15000US060590993051,1600,275,1268,332,12471
15000US060590993052,1299,796,209,1090,12472
15000US060590993053,2114,1731,263,1851,12473
15000US060590993054,784,360,236,548,12474
15000US060590993055,1035,598,386,649,12475
15000US060590993056,1077,632,225,852,12476
15000US060590993061,1534,894,497,1037,12477
15000US060590993062,1265,877,215,1050,12478
15000US060590993063,956,688,145,811,12479
15000US060590993064,1524,1052,223,1301,12480
15000US060590993065,930,667,134,796,12481
15000US060590993071,1367,926,186,1181,12482
15000US060590993072,1204,892,128,1076,12483
15000US060590993081,2367,1804,111,2256,12484
15000US060590993082,1707,1041,110,1597,12485
15000US060590993083,2081,1337,440,1641,12486
15000US060590993091,1285,1076,77,1208,12487
15000US060590993092,2409,1663,315,2094,12488
15000US060590993093,1787,1210,203,1584,12489
15000US060590993101,1306,773,344,962,12490
15000US060590993102,2010,1623,152,1858,12491
15000US060590993103,1134,890,72,1062,12492
15000US060590993111,1044,831,64,980,12493
15000US060590993112,1575,1280,130,1445,12494
15000US060590993113,1016,612,337,679,12495
15000US060590994021,2305,57,2180,125,12496
15000US060590994022,2987,1222,1245,1742,12497
15000US060590994023,672,256,121,551,12498
15000US060590994024,2796,190,2556,240,12499
15000US060590994041,2277,1648,313,1964,12500
15000US060590994042,2264,1638,220,2044,12501
15000US060590994051,974,496,330,644,12502
15000US060590994052,1590,1202,125,1465,12503
15000US060590994053,1907,1241,331,1576,12504
15000US060590994061,1695,1110,259,1436,12505
15000US060590994062,3062,2021,349,2713,12506
15000US060590994071,2464,1429,410,2054,12507
15000US060590994081,1112,838,139,973,12508
15000US060590994082,2530,1583,395,2135,12509
15000US060590994083,780,616,34,746,12510
15000US060590994101,1203,785,301,902,12511
15000US060590994102,753,602,7,746,12512
15000US060590994103,2829,927,1160,1669,12513
15000US060590994111,922,575,234,688,12514
15000US060590994112,2375,1072,1052,1323,12515
15000US060590994113,1330,614,437,893,12516
15000US060590994114,878,434,278,600,12517
15000US060590994121,1950,1246,442,1508,12518
15000US060590994122,1178,728,133,1045,12519
15000US060590994123,1755,1357,166,1589,12520
15000US060590994131,685,527,61,624,12521
15000US060590994132,2250,1098,787,1463,12522
15000US060590994133,2606,1734,525,2081,12523
15000US060590994134,1771,1256,173,1598,12524
15000US060590994135,897,670,7,890,12525
15000US060590994151,1373,904,172,1201,12526
15000US060590994152,1313,1045,151,1162,12527
15000US060590994153,1173,890,100,1073,12528
15000US060590994154,1184,911,140,1044,12529
15000US060590994155,632,539,25,607,12530
15000US060590994161,1646,1075,473,1173,12531
15000US060590994162,841,431,324,517,12532
15000US060590994163,2314,1652,256,2058,12533
15000US060590994171,2678,1915,349,2329,12534
15000US060590994172,1768,1317,173,1595,12535
15000US060590995021,466,221,149,317,12536
15000US060590995041,2735,2172,319,2416,12537
15000US060590995061,987,745,135,852,12538
15000US060590995081,1985,1172,157,1828,12539
15000US060590995082,653,397,150,503,12540
15000US060590995083,994,478,430,564,12541
15000US060590995084,1103,882,18,1085,12542
15000US060590995091,854,647,49,805,12543
15000US060590995092,938,752,45,893,12544
15000US060590995093,623,452,63,560,12545
15000US060590995094,342,241,24,318,12546
15000US060590995095,576,423,38,538,12547
15000US060590995101,1806,1495,82,1724,12548
15000US060590995102,1355,984,155,1200,12549
15000US060590995103,1355,1153,49,1306,12550
15000US060590995111,600,459,72,528,12551
15000US060590995112,940,624,243,697,12552
15000US060590995113,577,507,54,523,12553
15000US060590995114,1015,787,212,803,12554
15000US060590995121,1460,1200,132,1328,12555
15000US060590995122,1114,785,173,941,12556
15000US060590995123,731,470,243,488,12557
15000US060590995131,1491,1107,137,1354,12558
15000US060590995132,811,610,114,697,12559
15000US060590995141,1407,908,105,1302,12560
15000US060590995142,1046,712,91,955,12561
15000US060590995143,1240,769,159,1081,12562
15000US060590995144,550,526,0,550,12563
15000US060590995145,492,406,10,482,12564
15000US060590996011,1895,333,843,1052,12565
15000US060590996012,2801,420,1082,1719,12566
15000US060590996013,1387,48,605,782,12567
15000US060590996014,1100,577,62,1038,12568
15000US060590996021,1435,912,229,1206,12569
15000US060590996022,1858,998,353,1505,12570
15000US060590996031,2838,1634,512,2326,12571
15000US060590996032,773,305,216,557,12572
15000US060590996033,1355,1044,145,1210,12573
15000US060590996034,1652,948,250,1402,12574
15000US060590996041,1537,1131,165,1372,12575
15000US060590996042,2484,1279,789,1695,12576
15000US060590996051,1772,947,336,1436,12577
15000US060590996052,2102,1344,365,1737,12578
15000US060590997011,3373,279,597,2776,12579
15000US060590997012,1567,370,447,1120,12580
15000US060590997013,1566,217,233,1333,12581
15000US060590997021,2230,554,408,1822,12582
15000US060590997022,2452,819,338,2114,12583
15000US060590997023,3418,358,1288,2130,12584
15000US060590997031,1052,608,95,957,12585
15000US060590997032,2802,1088,105,2697,12586
15000US060590997033,1538,534,304,1234,12587
15000US060590998011,1432,530,628,804,12588
15000US060590998012,2184,343,580,1604,12589
15000US060590998013,2229,158,952,1277,12590
15000US060590998021,1927,487,559,1368,12591
15000US060590998022,3138,386,953,2185,12592
15000US060590998031,2463,285,998,1465,12593
15000US060590998032,1241,180,226,1015,12594
15000US060590998033,1769,479,182,1587,12595
15000US060590999021,1406,592,395,1011,12596
15000US060590999022,1501,532,437,1064,12597
15000US060590999023,1819,702,461,1358,12598
15000US060590999031,1661,403,326,1335,12599
15000US060590999032,2221,101,1364,857,12600
15000US060590999033,1849,608,441,1408,12601
15000US060590999041,1410,352,356,1054,12602
15000US060590999042,1730,129,835,895,12603
15000US060590999043,1046,298,366,680,12604
15000US060590999044,1068,76,549,519,12605
15000US060590999045,1535,98,719,816,12606
15000US060590999051,1931,654,862,1069,12607
15000US060590999052,2656,903,1020,1636,12608
15000US060590999061,2141,635,724,1417,12609
15000US060590999062,1234,739,157,1077,12610
15000US060590999063,1514,893,108,1406,12611
15000US060591100011,2900,2087,364,2536,12612
15000US060591100012,1615,934,382,1233,12613
15000US060591100031,1171,523,162,1009,12614
15000US060591100032,2149,1139,506,1643,12615
15000US060591100041,1344,685,301,1043,12616
15000US060591100042,1027,721,65,962,12617
15000US060591100043,977,642,146,831,12618
15000US060591100044,1757,1241,163,1594,12619
15000US060591100051,1428,981,193,1235,12620
15000US060591100052,1653,1075,436,1217,12621
15000US060591100061,2081,1376,294,1787,12622
15000US060591100062,1105,828,120,985,12623
15000US060591100071,834,746,0,834,12624
15000US060591100072,961,645,210,751,12625
15000US060591100073,1710,1391,124,1586,12626
15000US060591100074,1375,801,355,1020,12627
15000US060591100081,2312,1559,440,1872,12628
15000US060591100082,1194,847,45,1149,12629
15000US060591100083,954,698,103,851,12630
15000US060591100101,2694,1056,507,2187,12631
15000US060591100102,1263,797,216,1047,12632
15000US060591100103,1153,499,352,801,12633
15000US060591100111,1662,760,264,1398,12634
15000US060591100112,1136,531,206,930,12635
15000US060591100121,1036,742,157,879,12636
15000US060591100122,1123,754,83,1040,12637
15000US060591100123,935,618,87,848,12638
15000US060591100124,1968,1332,362,1606,12639
15000US060591100141,810,416,111,699,12640
15000US060591100142,1585,528,779,806,12641
15000US060591100143,1422,627,474,948,12642
15000US060591100144,1319,623,330,989,12643
15000US060591100151,1272,777,284,988,12644
15000US060591100152,1828,1397,240,1588,12645
15000US060591100153,344,177,27,317,12646
15000US060591101021,1543,645,343,1200,12647
15000US060591101022,2219,702,264,1955,12648
15000US060591101023,1968,608,251,1717,12649
15000US060591101041,2358,850,420,1938,12650
15000US060591101042,1820,1102,204,1616,12651
15000US060591101043,1490,112,676,814,12652
15000US060591101061,843,343,246,597,12653
15000US060591101062,1095,458,132,963,12654
15000US060591101063,1763,807,394,1369,12655
15000US060591101081,619,229,178,441,12656
15000US060591101082,1656,850,169,1487,12657
15000US060591101083,620,234,151,469,12658
15000US060591101091,771,465,48,723,12659
15000US060591101092,1452,469,292,1160,12660
15000US060591101093,1554,566,75,1479,12661
15000US060591101094,1804,789,316,1488,12662
15000US060591101101,1150,377,130,1020,12663
15000US060591101102,2834,972,1228,1606,12664
15000US060591101103,1760,599,449,1311,12665
15000US060591101111,1723,606,376,1347,12666
15000US060591101112,1974,697,425,1549,12667
15000US060591101113,2351,502,578,1773,12668
15000US060591101131,2257,1033,328,1929,12669
15000US060591101141,1988,1130,367,1621,12670
15000US060591101142,1259,830,306,953,12671
15000US060591101143,1520,658,213,1307,12672
15000US060591101151,1098,52,180,918,12673
15000US060591101152,1105,395,118,987,12674
15000US060591101153,1350,282,227,1123,12675
15000US060591101161,1561,517,296,1265,12676
15000US060591101162,1123,440,17,1106,12677
15000US060591101163,2280,340,500,1780,12678
15000US060591101171,2262,1250,583,1679,12679
15000US060591101172,882,494,11,871,12680
15000US060591101173,1107,176,108,999,12681
15000US060591101174,2020,1058,124,1896,12682
15000US060591101181,1490,251,212,1278,12683
15000US060591101182,1124,333,84,1040,12684
15000US060591102011,2544,856,732,1812,12685
15000US060591102012,3049,721,833,2216,12686
15000US060591102013,2409,608,603,1806,12687
15000US060591102021,2798,696,874,1924,12688
15000US060591102022,1143,475,73,1070,12689
15000US060591102023,3823,1270,1579,2244,12690
15000US060591102031,2930,1552,908,2022,12691
15000US060591102032,2111,1217,194,1917,12692
15000US060591103011,3919,1226,1530,2389,12693
15000US060591103012,837,196,107,730,12694
15000US060591103013,1435,385,186,1249,12695
15000US060591103014,1396,481,445,951,12696
15000US060591103021,1455,538,691,764,12697
15000US060591103022,1939,395,974,965,12698
15000US060591103023,2501,434,1137,1364,12699
15000US060591103031,1839,605,710,1129,12700
15000US060591103032,3149,1177,1175,1974,12701
15000US060591103041,1838,674,316,1522,12702
15000US060591103042,2871,1145,893,1978,12703
15000US060591104011,1726,801,559,1167,12704
15000US060591104012,1423,630,278,1145,12705
15000US060591104013,2219,554,1095,1124,12706
15000US060591104021,1406,411,592,814,12707
15000US060591104022,1570,267,533,1037,12708
15000US060591104023,2746,475,1899,847,12709
15000US060591105001,2528,443,1430,1098,12710
15000US060591105002,2909,313,2098,811,12711
15000US060591105003,2237,249,1349,888,12712
15000US060591105004,943,161,242,701,12713
15000US060591106031,1609,187,1076,533,12714
15000US060591106032,1392,195,840,552,12715
15000US060591106033,3018,521,1756,1262,12716
15000US060591106034,1584,348,1157,427,12717
15000US060591106035,1698,54,1180,518,12718
15000US060591106041,2167,228,22,2145,12719
15000US060591106042,1406,632,214,1192,12720
15000US060591106043,2822,540,1030,1792,12721
15000US060591106044,1236,779,31,1205,12722
15000US060591106051,882,135,70,812,12723
15000US060591106052,1708,448,260,1448,12724
15000US060591106053,1610,161,319,1291,12725
15000US060591106054,1109,109,13,1096,12726
15000US060591106055,1560,158,120,1440,12727
15000US060591106061,2655,276,1703,952,12728
15000US060591106062,2077,77,1212,865,12729
15000US060591106071,789,225,307,482,12730
15000US060591106072,1700,336,469,1231,12731
15000US060591106073,1744,284,430,1314,12732
15000US060599800001,25,0,18,7,12733
15000US060599901000,0,0,0,0,12734
15000US060610201041,266,255,11,255,12735
15000US060610201042,399,357,37,362,12736
15000US060610201043,360,323,14,346,12737
15000US060610201051,365,338,0,365,12738
15000US060610201052,545,446,22,523,12739
15000US060610201061,777,391,386,391,12740
15000US060610201062,772,704,68,704,12741
15000US060610201071,1094,588,454,640,12742
15000US060610201072,1333,1026,283,1050,12743
15000US060610201073,547,13,519,28,12744
15000US060610202001,2918,2533,249,2669,12745
15000US060610202002,2880,2579,207,2673,12746
15000US060610202003,376,376,0,376,12747
15000US060610202004,216,169,47,169,12748
15000US060610203001,1955,1515,297,1658,12749
15000US060610203002,1654,1053,423,1231,12750
15000US060610203003,790,713,77,713,12751
15000US060610204011,1783,1587,103,1680,12752
15000US060610204012,489,428,43,446,12753
15000US060610204021,1806,1674,38,1768,12754
15000US060610204022,2030,1799,160,1870,12755
15000US060610205011,785,667,81,704,12756
15000US060610205012,897,793,15,882,12757
15000US060610205013,1242,1110,48,1194,12758
15000US060610205021,1893,1765,68,1825,12759
15000US060610205022,679,610,30,649,12760
15000US060610205023,1824,1542,52,1772,12761
15000US060610206011,1439,1191,140,1299,12762
15000US060610206012,3286,2587,206,3080,12763
15000US060610206013,2513,2135,154,2359,12764
15000US060610206021,2077,1550,303,1774,12765
15000US060610206022,900,897,0,900,12766
15000US060610206023,1186,950,156,1030,12767
15000US060610206024,3208,2510,116,3092,12768
15000US060610206025,888,870,6,882,12769
15000US060610206041,1277,945,234,1043,12770
15000US060610206042,2127,1724,207,1920,12771
15000US060610206043,1138,905,24,1114,12772
15000US060610206044,1935,1633,95,1840,12773
15000US060610206051,1688,1229,112,1576,12774
15000US060610206052,2491,2145,251,2240,12775
15000US060610206053,1957,1533,53,1904,12776
15000US060610206061,1862,1428,107,1755,12777
15000US060610206062,684,521,57,627,12778
15000US060610206063,1624,1088,99,1525,12779
15000US060610207101,1264,1012,122,1142,12780
15000US060610207102,1404,1133,87,1317,12781
15000US060610207103,1780,1546,103,1677,12782
15000US060610207111,1311,1099,148,1163,12783
15000US060610207112,1775,1276,166,1609,12784
15000US060610207113,1071,828,163,908,12785
15000US060610207121,1881,947,866,1015,12786
15000US060610207122,500,445,39,461,12787
15000US060610207123,1587,1418,88,1499,12788
15000US060610207131,2028,1344,493,1535,12789
15000US060610207132,1242,829,234,1008,12790
15000US060610207141,1986,1422,270,1716,12791
15000US060610207142,2115,1617,145,1970,12792
15000US060610207151,1876,1595,159,1717,12793
15000US060610207152,1288,1031,174,1114,12794
15000US060610207171,761,546,154,607,12795
15000US060610207172,2673,1879,291,2382,12796
15000US060610208051,2049,1445,417,1632,12797
15000US060610208052,1246,1093,70,1176,12798
15000US060610208053,1092,549,420,672,12799
15000US060610208061,1992,1387,392,1600,12800
15000US060610208062,1904,1196,646,1258,12801
15000US060610209011,1092,710,344,748,12802
15000US060610209012,1433,556,735,698,12803
15000US060610209081,2116,1020,890,1226,12804
15000US060610209082,2263,1618,422,1841,12805
15000US060610209083,1673,636,932,741,12806
15000US060610209084,1141,646,374,767,12807
15000US060610210031,1561,1088,439,1122,12808
15000US060610210032,655,411,97,558,12809
15000US060610210033,1428,1062,239,1189,12810
15000US060610210034,454,363,22,432,12811
15000US060610210035,1298,972,75,1223,12812
15000US060610210036,560,397,163,397,12813
15000US060610210341,2116,1449,165,1951,12814
15000US060610210342,1385,918,139,1246,12815
15000US060610210343,914,640,134,780,12816
15000US060610210351,1888,1476,183,1705,12817
15000US060610210352,3454,2390,488,2966,12818
15000US060610210353,2354,1609,118,2236,12819
15000US060610210371,2131,1535,208,1923,12820
15000US060610210381,1018,815,176,842,12821
15000US060610210382,2113,1783,252,1861,12822
15000US060610210383,1971,1471,177,1794,12823
15000US060610210384,2258,1551,492,1766,12824
15000US060610210391,875,755,42,833,12825
15000US060610210392,848,760,60,788,12826
15000US060610210401,886,821,57,829,12827
15000US060610210402,1301,1180,44,1257,12828
15000US060610210403,968,861,91,877,12829
15000US060610210431,1562,1144,200,1362,12830
15000US060610210432,1802,1489,155,1647,12831
15000US060610210441,2113,1137,173,1940,12832
15000US060610210442,2386,1930,217,2169,12833
15000US060610210443,1672,1245,160,1512,12834
15000US060610210451,2169,1456,558,1611,12835
15000US060610210452,989,570,309,680,12836
15000US060610210461,713,516,172,541,12837
15000US060610210462,1620,1136,326,1294,12838
15000US060610210463,2011,1483,161,1850,12839
15000US060610211031,770,458,171,599,12840
15000US060610211032,524,457,54,470,12841
15000US060610211033,1140,932,173,967,12842
15000US060610211034,1119,1016,97,1022,12843
15000US060610211061,851,729,47,804,12844
15000US060610211062,1272,1087,76,1196,12845
15000US060610211081,533,421,70,463,12846
15000US060610211082,2308,1680,463,1845,12847
15000US060610211091,2797,2088,246,2551,12848
15000US060610211092,2626,2128,198,2428,12849
15000US060610211221,2236,1819,186,2050,12850
15000US060610211222,1187,895,127,1060,12851
15000US060610211231,2526,2004,192,2334,12852
15000US060610211232,2318,1663,329,1989,12853
15000US060610211233,2681,2525,35,2646,12854
15000US060610211281,1008,775,101,907,12855
15000US060610211282,2007,1225,323,1684,12856
15000US060610211291,2082,1645,343,1739,12857
15000US060610211292,1232,683,198,1034,12858
15000US060610211301,2813,1789,551,2262,12859
15000US060610211311,1895,1399,262,1633,12860
15000US060610211312,3450,2210,268,3182,12861
15000US060610212031,3127,2688,235,2892,12862
15000US060610212032,2359,1860,212,2147,12863
15000US060610212033,1866,1691,14,1852,12864
15000US060610212041,1665,1486,133,1532,12865
15000US060610212042,1019,838,121,898,12866
15000US060610213041,1894,1329,422,1472,12867
15000US060610213042,691,626,11,680,12868
15000US060610213043,1254,1149,50,1204,12869
15000US060610213044,1305,1212,86,1219,12870
15000US060610213091,951,886,11,940,12871
15000US060610213092,1819,1224,492,1327,12872
15000US060610213093,3388,2148,415,2973,12873
15000US060610213094,5290,3304,652,4638,12874
15000US060610213221,331,287,44,287,12875
15000US060610213222,14163,8789,1797,12366,12876
15000US060610214011,929,654,250,679,12877
15000US060610214012,1382,934,400,982,12878
15000US060610214031,1708,175,1244,464,12879
15000US060610214032,1050,595,406,644,12880
15000US060610214033,755,269,470,285,12881
15000US060610214034,1778,987,678,1100,12882
15000US060610214035,1939,1356,483,1456,12883
15000US060610215011,606,528,33,573,12884
15000US060610215012,4510,2995,841,3669,12885
15000US060610215013,1293,1137,114,1179,12886
15000US060610215021,2579,2122,272,2307,12887
15000US060610215022,1055,936,61,994,12888
15000US060610216031,2689,2097,549,2140,12889
15000US060610216032,960,385,575,385,12890
15000US060610216033,978,793,138,840,12891
15000US060610216041,1803,1503,87,1716,12892
15000US060610216042,2230,1827,365,1865,12893
15000US060610218011,1639,1434,167,1472,12894
15000US060610218012,1478,1333,109,1369,12895
15000US060610218013,859,851,8,851,12896
15000US060610218014,760,631,39,721,12897
15000US060610218021,1651,1011,371,1280,12898
15000US060610218022,2721,2400,247,2474,12899
15000US060610218023,843,679,125,718,12900
15000US060610218024,1006,880,33,973,12901
15000US060610219011,1128,1032,67,1061,12902
15000US060610219012,1350,1081,139,1211,12903
15000US060610219021,1882,1711,151,1731,12904
15000US060610219022,1949,1823,56,1893,12905
15000US060610219023,654,567,76,578,12906
15000US060610220021,1296,1167,64,1232,12907
15000US060610220022,3239,2750,302,2937,12908
15000US060610220023,3047,2519,410,2637,12909
15000US060610220111,509,438,48,461,12910
15000US060610220112,1041,953,70,971,12911
15000US060610220131,550,484,26,524,12912
15000US060610220132,972,923,10,962,12913
15000US060610220133,1072,1006,45,1027,12914
15000US060610220141,257,245,12,245,12915
15000US060610220142,441,410,14,427,12916
15000US060610220143,496,467,29,467,12917
15000US060610221001,575,485,22,553,12918
15000US060610221002,137,137,0,137,12919
15000US060610222001,569,546,16,553,12920
15000US060610222002,151,119,23,128,12921
15000US060610223001,102,102,0,102,12922
15000US060610223002,363,349,2,361,12923
15000US060610224001,2016,1269,224,1792,12924
15000US060610224002,2476,1820,339,2137,12925
15000US060610225001,2485,1497,278,2207,12926
15000US060610225002,2670,1631,265,2405,12927
15000US060610226001,5084,3462,638,4446,12928
15000US060610228001,4389,2577,583,3806,12929
15000US060610229001,5492,3281,1019,4473,12930
15000US060610230001,3311,2219,408,2903,12931
15000US060610231001,1724,1281,192,1532,12932
15000US060610231002,2783,1963,253,2530,12933
15000US060610231003,3806,2453,365,3441,12934
15000US060610232001,5803,3686,697,5106,12935
15000US060610233001,2168,1534,262,1906,12936
15000US060610233002,2983,1646,705,2278,12937
15000US060610234001,4147,2993,602,3545,12938
15000US060610234002,746,469,256,490,12939
15000US060610235001,5794,3950,1087,4707,12940
15000US060610236001,2309,2045,164,2145,12941
15000US060610236002,1973,1794,107,1866,12942
15000US060610237001,1818,1642,44,1774,12943
15000US060610237002,1529,1374,97,1432,12944
15000US060610238001,3304,3020,127,3177,12945
15000US060610239001,3312,2212,652,2660,12946
15000US060619900000,0,0,0,0,12947
15000US060630001001,565,439,56,509,12948
15000US060630001002,1017,809,130,887,12949
15000US060630001003,1015,780,80,935,12950
15000US060630001004,1605,1294,94,1511,12951
15000US060630001005,511,493,18,493,12952
15000US060630001006,884,748,36,848,12953
15000US060630002011,809,731,23,786,12954
15000US060630002012,636,508,87,549,12955
15000US060630002021,392,338,54,338,12956
15000US060630002022,498,437,43,455,12957
15000US060630003001,832,554,240,592,12958
15000US060630003002,1295,1148,117,1178,12959
15000US060630003003,1087,858,141,946,12960
15000US060630003004,752,645,107,645,12961
15000US060630004001,847,659,105,742,12962
15000US060630004002,836,689,0,836,12963
15000US060630004003,1002,847,76,926,12964
15000US060630005011,631,602,19,612,12965
15000US060630005012,1569,1360,75,1494,12966
15000US060630005021,357,342,4,353,12967
15000US060630005022,581,498,9,572,12968
15000US060630005023,1033,918,64,969,12969
15000US060650301011,1281,241,841,440,12970
15000US060650301031,603,238,286,317,12971
15000US060650301032,1729,422,1215,514,12972
15000US060650301041,2685,423,1484,1201,12973
15000US060650301042,1069,118,882,187,12974
15000US060650301043,4150,565,2969,1181,12975
15000US060650302001,1475,735,495,980,12976
15000US060650302002,437,216,190,247,12977
15000US060650302003,1221,619,429,792,12978
15000US060650302004,766,490,139,627,12979
15000US060650302005,662,387,248,414,12980
15000US060650303001,1092,451,531,561,12981
15000US060650303002,932,341,416,516,12982
15000US060650303003,357,186,159,198,12983
15000US060650303004,687,276,257,430,12984
15000US060650303005,1106,320,722,384,12985
15000US060650304001,586,17,549,37,12986
15000US060650304002,1192,174,714,478,12987
15000US060650304003,1214,129,1027,187,12988
15000US060650304004,1178,72,1014,164,12989
15000US060650304005,2125,30,1995,130,12990
15000US060650305011,1438,227,871,567,12991
15000US060650305012,1300,107,1065,235,12992
15000US060650305013,1030,43,709,321,12993
15000US060650305014,779,66,407,372,12994
15000US060650305021,1210,131,1046,164,12995
15000US060650305022,1131,85,1002,129,12996
15000US060650305031,746,61,537,209,12997
15000US060650305032,1834,114,1652,182,12998
15000US060650305033,1095,72,955,140,12999
15000US060650306011,2142,1446,130,2012,13000
15000US060650306012,1045,533,438,607,13001
15000US060650306013,2532,1602,477,2055,13002
15000US060650306021,1372,990,288,1084,13003
15000US060650306022,1206,879,182,1024,13004
15000US060650306023,870,514,204,666,13005
15000US060650306031,1683,1253,231,1452,13006
15000US060650306032,793,578,186,607,13007
15000US060650306033,768,453,284,484,13008
15000US060650307001,1200,873,274,926,13009
15000US060650307002,2048,452,1361,687,13010
15000US060650307003,647,578,69,578,13011
15000US060650307004,746,513,233,513,13012
15000US060650307005,1296,624,264,1032,13013
15000US060650308001,579,538,41,538,13014
15000US060650308002,599,346,253,346,13015
15000US060650308003,2403,792,798,1605,13016
15000US060650308004,3024,988,1952,1072,13017
15000US060650308005,1794,618,680,1114,13018
15000US060650309001,1324,406,775,549,13019
15000US060650309002,2193,365,1453,740,13020
15000US060650310011,1949,841,691,1258,13021
15000US060650310012,2000,795,700,1300,13022
15000US060650310013,1923,737,1143,780,13023
15000US060650310021,1553,311,1131,422,13024
15000US060650310022,1522,222,1053,469,13025
15000US060650310023,1833,161,1582,251,13026
15000US060650311001,1957,774,665,1292,13027
15000US060650311002,674,279,356,318,13028
15000US060650311003,576,413,57,519,13029
15000US060650311004,442,120,301,141,13030
15000US060650311005,1212,761,320,892,13031
15000US060650312001,840,351,371,469,13032
15000US060650312002,592,315,203,389,13033
15000US060650312003,1654,632,934,720,13034
15000US060650312004,1933,699,1221,712,13035
15000US060650312005,1899,981,823,1076,13036
15000US060650313001,1337,31,1217,120,13037
15000US060650313002,1431,14,1399,32,13038
15000US060650314011,633,266,337,296,13039
15000US060650314012,687,434,207,480,13040
15000US060650314013,1205,294,859,346,13041
15000US060650314014,2661,853,1200,1461,13042
15000US060650314015,1886,566,1143,743,13043
15000US060650314021,2810,1314,1096,1714,13044
15000US060650314022,1112,656,352,760,13045
15000US060650314023,1268,533,592,676,13046
15000US060650314024,2398,527,1817,581,13047
15000US060650315011,889,314,442,447,13048
15000US060650315012,1917,816,606,1311,13049
15000US060650315013,1214,146,921,293,13050
15000US060650315014,1054,298,671,383,13051
15000US060650315015,1104,462,518,586,13052
15000US060650315021,2951,871,1696,1255,13053
15000US060650315022,1815,470,1257,558,13054
15000US060650315023,1899,1024,626,1273,13055
15000US060650315024,1204,237,955,249,13056
15000US060650315025,533,276,157,376,13057
15000US060650316011,2051,483,1502,549,13058
15000US060650316012,933,244,490,443,13059
15000US060650316013,2076,500,1149,927,13060
15000US060650316021,505,32,379,126,13061
15000US060650316022,2190,466,1563,627,13062
15000US060650316023,1483,201,1187,296,13063
15000US060650316024,2178,829,1162,1016,13064
15000US060650317011,1469,58,1124,345,13065
15000US060650317012,1127,750,239,888,13066
15000US060650317021,1191,446,621,570,13067
15000US060650317022,1347,733,450,897,13068
15000US060650317031,1291,325,904,387,13069
15000US060650317032,2301,1123,981,1320,13070
15000US060650317041,1543,532,667,876,13071
15000US060650317042,1685,655,720,965,13072
15000US060650317043,689,259,309,380,13073
15000US060650317044,1345,355,882,463,13074
15000US060650401011,2051,399,1509,542,13075
15000US060650401012,1413,90,1191,222,13076
15000US060650401013,775,46,594,181,13077
15000US060650401021,2802,494,2044,758,13078
15000US060650401022,1996,586,1265,731,13079
15000US060650402011,5141,956,3865,1276,13080
15000US060650402012,1384,689,514,870,13081
15000US060650402021,2189,720,1425,764,13082
15000US060650402022,1684,502,1036,648,13083
15000US060650402031,2231,162,2047,184,13084
15000US060650402032,1976,152,1757,219,13085
15000US060650402041,1785,140,1619,166,13086
15000US060650402042,2178,38,2016,162,13087
15000US060650403011,2510,126,2225,285,13088
15000US060650403012,2120,490,1557,563,13089
15000US060650403013,1763,158,1434,329,13090
15000US060650403014,1258,164,1094,164,13091
15000US060650403021,4860,1688,2100,2760,13092
15000US060650403022,1775,861,466,1309,13093
15000US060650403023,1006,419,527,479,13094
15000US060650403031,3981,593,3068,913,13095
15000US060650404021,1881,333,1539,342,13096
15000US060650404022,2580,802,1764,816,13097
15000US060650404031,2299,426,1828,471,13098
15000US060650404032,1423,362,1040,383,13099
15000US060650404033,2164,748,1366,798,13100
15000US060650404041,3372,703,1992,1380,13101
15000US060650404051,2445,991,1212,1233,13102
15000US060650404052,3444,1688,1505,1939,13103
15000US060650405011,2543,568,1905,638,13104
15000US060650405012,2623,326,2186,437,13105
15000US060650405013,2312,843,1332,980,13106
15000US060650405021,4218,633,3163,1055,13107
15000US060650405022,2211,290,1896,315,13108
15000US060650405031,2637,580,1807,830,13109
15000US060650405032,395,59,329,66,13110
15000US060650405033,1262,639,379,883,13111
15000US060650406031,2935,521,2356,579,13112
15000US060650406041,1246,615,540,706,13113
15000US060650406042,1956,997,825,1131,13114
15000US060650406043,2178,877,1258,920,13115
15000US060650406051,1327,250,1031,296,13116
15000US060650406052,1929,201,1718,211,13117
15000US060650406061,2056,311,1671,385,13118
15000US060650406062,1464,209,1255,209,13119
15000US060650406071,5811,984,3052,2759,13120
15000US060650406072,3527,1006,1771,1756,13121
15000US060650406091,6301,1047,2031,4270,13122
15000US060650406092,6323,1487,2260,4063,13123
15000US060650406111,4808,1390,1270,3538,13124
15000US060650406112,2805,286,1533,1272,13125
15000US060650406131,2531,637,1237,1294,13126
15000US060650406132,5085,1008,1415,3670,13127
15000US060650406133,5280,698,3020,2260,13128
15000US060650406151,4417,490,1796,2621,13129
15000US060650406152,860,188,377,483,13130
15000US060650406153,4322,968,1156,3166,13131
15000US060650406161,3812,591,1223,2589,13132
15000US060650406162,3647,936,1249,2398,13133
15000US060650407011,836,472,143,693,13134
15000US060650407012,717,511,163,554,13135
15000US060650407013,681,363,303,378,13136
15000US060650407021,1386,820,544,842,13137
15000US060650407022,1449,867,485,964,13138
15000US060650407031,1078,760,285,793,13139
15000US060650407032,1670,1106,496,1174,13140
15000US060650408061,3041,1648,1003,2038,13141
15000US060650408071,1257,518,588,669,13142
15000US060650408072,2121,1130,847,1274,13143
15000US060650408081,1547,595,746,801,13144
15000US060650408082,2249,267,1583,666,13145
15000US060650408083,3969,1264,1883,2086,13146
15000US060650408091,1583,325,614,969,13147
15000US060650408092,1993,506,1117,876,13148
15000US060650408121,3866,2445,1404,2462,13149
15000US060650408131,3733,2001,998,2735,13150
15000US060650408132,2910,1685,1044,1866,13151
15000US060650408141,3011,1281,912,2099,13152
15000US060650408142,1994,668,723,1271,13153
15000US060650408151,1985,503,617,1368,13154
15000US060650408152,1787,459,632,1155,13155
15000US060650408161,3052,1086,973,2079,13156
15000US060650408211,2438,907,796,1642,13157
15000US060650408212,2963,588,1465,1498,13158
15000US060650409011,2390,817,630,1760,13159
15000US060650409012,2406,286,1436,970,13160
15000US060650409013,2241,697,1156,1085,13161
15000US060650409021,1527,678,522,1005,13162
15000US060650409022,2600,839,1232,1368,13163
15000US060650409023,1821,510,984,837,13164
15000US060650409031,1059,356,606,453,13165
15000US060650409032,1788,306,1153,635,13166
15000US060650409041,1326,361,829,497,13167
15000US060650409042,2800,658,1800,1000,13168
15000US060650410011,2937,368,2301,636,13169
15000US060650410021,1568,220,1177,391,13170
15000US060650410022,1939,377,1478,461,13171
15000US060650410031,2860,783,1773,1087,13172
15000US060650410041,1573,468,856,717,13173
15000US060650410042,2703,494,1969,734,13174
15000US060650410043,795,302,330,465,13175
15000US060650411011,1299,66,1120,179,13176
15000US060650411012,2883,193,2690,193,13177
15000US060650411013,1733,105,1595,138,13178
15000US060650411021,1945,365,1362,583,13179
15000US060650411022,2217,393,1653,564,13180
15000US060650412011,1899,654,1134,765,13181
15000US060650412012,2662,491,1817,845,13182
15000US060650412021,1660,51,1595,65,13183
15000US060650412022,1775,227,1486,289,13184
15000US060650412023,1189,92,1058,131,13185
15000US060650412031,1836,112,1495,341,13186
15000US060650412032,1732,269,1407,325,13187
15000US060650413011,1924,229,1555,369,13188
15000US060650413012,1587,222,1316,271,13189
15000US060650413021,2961,161,2517,444,13190
15000US060650413022,1840,100,1634,206,13191
15000US060650414031,2137,773,1070,1067,13192
15000US060650414032,902,284,403,499,13193
15000US060650414041,2360,603,1376,984,13194
15000US060650414042,1911,447,1299,612,13195
15000US060650414051,2209,988,1096,1113,13196
15000US060650414052,2281,848,1210,1071,13197
15000US060650414061,3606,1111,1659,1947,13198
15000US060650414062,2269,515,1352,917,13199
15000US060650414071,2404,410,1669,735,13200
15000US060650414072,1338,289,949,389,13201
15000US060650414073,1757,522,972,785,13202
15000US060650414081,1636,405,925,711,13203
15000US060650414082,2403,549,1344,1059,13204
15000US060650414091,8346,3740,2113,6233,13205
15000US060650414092,4929,3044,1070,3859,13206
15000US060650414093,4127,708,2412,1715,13207
15000US060650414094,1313,397,897,416,13208
15000US060650414101,1562,30,1423,139,13209
15000US060650414102,1107,50,1050,57,13210
15000US060650414111,1578,428,1091,487,13211
15000US060650414112,1165,126,983,182,13212
15000US060650414121,3043,541,1864,1179,13213
15000US060650414122,1494,693,634,860,13214
15000US060650415001,787,14,763,24,13215
15000US060650415002,2053,349,1474,579,13216
15000US060650416001,1422,64,1347,75,13217
15000US060650416002,1812,187,1555,257,13218
15000US060650416003,390,8,322,68,13219
15000US060650416004,1779,420,1270,509,13220
15000US060650417021,1116,223,856,260,13221
15000US060650417022,2541,1087,1401,1140,13222
15000US060650417023,1521,409,931,590,13223
15000US060650417031,1607,202,1252,355,13224
15000US060650417032,1974,332,1587,387,13225
15000US060650417033,2225,435,1559,666,13226
15000US060650417041,2027,139,1704,323,13227
15000US060650417042,1836,155,1589,247,13228
15000US060650418031,4145,2071,1446,2699,13229
15000US060650418032,2981,1259,684,2297,13230
15000US060650418041,1549,711,546,1003,13231
15000US060650418042,2822,1652,849,1973,13232
15000US060650418051,1250,479,560,690,13233
15000US060650418052,1833,947,577,1256,13234
15000US060650418053,2948,870,1786,1162,13235
15000US060650418061,2335,1038,834,1501,13236
15000US060650418062,2458,1125,628,1830,13237
15000US060650418071,1418,515,809,609,13238
15000US060650418072,972,501,374,598,13239
15000US060650418081,2996,1176,1002,1994,13240
15000US060650418082,2223,892,680,1543,13241
15000US060650418083,1736,912,270,1466,13242
15000US060650418091,919,338,374,545,13243
15000US060650418092,1747,522,726,1021,13244
15000US060650418093,3334,1912,1023,2311,13245
15000US060650418101,2068,776,776,1292,13246
15000US060650418102,2000,1062,436,1564,13247
15000US060650418103,1756,1068,366,1390,13248
15000US060650418121,1319,755,373,946,13249
15000US060650418122,1800,828,676,1124,13250
15000US060650418131,2350,713,1511,839,13251
15000US060650418132,2443,1291,1013,1430,13252
15000US060650418133,2768,218,2457,311,13253
15000US060650419041,1688,759,442,1246,13254
15000US060650419042,2102,1164,751,1351,13255
15000US060650419043,1556,586,857,699,13256
15000US060650419051,3090,934,1752,1338,13257
15000US060650419061,1330,299,838,492,13258
15000US060650419062,1810,350,1442,368,13259
15000US060650419063,1805,664,977,828,13260
15000US060650419064,1432,411,755,677,13261
15000US060650419091,1264,274,990,274,13262
15000US060650419092,1123,687,255,868,13263
15000US060650419093,1224,714,434,790,13264
15000US060650419094,1900,455,1115,785,13265
15000US060650419101,3788,1275,1753,2035,13266
15000US060650419102,3276,1735,902,2374,13267
15000US060650419111,4176,1608,1077,3099,13268
15000US060650419112,2618,1123,1105,1513,13269
15000US060650419113,5108,2643,1177,3931,13270
15000US060650419121,2574,1306,459,2115,13271
15000US060650419122,1568,569,487,1081,13272
15000US060650419123,1714,1006,270,1444,13273
15000US060650419131,1507,583,691,816,13274
15000US060650419132,2138,1209,470,1668,13275
15000US060650419133,2308,871,983,1325,13276
15000US060650420031,3676,1523,1320,2356,13277
15000US060650420032,2555,1523,792,1763,13278
15000US060650420041,1435,777,639,796,13279
15000US060650420042,2008,1076,583,1425,13280
15000US060650420051,2661,1725,667,1994,13281
15000US060650420052,3041,1231,1079,1962,13282
15000US060650420071,2584,1816,597,1987,13283
15000US060650420072,1842,1351,332,1510,13284
15000US060650420081,4572,2046,1748,2824,13285
15000US060650420082,3698,1963,1167,2531,13286
15000US060650420091,3252,976,1809,1443,13287
15000US060650420092,3024,759,1677,1347,13288
15000US060650420093,2439,129,2146,293,13289
15000US060650420101,3442,546,2682,760,13290
15000US060650420102,2829,342,2219,610,13291
15000US060650420121,2590,985,1025,1565,13292
15000US060650420122,4161,1892,1025,3136,13293
15000US060650420131,5864,2605,1599,4265,13294
15000US060650420132,2483,1194,986,1497,13295
15000US060650420141,4415,1922,1728,2687,13296
15000US060650420142,1896,1074,427,1469,13297
15000US060650420143,4819,2422,1430,3389,13298
15000US060650422061,1959,712,771,1188,13299
15000US060650422062,1395,605,253,1142,13300
15000US060650422063,835,427,238,597,13301
15000US060650422064,1809,825,601,1208,13302
15000US060650422071,1702,1036,459,1243,13303
15000US060650422072,1510,935,377,1133,13304
15000US060650422081,1187,956,115,1072,13305
15000US060650422082,1542,954,407,1135,13306
15000US060650422091,3027,636,1201,1826,13307
15000US060650422092,1474,397,651,823,13308
15000US060650422101,1250,342,454,796,13309
15000US060650422102,1760,350,850,910,13310
15000US060650422103,1776,426,807,969,13311
15000US060650422121,4407,707,2435,1972,13312
15000US060650422122,2316,1073,630,1686,13313
15000US060650422131,1524,953,337,1187,13314
15000US060650422132,1463,463,269,1194,13315
15000US060650422133,1627,920,499,1128,13316
15000US060650422141,3893,1422,1619,2274,13317
15000US060650422142,2525,759,1181,1344,13318
15000US060650422171,1032,594,274,758,13319
15000US060650422172,2036,722,401,1635,13320
15000US060650422173,1548,893,478,1070,13321
15000US060650422174,1103,551,342,761,13322
15000US060650423001,94,94,0,94,13323
15000US060650423002,2540,869,1647,893,13324
15000US060650423003,2451,818,1482,969,13325
15000US060650423004,2550,326,1972,578,13326
15000US060650424011,2022,921,978,1044,13327
15000US060650424021,2734,848,1153,1581,13328
15000US060650424022,1961,584,1074,887,13329
15000US060650424031,2362,769,752,1610,13330
15000US060650424032,1947,279,1273,674,13331
15000US060650424041,2407,297,1614,793,13332
15000US060650424051,3688,618,1615,2073,13333
15000US060650424052,1672,250,1130,542,13334
15000US060650424061,2219,286,1441,778,13335
15000US060650424062,2062,508,1123,939,13336
15000US060650424071,1998,633,1177,821,13337
15000US060650424072,1232,329,698,534,13338
15000US060650424081,1660,331,1037,623,13339
15000US060650424082,1679,337,1066,613,13340
15000US060650424091,1486,329,999,487,13341
15000US060650424092,1832,329,707,1125,13342
15000US060650424101,3079,830,1242,1837,13343
15000US060650424102,2269,426,1192,1077,13344
15000US060650424111,927,355,376,551,13345
15000US060650424112,1556,299,839,717,13346
15000US060650424121,1271,622,533,738,13347
15000US060650424122,1462,686,383,1079,13348
15000US060650424123,2255,818,781,1474,13349
15000US060650425051,1476,69,1318,158,13350
15000US060650425052,2066,187,1646,420,13351
15000US060650425061,3407,578,1454,1953,13352
15000US060650425062,5987,593,2224,3763,13353
15000US060650425071,3048,512,1512,1536,13354
15000US060650425072,1365,257,743,622,13355
15000US060650425081,1980,122,1702,278,13356
15000US060650425082,1370,102,1047,323,13357
15000US060650425083,2115,154,1681,434,13358
15000US060650425091,1817,267,1223,594,13359
15000US060650425092,1606,449,999,607,13360
15000US060650425101,1642,336,1098,544,13361
15000US060650425102,2168,72,1413,755,13362
15000US060650425103,1763,157,1281,482,13363
15000US060650425111,2131,77,1714,417,13364
15000US060650425112,1383,112,933,450,13365
15000US060650425121,1538,68,1298,240,13366
15000US060650425122,1423,119,897,526,13367
15000US060650425131,1067,159,741,326,13368
15000US060650425132,901,180,613,288,13369
15000US060650425133,1154,228,619,535,13370
15000US060650425141,2089,384,1220,869,13371
15000US060650425142,1078,116,801,277,13372
15000US060650425151,2316,47,1736,580,13373
15000US060650425152,2009,113,1712,297,13374
15000US060650425161,2269,224,1660,609,13375
15000US060650425162,2260,58,1969,291,13376
15000US060650425171,1383,188,1047,336,13377
15000US060650425172,1851,389,1146,705,13378
15000US060650425181,1249,323,700,549,13379
15000US060650425182,2412,181,1708,704,13380
15000US060650425191,1531,150,989,542,13381
15000US060650425201,4736,461,3578,1158,13382
15000US060650425211,2656,555,1801,855,13383
15000US060650425212,2332,220,1499,833,13384
15000US060650426171,3513,210,2641,872,13385
15000US060650426172,2604,144,2155,449,13386
15000US060650426173,4767,325,3759,1008,13387
15000US060650426181,5081,468,3999,1082,13388
15000US060650426182,3776,683,2903,873,13389
15000US060650426191,11920,1812,7860,4060,13390
15000US060650426201,2972,365,1467,1505,13391
15000US060650426202,9526,1092,6691,2835,13392
15000US060650426211,2940,291,1679,1261,13393
15000US060650426212,3668,394,2112,1556,13394
15000US060650426221,4008,603,2010,1998,13395
15000US060650426231,3902,1116,1516,2386,13396
15000US060650426241,4318,1023,2296,2022,13397
15000US060650427061,1536,159,1118,418,13398
15000US060650427062,2386,44,2106,280,13399
15000US060650427063,2732,108,2170,562,13400
15000US060650427064,2125,201,1272,853,13401
15000US060650427081,1841,700,718,1123,13402
15000US060650427082,3103,1376,1372,1731,13403
15000US060650427091,2282,979,1121,1161,13404
15000US060650427092,1983,1357,462,1521,13405
15000US060650427111,2083,1330,600,1483,13406
15000US060650427112,1125,880,154,971,13407
15000US060650427113,1794,1304,164,1630,13408
15000US060650427141,1985,1790,114,1871,13409
15000US060650427142,1502,1260,224,1278,13410
15000US060650427151,2045,631,696,1349,13411
15000US060650427152,2737,1402,1036,1701,13412
15000US060650427153,9564,3683,3568,5996,13413
15000US060650427161,1364,1100,191,1173,13414
15000US060650427162,2640,1682,908,1732,13415
15000US060650427163,1511,1365,146,1365,13416
15000US060650427171,5498,2249,2912,2586,13417
15000US060650427191,3765,987,2264,1501,13418
15000US060650427192,2104,832,1178,926,13419
15000US060650427201,2149,884,1240,909,13420
15000US060650427202,3037,1238,1480,1557,13421
15000US060650427231,3214,1071,2047,1167,13422
15000US060650427232,3221,1493,1588,1633,13423
15000US060650427241,3755,1840,1304,2451,13424
15000US060650427261,7709,2951,3209,4500,13425
15000US060650427281,2195,895,1059,1136,13426
15000US060650427291,3310,1922,824,2486,13427
15000US060650427292,4803,2093,1717,3086,13428
15000US060650427293,2424,1532,697,1727,13429
15000US060650427301,1660,157,1503,157,13430
15000US060650427302,3990,1299,2602,1388,13431
15000US060650427311,2219,1094,999,1220,13432
15000US060650427312,4649,1232,2638,2011,13433
15000US060650427321,6113,2574,2752,3361,13434
15000US060650427331,5715,3009,1829,3886,13435
15000US060650427332,196,62,56,140,13436
15000US060650427371,2501,1131,742,1759,13437
15000US060650427381,2582,947,819,1763,13438
15000US060650427382,4575,2478,1325,3250,13439
15000US060650427391,4281,2193,1354,2927,13440
15000US060650427392,3542,1251,1281,2261,13441
15000US060650427401,1480,1213,104,1376,13442
15000US060650427402,485,384,21,464,13443
15000US060650427411,858,556,239,619,13444
15000US060650427412,1271,1064,63,1208,13445
15000US060650427421,4268,2029,1772,2496,13446
15000US060650427431,2918,1670,908,2010,13447
15000US060650427441,4176,1349,2438,1738,13448
15000US060650427451,2582,1567,726,1856,13449
15000US060650427452,2208,1079,1043,1165,13450
15000US060650428001,2086,170,1780,306,13451
15000US060650428002,3546,137,3157,389,13452
15000US060650428003,2516,273,1941,575,13453
15000US060650429011,3576,546,2762,814,13454
15000US060650429012,5138,555,3854,1284,13455
15000US060650429021,1998,867,889,1109,13456
15000US060650429022,2709,244,2389,320,13457
15000US060650429031,2779,627,1841,938,13458
15000US060650429032,3308,320,2753,555,13459
15000US060650429041,3422,260,2947,475,13460
15000US060650429042,4523,1026,3221,1302,13461
15000US060650429043,1885,24,1678,207,13462
15000US060650430011,3257,1154,1743,1514,13463
15000US060650430012,2158,262,1818,340,13464
15000US060650430031,2297,644,1439,858,13465
15000US060650430032,2959,602,2306,653,13466
15000US060650430033,1723,555,926,797,13467
15000US060650430051,2465,529,1628,837,13468
15000US060650430052,1581,400,1137,444,13469
15000US060650430053,1709,732,881,828,13470
15000US060650430061,3038,590,2289,749,13471
15000US060650430062,2717,618,1848,869,13472
15000US060650430071,4715,2782,1359,3356,13473
15000US060650430072,2211,952,864,1347,13474
15000US060650430081,3120,1281,1669,1451,13475
15000US060650430082,3312,1703,1252,2060,13476
15000US060650430091,3079,1351,1669,1410,13477
15000US060650430092,2212,653,1027,1185,13478
15000US060650430101,3692,1138,2288,1404,13479
15000US060650430102,2287,1086,991,1296,13480
15000US060650432061,1976,1229,541,1435,13481
15000US060650432062,633,383,51,582,13482
15000US060650432063,2266,1343,639,1627,13483
15000US060650432064,3232,1154,906,2326,13484
15000US060650432111,751,499,246,505,13485
15000US060650432112,1078,623,335,743,13486
15000US060650432113,1589,801,518,1071,13487
15000US060650432114,1827,586,738,1089,13488
15000US060650432161,2122,834,730,1392,13489
15000US060650432162,2002,1074,466,1536,13490
15000US060650432163,2540,1498,719,1821,13491
15000US060650432171,3396,1579,1264,2132,13492
15000US060650432181,2122,1407,532,1590,13493
15000US060650432182,1919,1190,608,1311,13494
15000US060650432183,1736,1201,439,1297,13495
15000US060650432201,2208,726,921,1287,13496
15000US060650432202,1820,1085,604,1216,13497
15000US060650432221,1924,1094,483,1441,13498
15000US060650432222,2350,1426,526,1824,13499
15000US060650432271,1107,754,263,844,13500
15000US060650432272,1979,855,355,1624,13501
15000US060650432273,4019,1565,1313,2706,13502
15000US060650432281,1737,823,386,1351,13503
15000US060650432282,2295,959,940,1355,13504
15000US060650432291,1249,972,223,1026,13505
15000US060650432292,2160,1366,548,1612,13506
15000US060650432293,1662,1466,79,1583,13507
15000US060650432351,1293,782,235,1058,13508
15000US060650432352,4350,2206,960,3390,13509
15000US060650432391,2803,1955,834,1969,13510
15000US060650432392,2696,1801,608,2088,13511
15000US060650432393,1726,1022,704,1022,13512
15000US060650432401,4876,2231,1956,2920,13513
15000US060650432402,5259,2772,1088,4171,13514
15000US060650432421,4739,2776,1169,3570,13515
15000US060650432422,4545,1962,1394,3151,13516
15000US060650432441,2397,1140,435,1962,13517
15000US060650432442,2967,1717,649,2318,13518
15000US060650432443,3067,1676,883,2184,13519
15000US060650432461,958,642,183,775,13520
15000US060650432462,4768,3159,796,3972,13521
15000US060650432471,3233,1939,707,2526,13522
15000US060650432472,7299,3008,2360,4939,13523
15000US060650432481,4800,2509,1293,3507,13524
15000US060650432501,1071,462,198,873,13525
15000US060650432502,678,399,128,550,13526
15000US060650432503,2195,750,223,1972,13527
15000US060650432504,1450,1003,266,1184,13528
15000US060650432505,3383,2078,722,2661,13529
15000US060650432521,5895,3117,694,5201,13530
15000US060650432522,2746,1444,735,2011,13531
15000US060650432541,1170,414,576,594,13532
15000US060650432542,1286,500,482,804,13533
15000US060650432543,2772,1696,767,2005,13534
15000US060650432561,1029,305,475,554,13535
15000US060650432562,1852,636,635,1217,13536
15000US060650432563,885,423,288,597,13537
15000US060650432571,3027,1609,224,2803,13538
15000US060650432572,5135,3613,792,4343,13539
15000US060650432573,1081,601,301,780,13540
15000US060650432621,3215,2121,811,2404,13541
15000US060650432622,1988,1504,331,1657,13542
15000US060650432641,1973,1096,664,1309,13543
15000US060650432642,1399,841,266,1133,13544
15000US060650432643,4570,2946,784,3786,13545
15000US060650432651,3118,1901,798,2320,13546
15000US060650432652,2735,1825,503,2232,13547
15000US060650432653,1113,724,324,789,13548
15000US060650432661,613,440,94,519,13549
15000US060650432662,4588,1716,1777,2811,13550
15000US060650432671,2538,1829,232,2306,13551
15000US060650432672,4222,2845,933,3289,13552
15000US060650432701,870,356,119,751,13553
15000US060650432702,4648,2340,1174,3474,13554
15000US060650432711,3956,2001,1902,2054,13555
15000US060650432721,1261,1220,14,1247,13556
15000US060650432722,3821,2908,627,3194,13557
15000US060650432741,2454,1161,1050,1404,13558
15000US060650432761,4015,1990,1005,3010,13559
15000US060650432781,1204,948,142,1062,13560
15000US060650432782,1530,868,418,1112,13561
15000US060650432783,1561,1094,250,1311,13562
15000US060650432784,2650,1407,764,1886,13563
15000US060650432791,2892,1823,877,2015,13564
15000US060650432792,1555,837,505,1050,13565
15000US060650432793,681,505,127,554,13566
15000US060650432911,1988,1234,492,1496,13567
15000US060650432912,1724,1334,164,1560,13568
15000US060650432913,2079,573,613,1466,13569
15000US060650432914,943,448,427,516,13570
15000US060650432915,2045,1187,410,1635,13571
15000US060650433041,1427,1114,304,1123,13572
15000US060650433042,764,574,128,636,13573
15000US060650433043,3608,2063,1076,2532,13574
15000US060650433044,1431,1218,112,1319,13575
15000US060650433061,2407,1214,801,1606,13576
15000US060650433062,2191,980,1064,1127,13577
15000US060650433071,2661,1146,867,1794,13578
15000US060650433072,2800,1466,631,2169,13579
15000US060650433073,1171,410,681,490,13580
15000US060650433081,1178,493,583,595,13581
15000US060650433082,1582,524,710,872,13582
15000US060650433091,1620,615,591,1029,13583
15000US060650433092,1412,548,647,765,13584
15000US060650433101,1578,755,597,981,13585
15000US060650433102,1879,805,897,982,13586
15000US060650433111,1124,469,649,475,13587
15000US060650433112,1236,737,378,858,13588
15000US060650433121,2121,679,1248,873,13589
15000US060650433122,2045,767,1013,1032,13590
15000US060650433131,1998,512,1190,808,13591
15000US060650433132,1666,869,618,1048,13592
15000US060650433141,1637,810,715,922,13593
15000US060650433142,2116,1082,977,1139,13594
15000US060650433151,2429,1521,708,1721,13595
15000US060650433161,892,750,64,828,13596
15000US060650433162,2981,1604,486,2495,13597
15000US060650433171,2762,909,1082,1680,13598
15000US060650433172,3533,1269,1576,1957,13599
15000US060650433173,2249,793,893,1356,13600
15000US060650434011,2528,717,1611,917,13601
15000US060650434012,1902,461,1233,669,13602
15000US060650434013,2241,543,1612,629,13603
15000US060650434031,948,284,578,370,13604
15000US060650434032,1635,520,912,723,13605
15000US060650434041,1218,1059,42,1176,13606
15000US060650434042,1634,715,790,844,13607
15000US060650434051,1074,467,488,586,13608
15000US060650434052,1170,506,528,642,13609
15000US060650434053,1752,859,540,1212,13610
15000US060650435031,1531,618,689,842,13611
15000US060650435032,2079,1051,847,1232,13612
15000US060650435041,4884,1948,2115,2769,13613
15000US060650435042,3420,1851,1111,2309,13614
15000US060650435051,1399,936,374,1025,13615
15000US060650435052,1729,1082,562,1167,13616
15000US060650435061,1692,1000,396,1296,13617
15000US060650435062,2326,840,992,1334,13618
15000US060650435063,1959,823,1058,901,13619
15000US060650435071,1652,596,927,725,13620
15000US060650435072,2927,594,1765,1162,13621
15000US060650435073,2455,859,1266,1189,13622
15000US060650435081,3197,2072,549,2648,13623
15000US060650435082,1505,734,703,802,13624
15000US060650435083,2343,737,1349,994,13625
15000US060650435091,3438,1385,1861,1577,13626
15000US060650435092,1879,1107,684,1195,13627
15000US060650435121,3741,1328,1632,2109,13628
15000US060650435122,3117,1001,1400,1717,13629
15000US060650435131,3171,1061,1783,1388,13630
15000US060650435171,4967,1382,2556,2411,13631
15000US060650435172,2672,652,1493,1179,13632
15000US060650436011,1319,267,1033,286,13633
15000US060650436012,3270,510,2214,1056,13634
15000US060650436021,1760,202,1520,240,13635
15000US060650436022,2045,374,1302,743,13636
15000US060650437011,1598,1095,414,1184,13637
15000US060650437012,2093,1187,740,1353,13638
15000US060650437021,3359,1891,1348,2011,13639
15000US060650437022,1760,958,490,1270,13640
15000US060650437031,2134,1388,524,1610,13641
15000US060650437032,868,452,318,550,13642
15000US060650438021,2199,1604,437,1762,13643
15000US060650438022,652,537,54,598,13644
15000US060650438023,2470,1292,1114,1356,13645
15000US060650438071,4190,2239,1484,2706,13646
15000US060650438072,2219,733,1267,952,13647
15000US060650438091,742,525,171,571,13648
15000US060650438092,2341,1789,372,1969,13649
15000US060650438101,936,728,70,866,13650
15000US060650438102,1465,695,556,909,13651
15000US060650438103,2604,1133,922,1682,13652
15000US060650438111,2945,2013,697,2248,13653
15000US060650438112,1531,806,614,917,13654
15000US060650438121,3681,3171,291,3390,13655
15000US060650438122,2053,1791,85,1968,13656
15000US060650438131,935,368,405,530,13657
15000US060650438132,2944,950,1716,1228,13658
15000US060650438133,1425,538,739,686,13659
15000US060650438134,634,175,149,485,13660
15000US060650438141,961,780,169,792,13661
15000US060650438181,4394,1859,1747,2647,13662
15000US060650438201,4451,1657,1590,2861,13663
15000US060650438211,3530,1086,1890,1640,13664
15000US060650438221,3185,1604,1219,1966,13665
15000US060650438231,8970,3705,3398,5572,13666
15000US060650438232,640,439,198,442,13667
15000US060650439001,2214,1060,998,1216,13668
15000US060650439002,1513,517,979,534,13669
15000US060650439003,2715,1185,1228,1487,13670
15000US060650440001,1574,349,951,623,13671
15000US060650440002,279,34,245,34,13672
15000US060650441011,2166,475,1405,761,13673
15000US060650441012,980,67,778,202,13674
15000US060650441021,3019,1140,1581,1438,13675
15000US060650441031,3044,812,1685,1359,13676
15000US060650441032,3076,1951,643,2433,13677
15000US060650441041,2884,1364,1349,1535,13678
15000US060650442001,3680,698,1648,2032,13679
15000US060650442002,2336,206,1743,593,13680
15000US060650443001,1988,594,922,1066,13681
15000US060650443002,2773,698,1398,1375,13682
15000US060650444021,2215,1476,654,1561,13683
15000US060650444022,552,399,112,440,13684
15000US060650444023,1160,791,290,870,13685
15000US060650444024,860,624,208,652,13686
15000US060650444031,716,529,179,537,13687
15000US060650444032,1027,523,421,606,13688
15000US060650444033,2045,1318,271,1774,13689
15000US060650444041,1353,1018,300,1053,13690
15000US060650444051,677,638,20,657,13691
15000US060650444052,890,828,54,836,13692
15000US060650445051,4693,639,3887,806,13693
15000US060650445052,2095,1649,446,1649,13694
15000US060650445071,2849,1048,1691,1158,13695
15000US060650445072,4148,407,3480,668,13696
15000US060650445091,4092,1486,1933,2159,13697
15000US060650445101,3505,635,1800,1705,13698
15000US060650445102,2302,520,1578,724,13699
15000US060650445151,4044,949,2531,1513,13700
15000US060650445161,2537,710,1704,833,13701
15000US060650445162,3740,993,2391,1349,13702
15000US060650445171,2322,1848,406,1916,13703
15000US060650445181,1581,960,465,1116,13704
15000US060650445182,4211,1705,2103,2108,13705
15000US060650445201,722,560,162,560,13706
15000US060650445202,833,405,352,481,13707
15000US060650445211,1196,528,446,750,13708
15000US060650445221,4401,2122,1874,2527,13709
15000US060650446021,1304,584,514,790,13710
15000US060650446022,927,790,38,889,13711
15000US060650446023,1106,581,475,631,13712
15000US060650446041,2211,1416,691,1520,13713
15000US060650446042,2454,1407,806,1648,13714
15000US060650446051,2533,985,782,1751,13715
15000US060650446052,2980,876,1539,1441,13716
15000US060650446061,892,704,137,755,13717
15000US060650446062,1636,821,637,999,13718
15000US060650447011,1599,1049,290,1309,13719
15000US060650447012,1589,797,455,1134,13720
15000US060650447021,1924,179,1684,240,13721
15000US060650448041,2981,852,1535,1446,13722
15000US060650448051,1649,1128,280,1369,13723
15000US060650448061,2151,1495,518,1633,13724
15000US060650448071,1466,977,339,1127,13725
15000US060650449041,5239,2006,2131,3108,13726
15000US060650449071,2104,231,1769,335,13727
15000US060650449072,1361,88,1244,117,13728
15000US060650449073,2061,78,1983,78,13729
15000US060650449111,3061,2254,466,2595,13730
15000US060650449112,1662,1303,277,1385,13731
15000US060650449151,3773,119,3385,388,13732
15000US060650449152,3172,247,2786,386,13733
15000US060650449161,1644,1210,241,1403,13734
15000US060650449162,1167,569,524,643,13735
15000US060650449163,2162,514,1454,708,13736
15000US060650449171,2324,2034,91,2233,13737
15000US060650449172,2118,2059,59,2059,13738
15000US060650449181,1893,1706,107,1786,13739
15000US060650449182,1242,1144,54,1188,13740
15000US060650449191,1099,895,145,954,13741
15000US060650449192,873,784,48,825,13742
15000US060650449193,1909,1765,11,1898,13743
15000US060650449194,191,144,4,187,13744
15000US060650449211,2392,1928,201,2191,13745
15000US060650449221,4892,3547,780,4112,13746
15000US060650449231,2068,556,1286,782,13747
15000US060650449232,1666,826,682,984,13748
15000US060650449241,2656,690,1804,852,13749
15000US060650449242,1959,560,1347,612,13750
15000US060650449251,886,377,463,423,13751
15000US060650449252,2679,805,1743,936,13752
15000US060650449261,3976,413,3031,945,13753
15000US060650449262,736,316,292,444,13754
15000US060650449271,3039,1742,841,2198,13755
15000US060650449272,658,641,8,650,13756
15000US060650449281,1024,955,60,964,13757
15000US060650449282,2141,1885,207,1934,13758
15000US060650449291,1546,1528,18,1528,13759
15000US060650449292,3493,1732,1344,2149,13760
15000US060650449301,3361,1599,1585,1776,13761
15000US060650449311,2482,783,1434,1048,13762
15000US060650449321,3155,1713,1110,2045,13763
15000US060650450001,1090,199,841,249,13764
15000US060650450002,1065,816,213,852,13765
15000US060650450003,1032,419,577,455,13766
15000US060650451031,901,595,215,686,13767
15000US060650451032,842,589,173,669,13768
15000US060650451033,759,681,78,681,13769
15000US060650451034,901,737,164,737,13770
15000US060650451081,2003,305,1566,437,13771
15000US060650451082,2313,1485,437,1876,13772
15000US060650451083,2499,547,1681,818,13773
15000US060650451091,1880,685,1042,838,13774
15000US060650451092,1696,949,605,1091,13775
15000US060650451101,3605,1195,2027,1578,13776
15000US060650451102,1689,631,837,852,13777
15000US060650451141,1086,955,122,964,13778
15000US060650451142,1031,973,48,983,13779
15000US060650451151,1793,1648,61,1732,13780
15000US060650451161,1435,1052,349,1086,13781
15000US060650451171,1512,1269,113,1399,13782
15000US060650451172,2424,1524,499,1925,13783
15000US060650451181,2687,1034,1312,1375,13784
15000US060650451191,1910,1075,646,1264,13785
15000US060650451192,871,423,414,457,13786
15000US060650451201,294,278,8,286,13787
15000US060650451202,2704,721,1864,840,13788
15000US060650451203,2049,1004,763,1286,13789
15000US060650451211,2614,1180,1229,1385,13790
15000US060650451212,1534,1203,207,1327,13791
15000US060650451213,2618,2041,544,2074,13792
15000US060650451221,1621,1458,79,1542,13793
15000US060650451231,725,629,14,711,13794
15000US060650451232,1379,920,359,1020,13795
15000US060650451241,1236,1051,80,1156,13796
15000US060650451251,2863,2586,276,2587,13797
15000US060650452071,2844,20,2824,20,13798
15000US060650452072,2734,560,2028,706,13799
15000US060650452091,2437,261,2007,430,13800
15000US060650452092,3237,321,2863,374,13801
15000US060650452121,1338,866,132,1206,13802
15000US060650452122,807,751,48,759,13803
15000US060650452131,4616,791,3544,1072,13804
15000US060650452132,850,428,152,698,13805
15000US060650452141,2475,1866,473,2002,13806
15000US060650452142,2938,2093,742,2196,13807
15000US060650452151,3183,2098,997,2186,13808
15000US060650452152,435,204,192,243,13809
15000US060650452153,3652,1717,1436,2216,13810
15000US060650452154,2465,1585,771,1694,13811
15000US060650452161,1913,1655,117,1796,13812
15000US060650452171,4700,912,3419,1281,13813
15000US060650452172,3540,131,3079,461,13814
15000US060650452221,137,15,27,110,13815
15000US060650452222,1078,544,349,729,13816
15000US060650452223,994,427,238,756,13817
15000US060650452241,2666,981,1516,1150,13818
15000US060650452242,2655,1341,1187,1468,13819
15000US060650452261,3830,193,3606,224,13820
15000US060650452262,3337,49,3131,206,13821
15000US060650452281,2033,1161,838,1195,13822
15000US060650452282,3614,1597,1806,1808,13823
15000US060650452331,3429,1685,1452,1977,13824
15000US060650452332,1112,784,281,831,13825
15000US060650453021,2511,95,2395,116,13826
15000US060650453022,586,35,544,42,13827
15000US060650453023,1425,79,1195,230,13828
15000US060650453031,2944,102,2634,310,13829
15000US060650453041,2206,427,1743,463,13830
15000US060650453042,4771,1564,2587,2184,13831
15000US060650453043,2877,802,1938,939,13832
15000US060650455011,2201,218,1771,430,13833
15000US060650455012,3309,247,2844,465,13834
15000US060650455021,1751,142,1504,247,13835
15000US060650455022,2263,245,2017,246,13836
15000US060650456041,2349,0,2349,0,13837
15000US060650456042,2440,2,2438,2,13838
15000US060650456043,5042,388,4654,388,13839
15000US060650456044,4286,5,4281,5,13840
15000US060650456051,3056,25,2999,57,13841
15000US060650456052,911,4,894,17,13842
15000US060650456053,1229,0,1209,20,13843
15000US060650456054,2427,1238,998,1429,13844
15000US060650456055,979,7,967,12,13845
15000US060650456061,468,297,155,313,13846
15000US060650456062,2107,1135,937,1170,13847
15000US060650456081,986,924,10,976,13848
15000US060650456082,1951,1714,77,1874,13849
15000US060650456091,2945,142,2803,142,13850
15000US060650456092,1125,52,1057,68,13851
15000US060650456093,1439,0,1439,0,13852
15000US060650457031,3480,8,3437,43,13853
15000US060650457032,2740,20,2720,20,13854
15000US060650457041,2531,0,2531,0,13855
15000US060650457051,9897,35,9862,35,13856
15000US060650457061,4104,76,4028,76,13857
15000US060650457062,1050,0,1050,0,13858
15000US060650457071,1692,10,1682,10,13859
15000US060650457072,1996,143,1832,164,13860
15000US060650457073,3000,49,2936,64,13861
15000US060650459001,747,390,319,428,13862
15000US060650459002,605,91,509,96,13863
15000US060650461011,1152,713,427,725,13864
15000US060650461012,2205,601,1081,1124,13865
15000US060650461021,1921,327,1363,558,13866
15000US060650461031,1657,779,750,907,13867
15000US060650461032,1582,522,1013,569,13868
15000US060650462001,1491,339,986,505,13869
15000US060650462002,1938,86,1603,335,13870
15000US060650464011,2080,1483,461,1619,13871
15000US060650464012,1369,574,655,714,13872
15000US060650464021,2463,934,1209,1254,13873
15000US060650464022,2239,1176,985,1254,13874
15000US060650464031,4037,1440,2204,1833,13875
15000US060650464032,1798,754,848,950,13876
15000US060650464033,1920,657,1263,657,13877
15000US060650464041,4156,2090,1233,2923,13878
15000US060650464042,2626,664,1789,837,13879
15000US060650464051,1809,836,876,933,13880
15000US060650464052,1892,713,1024,868,13881
15000US060650465001,2499,315,804,1695,13882
15000US060650465002,380,179,54,326,13883
15000US060650465003,2185,413,840,1345,13884
15000US060650465004,2405,271,495,1910,13885
15000US060650466011,3624,961,1367,2257,13886
15000US060650466021,1010,520,418,592,13887
15000US060650466022,2710,2037,557,2153,13888
15000US060650467001,1145,698,240,905,13889
15000US060650467002,1502,137,1171,331,13890
15000US060650467003,1704,9,1365,339,13891
15000US060650468001,1945,273,1086,859,13892
15000US060650468002,3285,870,1505,1780,13893
15000US060650468003,1263,217,527,736,13894
15000US060650469001,1632,586,929,703,13895
15000US060650470001,690,315,270,420,13896
15000US060650470002,793,620,106,687,13897
15000US060650472011,2038,1292,736,1302,13898
15000US060650472021,1926,1062,783,1143,13899
15000US060650479001,2856,1291,853,2003,13900
15000US060650479002,2001,1277,71,1930,13901
15000US060650479003,2863,1716,689,2174,13902
15000US060650479004,1842,924,333,1509,13903
15000US060650479005,3944,1744,1313,2631,13904
15000US060650481001,7169,3851,1973,5196,13905
15000US060650482001,2833,1157,808,2025,13906
15000US060650482002,1569,325,761,808,13907
15000US060650483001,2781,362,1113,1668,13908
15000US060650483002,4033,508,2335,1698,13909
15000US060650487001,3235,667,1084,2151,13910
15000US060650487002,1351,327,853,498,13911
15000US060650488001,2119,319,762,1357,13912
15000US060650488002,2444,274,1795,649,13913
15000US060650489011,4115,809,2683,1432,13914
15000US060650489021,5797,704,3889,1908,13915
15000US060650489022,2544,443,1637,907,13916
15000US060650490001,1135,290,502,633,13917
15000US060650490002,7173,1276,2928,4245,13918
15000US060650490003,1659,275,194,1465,13919
15000US060650491001,1721,1035,520,1201,13920
15000US060650491002,2824,1251,1402,1422,13921
15000US060650491003,983,379,576,407,13922
15000US060650494001,1918,121,1797,121,13923
15000US060650494002,1650,1566,62,1588,13924
15000US060650495001,3535,113,3326,209,13925
15000US060650495002,4037,517,3438,599,13926
15000US060650496001,2218,751,1276,942,13927
15000US060650496002,3582,1845,670,2912,13928
15000US060650496003,2370,1136,407,1963,13929
15000US060650497001,1852,1347,72,1780,13930
15000US060650497002,3106,2672,279,2827,13931
15000US060650497003,3893,2169,1286,2607,13932
15000US060650498001,2522,728,1098,1424,13933
15000US060650498002,1929,1098,746,1183,13934
15000US060650503001,2727,1294,1089,1638,13935
15000US060650503002,4988,2428,980,4008,13936
15000US060650503003,2052,864,251,1801,13937
15000US060650503004,2092,836,617,1475,13938
15000US060650504001,1811,636,697,1114,13939
15000US060650504002,896,653,191,705,13940
15000US060650504003,932,509,271,661,13941
15000US060650504004,2375,1350,574,1801,13942
15000US060650504005,4718,1978,1985,2733,13943
15000US060650505001,2259,919,772,1487,13944
15000US060650505002,3902,1218,2048,1854,13945
15000US060650505003,2195,690,800,1395,13946
15000US060650505004,1638,638,766,872,13947
15000US060650505005,4370,2260,806,3564,13948
15000US060650506001,1325,1024,254,1071,13949
15000US060650506002,1199,901,61,1138,13950
15000US060650506003,1435,529,319,1116,13951
15000US060650506004,3146,2242,614,2532,13952
15000US060650507001,2704,917,693,2011,13953
15000US060650507002,2391,574,1184,1207,13954
15000US060650507003,5051,2363,1853,3198,13955
15000US060650507004,2381,1252,677,1704,13956
15000US060650509001,2279,982,756,1523,13957
15000US060650509002,1868,777,650,1218,13958
15000US060650509003,819,331,148,671,13959
15000US060650511001,2910,297,1450,1460,13960
15000US060650511002,3627,515,1881,1746,13961
15000US060650512001,3187,1282,1479,1708,13962
15000US060650512002,727,440,180,547,13963
15000US060650513001,4850,2282,2408,2442,13964
15000US060650513002,4489,1874,1813,2676,13965
15000US060650514001,2547,2265,0,2547,13966
15000US060650514002,1227,1184,0,1227,13967
15000US060650514003,3166,2970,147,3019,13968
15000US060659401001,36,36,0,36,13969
15000US060659401002,81,76,0,81,13970
15000US060659404001,5292,73,5219,73,13971
15000US060659404002,1088,52,1009,79,13972
15000US060659405001,940,821,70,870,13973
15000US060659405002,1089,950,50,1039,13974
15000US060659406001,2001,1518,227,1774,13975
15000US060659406002,1166,1101,45,1121,13976
15000US060659407001,1085,866,121,964,13977
15000US060659407002,1477,1106,274,1203,13978
15000US060659408001,1482,1238,123,1359,13979
15000US060659408002,1201,1111,39,1162,13980
15000US060659409001,1152,954,117,1035,13981
15000US060659409002,762,666,66,696,13982
15000US060659410001,1021,892,101,920,13983
15000US060659410002,845,531,262,583,13984
15000US060659410003,945,791,62,883,13985
15000US060659410004,916,805,51,865,13986
15000US060659411001,492,461,12,480,13987
15000US060659411002,1322,1224,72,1250,13988
15000US060659412001,901,427,268,633,13989
15000US060659412002,790,688,52,738,13990
15000US060659412003,559,479,42,517,13991
15000US060659413001,1727,996,456,1271,13992
15000US060659413002,1552,1253,187,1365,13993
15000US060659414001,768,637,43,725,13994
15000US060659414002,1774,679,915,859,13995
15000US060659414003,1297,730,367,930,13996
15000US060659415001,4914,2151,1672,3242,13997
15000US060659800041,0,0,0,0,13998
15000US060659810001,6324,1115,3405,2919,13999
15000US060670001001,1972,1728,106,1866,14000
15000US060670001002,1091,910,92,999,14001
15000US060670001003,657,610,7,650,14002
15000US060670002001,827,634,45,782,14003
15000US060670002002,1006,670,278,728,14004
15000US060670002003,1064,802,138,926,14005
15000US060670002004,870,704,112,758,14006
15000US060670003001,787,657,94,693,14007
15000US060670003002,657,561,40,617,14008
15000US060670003003,1641,1148,285,1356,14009
15000US060670004001,876,567,227,649,14010
15000US060670004002,976,485,286,690,14011
15000US060670004003,1460,997,272,1188,14012
15000US060670004004,662,459,83,579,14013
15000US060670005001,1624,815,586,1038,14014
15000US060670005002,881,518,142,739,14015
15000US060670005003,725,470,108,617,14016
15000US060670006001,643,317,95,548,14017
15000US060670006002,637,268,144,493,14018
15000US060670007001,2494,623,580,1914,14019
15000US060670008001,423,294,43,380,14020
15000US060670008002,1129,730,123,1006,14021
15000US060670011011,966,620,158,808,14022
15000US060670011012,1246,669,152,1094,14023
15000US060670012001,1530,1028,261,1269,14024
15000US060670012002,791,569,94,697,14025
15000US060670012003,866,635,84,782,14026
15000US060670013001,891,531,94,797,14027
15000US060670013002,853,545,223,630,14028
15000US060670013003,1313,780,201,1112,14029
15000US060670014001,520,364,56,464,14030
15000US060670014002,840,598,102,738,14031
15000US060670014003,1093,755,97,996,14032
15000US060670015001,1088,957,93,995,14033
15000US060670015002,1052,1034,0,1052,14034
15000US060670015003,670,458,62,608,14035
15000US060670015004,803,422,360,443,14036
15000US060670015005,1274,1065,59,1215,14037
15000US060670016001,1502,1019,414,1088,14038
15000US060670016002,1529,1105,105,1424,14039
15000US060670016003,882,488,213,669,14040
15000US060670016004,906,747,70,836,14041
15000US060670016005,1210,1057,77,1133,14042
15000US060670017001,1692,1479,134,1558,14043
15000US060670017002,699,631,39,660,14044
15000US060670017003,1219,815,180,1039,14045
15000US060670017004,668,583,28,640,14046
15000US060670017005,1315,687,188,1127,14047
15000US060670018001,1001,701,53,948,14048
15000US060670018002,529,260,96,433,14049
15000US060670018003,618,272,21,597,14050
15000US060670018004,1380,595,296,1084,14051
15000US060670018005,1293,664,276,1017,14052
15000US060670019001,1023,634,172,851,14053
15000US060670019002,628,290,145,483,14054
15000US060670019003,1432,1055,218,1214,14055
15000US060670020001,611,230,106,505,14056
15000US060670020002,1151,569,232,919,14057
15000US060670020003,710,325,136,574,14058
15000US060670021001,1160,469,350,810,14059
15000US060670021002,719,186,224,495,14060
15000US060670021003,622,246,9,613,14061
15000US060670022001,1452,376,521,931,14062
15000US060670022002,884,0,269,615,14063
15000US060670022003,1120,323,407,713,14064
15000US060670022004,828,514,148,680,14065
15000US060670023001,708,489,49,659,14066
15000US060670023002,801,590,58,743,14067
15000US060670023003,1197,851,205,992,14068
15000US060670023004,683,479,144,539,14069
15000US060670024001,1531,1225,208,1323,14070
15000US060670024002,1555,1207,102,1453,14071
15000US060670024003,544,431,51,493,14072
15000US060670024004,752,616,47,705,14073
15000US060670025001,768,579,49,719,14074
15000US060670025002,765,582,114,651,14075
15000US060670026001,1257,794,307,950,14076
15000US060670026002,827,590,119,708,14077
15000US060670026003,592,466,26,566,14078
15000US060670027001,556,343,152,404,14079
15000US060670027002,1150,355,219,931,14080
15000US060670027003,657,212,253,404,14081
15000US060670027004,1062,188,474,588,14082
15000US060670028001,1189,231,413,776,14083
15000US060670028002,798,78,369,429,14084
15000US060670028003,1466,231,826,640,14085
15000US060670029001,2185,879,687,1498,14086
15000US060670029002,1022,631,329,693,14087
15000US060670029003,513,428,0,513,14088
15000US060670029004,1467,661,644,823,14089
15000US060670030001,2793,402,1035,1758,14090
15000US060670030002,1462,533,721,741,14091
15000US060670030003,1149,763,131,1018,14092
15000US060670030004,1089,631,371,718,14093
15000US060670030005,777,538,125,652,14094
15000US060670031011,884,247,471,413,14095
15000US060670031012,461,252,180,281,14096
15000US060670031013,1212,347,736,476,14097
15000US060670031014,870,261,551,319,14098
15000US060670031021,1073,468,465,608,14099
15000US060670031022,975,391,369,606,14100
15000US060670031023,1015,139,369,646,14101
15000US060670032021,1099,339,180,919,14102
15000US060670032022,3058,289,799,2259,14103
15000US060670032023,1065,355,601,464,14104
15000US060670032031,1376,129,615,761,14105
15000US060670032032,1769,83,393,1376,14106
15000US060670032041,1842,252,783,1059,14107
15000US060670032042,1279,51,301,978,14108
15000US060670032043,2293,278,563,1730,14109
15000US060670033001,1315,1077,98,1217,14110
15000US060670033002,1383,425,174,1209,14111
15000US060670033003,1668,1053,261,1407,14112
15000US060670034001,1348,227,552,796,14113
15000US060670034002,1500,752,236,1264,14114
15000US060670034003,1502,842,249,1253,14115
15000US060670035011,723,292,332,391,14116
15000US060670035012,794,499,107,687,14117
15000US060670035013,977,301,448,529,14118
15000US060670035021,1126,653,218,908,14119
15000US060670035022,917,163,286,631,14120
15000US060670035023,680,234,211,469,14121
15000US060670036001,2027,589,1120,907,14122
15000US060670036002,1033,319,498,535,14123
15000US060670037001,2551,313,1137,1414,14124
15000US060670037002,1401,223,846,555,14125
15000US060670038001,3225,286,1319,1906,14126
15000US060670038002,1342,416,558,784,14127
15000US060670038003,794,93,60,734,14128
15000US060670038004,690,208,228,462,14129
15000US060670039001,902,428,136,766,14130
15000US060670039002,1098,472,221,877,14131
15000US060670039003,1399,561,487,912,14132
15000US060670040011,1002,430,135,867,14133
15000US060670040012,1026,238,250,776,14134
15000US060670040013,1810,744,433,1377,14135
15000US060670040014,1468,366,450,1018,14136
15000US060670040041,2148,1325,223,1925,14137
15000US060670040042,2681,1119,562,2119,14138
15000US060670040043,1740,476,267,1473,14139
15000US060670040051,981,450,24,957,14140
15000US060670040052,2181,810,335,1846,14141
15000US060670040053,1028,458,147,881,14142
15000US060670040061,827,367,156,671,14143
15000US060670040062,1601,618,368,1233,14144
15000US060670040063,1258,105,225,1033,14145
15000US060670040064,1342,417,72,1270,14146
15000US060670040081,2300,916,423,1877,14147
15000US060670040082,1450,754,292,1158,14148
15000US060670040091,919,401,65,854,14149
15000US060670040092,1104,176,88,1016,14150
15000US060670040093,1789,311,504,1285,14151
15000US060670040094,1079,391,217,862,14152
15000US060670040101,2397,644,126,2271,14153
15000US060670040102,1581,451,146,1435,14154
15000US060670040103,1151,294,291,860,14155
15000US060670040111,1285,405,85,1200,14156
15000US060670040112,1680,630,175,1505,14157
15000US060670040121,2694,853,624,2070,14158
15000US060670040122,837,375,53,784,14159
15000US060670041001,2046,472,1002,1044,14160
15000US060670041002,841,69,247,594,14161
15000US060670041003,2290,238,627,1663,14162
15000US060670042011,906,71,499,407,14163
15000US060670042012,2618,250,1200,1418,14164
15000US060670042013,2088,299,383,1705,14165
15000US060670042021,1944,205,999,945,14166
15000US060670042022,2036,230,505,1531,14167
15000US060670042023,1804,151,687,1117,14168
15000US060670042031,3086,373,1038,2048,14169
15000US060670042032,2442,280,829,1613,14170
15000US060670043001,1805,334,494,1311,14171
15000US060670043002,2417,255,647,1770,14172
15000US060670043003,2626,273,1042,1584,14173
15000US060670043004,2295,163,248,2047,14174
15000US060670044011,669,80,183,486,14175
15000US060670044012,987,133,502,485,14176
15000US060670044013,1300,300,590,710,14177
15000US060670044014,857,157,458,399,14178
15000US060670044021,1701,218,879,822,14179
15000US060670044022,1919,344,1110,809,14180
15000US060670044023,1059,69,637,422,14181
15000US060670045011,1745,91,1159,586,14182
15000US060670045012,1491,47,678,813,14183
15000US060670045021,1208,363,660,548,14184
15000US060670045022,1754,109,697,1057,14185
15000US060670045023,2200,229,970,1230,14186
15000US060670046011,1118,251,477,641,14187
15000US060670046012,2118,337,550,1568,14188
15000US060670046013,1167,257,224,943,14189
15000US060670046014,1086,53,523,563,14190
15000US060670046015,2372,483,984,1388,14191
15000US060670046021,2061,535,1031,1030,14192
15000US060670046022,728,219,172,556,14193
15000US060670046023,2142,339,1350,792,14194
15000US060670047011,1424,259,684,740,14195
15000US060670047012,2144,142,891,1253,14196
15000US060670047021,3503,291,1416,2087,14197
15000US060670047022,1967,158,761,1206,14198
15000US060670048011,1259,266,209,1050,14199
15000US060670048012,1363,49,232,1131,14200
15000US060670048013,1665,499,405,1260,14201
15000US060670048014,1337,10,290,1047,14202
15000US060670048021,2998,469,957,2041,14203
15000US060670048022,1747,307,452,1295,14204
15000US060670049031,2914,661,747,2167,14205
15000US060670049032,2419,217,242,2177,14206
15000US060670049033,1582,131,433,1149,14207
15000US060670049041,1580,402,491,1089,14208
15000US060670049042,2675,580,1009,1666,14209
15000US060670049043,1637,384,578,1059,14210
15000US060670049051,2442,261,480,1962,14211
15000US060670049052,2583,226,1655,928,14212
15000US060670049053,2042,762,588,1454,14213
15000US060670049061,1722,162,443,1279,14214
15000US060670049062,1357,223,441,916,14215
15000US060670050011,2809,478,1288,1521,14216
15000US060670050012,3663,132,1625,2038,14217
15000US060670050013,2508,385,416,2092,14218
15000US060670050021,1872,385,676,1196,14219
15000US060670050022,1746,530,466,1280,14220
15000US060670050023,2533,660,469,2064,14221
15000US060670051011,2051,359,711,1340,14222
15000US060670051012,2237,442,565,1672,14223
15000US060670051021,2825,431,953,1872,14224
15000US060670051022,1956,1170,320,1636,14225
15000US060670052011,1115,227,531,584,14226
15000US060670052012,2255,786,686,1569,14227
15000US060670052021,2013,1199,549,1464,14228
15000US060670052022,1231,926,218,1013,14229
15000US060670052041,559,454,61,498,14230
15000US060670052042,1247,510,497,750,14231
15000US060670052043,1121,755,118,1003,14232
15000US060670052044,830,713,22,808,14233
15000US060670052045,550,364,92,458,14234
15000US060670052051,735,422,151,584,14235
15000US060670052052,1190,700,295,895,14236
15000US060670053011,1006,317,327,679,14237
15000US060670053012,256,90,104,152,14238
15000US060670054021,1119,762,136,983,14239
15000US060670054022,1415,735,364,1051,14240
15000US060670054031,975,889,16,959,14241
15000US060670054032,1405,722,436,969,14242
15000US060670054041,1321,1166,76,1245,14243
15000US060670054042,824,716,29,795,14244
15000US060670054043,531,457,58,473,14245
15000US060670054044,1775,1145,204,1571,14246
15000US060670054045,794,514,132,662,14247
15000US060670055021,1049,278,685,364,14248
15000US060670055022,1643,771,576,1067,14249
15000US060670055023,2725,787,1101,1624,14250
15000US060670055051,1535,1249,181,1354,14251
15000US060670055052,1622,762,558,1064,14252
15000US060670055053,2398,616,810,1588,14253
15000US060670055061,1440,375,620,820,14254
15000US060670055062,1845,895,466,1379,14255
15000US060670055081,693,410,174,519,14256
15000US060670055082,1570,749,275,1295,14257
15000US060670055083,1167,561,318,849,14258
15000US060670055091,1520,554,401,1119,14259
15000US060670055092,279,59,69,210,14260
15000US060670055101,1998,529,923,1075,14261
15000US060670055102,859,366,80,779,14262
15000US060670055103,1740,1144,182,1558,14263
15000US060670056011,893,786,91,802,14264
15000US060670056012,1007,709,143,864,14265
15000US060670056013,1382,574,188,1194,14266
15000US060670056014,1614,943,47,1567,14267
15000US060670056051,1691,971,418,1273,14268
15000US060670056052,1785,864,593,1192,14269
15000US060670056061,1018,741,117,901,14270
15000US060670056062,1688,1264,121,1567,14271
15000US060670056063,786,449,215,571,14272
15000US060670056064,986,663,117,869,14273
15000US060670057011,1450,840,280,1170,14274
15000US060670057012,506,441,0,506,14275
15000US060670057013,1094,797,163,931,14276
15000US060670057021,946,716,60,886,14277
15000US060670057022,1079,768,220,859,14278
15000US060670057023,1185,1009,67,1118,14279
15000US060670057024,640,394,107,533,14280
15000US060670057025,763,629,69,694,14281
15000US060670058011,773,757,16,757,14282
15000US060670058012,1101,749,73,1028,14283
15000US060670058013,2399,1758,479,1920,14284
15000US060670058014,1256,928,100,1156,14285
15000US060670058031,1606,1205,249,1357,14286
15000US060670058032,970,819,9,961,14287
15000US060670058033,1116,952,39,1077,14288
15000US060670058041,1210,893,104,1106,14289
15000US060670058042,1276,1067,24,1252,14290
15000US060670059011,1792,1066,242,1550,14291
15000US060670059012,1484,1320,53,1431,14292
15000US060670059013,3236,2571,272,2964,14293
15000US060670059031,1596,932,235,1361,14294
15000US060670059032,573,477,61,512,14295
15000US060670059041,1044,884,55,989,14296
15000US060670059042,865,803,23,842,14297
15000US060670059043,869,797,0,869,14298
15000US060670059044,2062,1222,357,1705,14299
15000US060670060021,637,535,40,597,14300
15000US060670060022,965,430,324,641,14301
15000US060670060023,678,591,24,654,14302
15000US060670060024,689,392,169,520,14303
15000US060670060025,1170,624,347,823,14304
15000US060670060031,2607,1554,489,2118,14305
15000US060670060032,1986,1194,239,1747,14306
15000US060670060041,897,509,84,813,14307
15000US060670060042,1097,992,0,1097,14308
15000US060670060043,517,438,32,485,14309
15000US060670061011,1481,880,223,1258,14310
15000US060670061012,1964,1003,581,1383,14311
15000US060670061013,1573,986,140,1433,14312
15000US060670061021,798,533,51,747,14313
15000US060670061022,1948,814,707,1241,14314
15000US060670061023,823,677,52,771,14315
15000US060670062011,1430,329,461,969,14316
15000US060670062012,2271,849,868,1403,14317
15000US060670062013,943,646,197,746,14318
15000US060670062014,2229,817,605,1624,14319
15000US060670062021,977,513,368,609,14320
15000US060670062022,1450,606,681,769,14321
15000US060670062023,944,83,510,434,14322
15000US060670063001,1694,421,808,886,14323
15000US060670063002,1645,602,514,1131,14324
15000US060670063003,1547,459,966,581,14325
15000US060670063004,587,165,286,301,14326
15000US060670064001,1321,519,403,918,14327
15000US060670064002,1119,408,456,663,14328
15000US060670064003,739,470,222,517,14329
15000US060670064004,1493,415,558,935,14330
15000US060670064005,708,245,251,457,14331
15000US060670065001,751,262,287,464,14332
15000US060670065002,1728,248,691,1037,14333
15000US060670065003,873,74,379,494,14334
15000US060670065004,2205,388,787,1418,14335
15000US060670065005,1291,488,165,1126,14336
15000US060670066001,1175,145,197,978,14337
15000US060670066002,1628,224,694,934,14338
15000US060670066003,1217,341,528,689,14339
15000US060670066004,1224,242,586,638,14340
15000US060670066005,1677,579,632,1045,14341
15000US060670067011,2826,511,1547,1279,14342
15000US060670067012,2465,723,798,1667,14343
15000US060670067013,1598,293,808,790,14344
15000US060670067014,1851,377,612,1239,14345
15000US060670067021,1863,614,368,1495,14346
15000US060670067022,1384,156,624,760,14347
15000US060670067023,1189,110,472,717,14348
15000US060670067024,1140,69,487,653,14349
15000US060670067025,1354,282,477,877,14350
15000US060670068001,1891,357,977,914,14351
15000US060670068002,2853,218,1986,867,14352
15000US060670068003,1472,298,888,584,14353
15000US060670068004,1244,386,342,902,14354
15000US060670069001,607,284,17,590,14355
15000US060670069002,1167,240,378,789,14356
15000US060670069003,1007,223,412,595,14357
15000US060670069004,1215,685,478,737,14358
15000US060670069005,723,444,162,561,14359
15000US060670070011,2413,257,1538,875,14360
15000US060670070012,1055,89,576,479,14361
15000US060670070013,1055,281,559,496,14362
15000US060670070041,3258,488,1396,1862,14363
15000US060670070042,2231,593,916,1315,14364
15000US060670070043,1702,301,955,747,14365
15000US060670070071,2007,522,1168,839,14366
15000US060670070072,1448,550,240,1208,14367
15000US060670070073,1952,376,1428,524,14368
15000US060670070101,860,476,79,781,14369
15000US060670070102,1781,667,603,1178,14370
15000US060670070103,936,567,219,717,14371
15000US060670070111,2847,682,1147,1700,14372
15000US060670070112,1425,203,948,477,14373
15000US060670070113,1713,673,273,1440,14374
15000US060670070114,700,209,284,416,14375
15000US060670070121,1704,530,687,1017,14376
15000US060670070122,1507,436,516,991,14377
15000US060670070131,1544,420,722,822,14378
15000US060670070132,1634,303,503,1131,14379
15000US060670070141,1282,319,617,665,14380
15000US060670070142,2808,566,1308,1500,14381
15000US060670070143,2306,767,766,1540,14382
15000US060670070144,1178,291,442,736,14383
15000US060670070151,3191,1182,602,2589,14384
15000US060670070152,1732,624,438,1294,14385
15000US060670070161,2943,511,624,2319,14386
15000US060670070162,3154,902,848,2306,14387
15000US060670070171,1337,609,363,974,14388
15000US060670070172,1903,688,455,1448,14389
15000US060670070181,2232,659,452,1780,14390
15000US060670070182,3134,1493,499,2635,14391
15000US060670070191,1031,210,213,818,14392
15000US060670070201,2933,1527,747,2186,14393
15000US060670070202,1653,705,274,1379,14394
15000US060670071011,228,220,0,228,14395
15000US060670071021,0,0,0,0,14396
15000US060670071022,4415,1099,519,3896,14397
15000US060670071023,1573,926,211,1362,14398
15000US060670071024,1940,1170,198,1742,14399
15000US060670071031,2855,587,927,1928,14400
15000US060670071032,1365,499,280,1085,14401
15000US060670071041,5720,2112,799,4921,14402
15000US060670071042,2268,659,677,1591,14403
15000US060670071051,3306,891,850,2456,14404
15000US060670071052,2226,1027,218,2008,14405
15000US060670071053,1540,342,395,1145,14406
15000US060670071061,1153,649,71,1082,14407
15000US060670071062,3674,1264,1051,2623,14408
15000US060670071063,2090,511,833,1257,14409
15000US060670071064,1398,377,152,1246,14410
15000US060670071071,721,349,114,607,14411
15000US060670071072,2676,951,493,2183,14412
15000US060670072021,1508,884,435,1073,14413
15000US060670072022,1439,1045,251,1188,14414
15000US060670072023,942,618,94,848,14415
15000US060670072041,2710,843,834,1876,14416
15000US060670072042,1988,1197,375,1613,14417
15000US060670072061,1767,1428,94,1673,14418
15000US060670072062,2317,1832,340,1977,14419
15000US060670072071,1293,915,256,1037,14420
15000US060670072072,1701,890,576,1125,14421
15000US060670072073,1377,874,197,1180,14422
15000US060670072081,729,532,0,729,14423
15000US060670072082,1998,1054,704,1294,14424
15000US060670072083,1710,1066,460,1250,14425
15000US060670072091,1579,1342,144,1435,14426
15000US060670072092,2002,1132,715,1287,14427
15000US060670073011,2734,1114,706,2028,14428
15000US060670073012,1026,448,457,569,14429
15000US060670073013,1093,713,118,975,14430
15000US060670074021,2000,1062,655,1345,14431
15000US060670074022,2085,1292,418,1667,14432
15000US060670074023,1230,521,285,945,14433
15000US060670074024,1162,383,615,547,14434
15000US060670074031,2414,1122,573,1841,14435
15000US060670074032,2733,1211,686,2047,14436
15000US060670074061,2294,947,206,2088,14437
15000US060670074062,2297,1090,999,1298,14438
15000US060670074063,2378,1596,339,2039,14439
15000US060670074064,1608,365,1087,521,14440
15000US060670074131,2190,1056,447,1743,14441
15000US060670074132,2927,1116,991,1936,14442
15000US060670074133,1586,980,108,1478,14443
15000US060670074141,1865,986,527,1338,14444
15000US060670074142,2461,1170,524,1937,14445
15000US060670074151,1116,686,92,1024,14446
15000US060670074152,2127,1039,748,1379,14447
15000US060670074161,2198,1037,618,1580,14448
15000US060670074162,2245,1090,666,1579,14449
15000US060670074171,1115,754,103,1012,14450
15000US060670074172,2254,1293,453,1801,14451
15000US060670074211,2793,2186,121,2672,14452
15000US060670074212,4121,2011,934,3187,14453
15000US060670074213,2541,1778,217,2324,14454
15000US060670074221,1525,970,337,1188,14455
15000US060670074222,1015,552,381,634,14456
15000US060670074231,1992,942,385,1607,14457
15000US060670074232,3069,1058,1046,2023,14458
15000US060670074241,2260,1125,649,1611,14459
15000US060670074242,1569,975,350,1219,14460
15000US060670074261,1236,524,236,1000,14461
15000US060670074262,877,483,67,810,14462
15000US060670074271,1298,808,248,1050,14463
15000US060670074272,1564,1100,321,1243,14464
15000US060670074273,4477,2411,380,4097,14465
15000US060670074281,1825,1037,250,1575,14466
15000US060670074282,1704,1283,168,1536,14467
15000US060670074291,2099,998,734,1365,14468
15000US060670074292,1427,1082,112,1315,14469
15000US060670074293,1608,637,624,984,14470
15000US060670074301,1784,1131,315,1469,14471
15000US060670074302,2824,1350,437,2387,14472
15000US060670074303,3621,1999,962,2659,14473
15000US060670074311,1751,898,239,1512,14474
15000US060670074312,1985,1106,215,1770,14475
15000US060670074321,2224,1419,233,1991,14476
15000US060670074322,3097,2032,366,2731,14477
15000US060670074331,1673,955,117,1556,14478
15000US060670074332,2890,1398,467,2423,14479
15000US060670074333,3541,1638,328,3213,14480
15000US060670075011,1413,971,317,1096,14481
15000US060670075012,792,375,193,599,14482
15000US060670075013,387,362,25,362,14483
15000US060670075014,1877,1218,395,1482,14484
15000US060670075015,1876,741,666,1210,14485
15000US060670075031,793,256,62,731,14486
15000US060670075032,2495,1799,161,2334,14487
15000US060670075033,533,204,170,363,14488
15000US060670075034,1374,555,278,1096,14489
15000US060670075041,920,581,242,678,14490
15000US060670075042,1327,997,174,1153,14491
15000US060670076011,1397,997,341,1056,14492
15000US060670076012,1650,997,354,1296,14493
15000US060670076013,2116,1307,226,1890,14494
15000US060670076014,1557,1069,339,1218,14495
15000US060670076021,1278,872,224,1054,14496
15000US060670076022,1262,897,140,1122,14497
15000US060670076023,1431,1096,145,1286,14498
15000US060670076024,870,665,47,823,14499
15000US060670077011,923,742,137,786,14500
15000US060670077012,1369,967,141,1228,14501
15000US060670077013,716,396,22,694,14502
15000US060670077014,918,547,205,713,14503
15000US060670077015,2236,1431,470,1766,14504
15000US060670077021,2218,1583,232,1986,14505
15000US060670077022,737,410,234,503,14506
15000US060670077023,1329,1020,23,1306,14507
15000US060670078011,1894,1124,96,1798,14508
15000US060670078012,1682,1403,166,1516,14509
15000US060670078013,1126,920,16,1110,14510
15000US060670078014,1121,852,227,894,14511
15000US060670078021,910,824,0,910,14512
15000US060670078022,1198,922,35,1163,14513
15000US060670078023,2185,1276,483,1702,14514
15000US060670078024,578,472,27,551,14515
15000US060670079031,819,668,59,760,14516
15000US060670079032,1106,708,129,977,14517
15000US060670079033,514,444,38,476,14518
15000US060670079034,1441,871,220,1221,14519
15000US060670079035,1066,987,50,1016,14520
15000US060670079041,1964,1332,337,1627,14521
15000US060670079042,1349,1092,189,1160,14522
15000US060670079043,1127,911,119,1008,14523
15000US060670079044,804,636,83,721,14524
15000US060670079051,2091,1718,171,1920,14525
15000US060670079052,2183,1748,204,1979,14526
15000US060670079061,2377,1728,434,1943,14527
15000US060670079062,1233,960,49,1184,14528
15000US060670080051,946,738,145,801,14529
15000US060670080052,2051,1747,164,1887,14530
15000US060670080053,1329,1141,148,1181,14531
15000US060670080061,1797,1290,334,1463,14532
15000US060670080062,907,750,82,825,14533
15000US060670080063,1517,1218,90,1427,14534
15000US060670080064,1287,1057,210,1077,14535
15000US060670080071,1569,1341,133,1436,14536
15000US060670080072,1906,1369,302,1604,14537
15000US060670080081,1495,1258,150,1345,14538
15000US060670080082,1491,1146,140,1351,14539
15000US060670080083,1919,1419,119,1800,14540
15000US060670080091,1011,779,83,928,14541
15000US060670080092,847,725,67,780,14542
15000US060670080093,1656,1354,134,1522,14543
15000US060670080094,1131,878,167,964,14544
15000US060670080101,1062,883,146,916,14545
15000US060670080102,1688,1190,420,1268,14546
15000US060670080103,1294,973,34,1260,14547
15000US060670080104,1260,1066,113,1147,14548
15000US060670081111,1731,1119,136,1595,14549
15000US060670081112,1736,1353,216,1520,14550
15000US060670081113,1846,1411,123,1723,14551
15000US060670081114,1445,1121,324,1121,14552
15000US060670081131,2753,2000,565,2188,14553
15000US060670081132,1038,792,210,828,14554
15000US060670081171,642,486,49,593,14555
15000US060670081172,1467,955,308,1159,14556
15000US060670081191,1408,1064,288,1120,14557
15000US060670081192,1308,1103,135,1173,14558
15000US060670081193,832,538,252,580,14559
15000US060670081194,876,682,69,807,14560
15000US060670081195,1001,817,141,860,14561
15000US060670081201,1583,1071,291,1292,14562
15000US060670081202,1341,1007,161,1180,14563
15000US060670081203,1419,842,383,1036,14564
15000US060670081221,789,614,51,738,14565
15000US060670081222,1937,1530,258,1679,14566
15000US060670081223,882,731,135,747,14567
15000US060670081241,3180,2574,261,2919,14568
15000US060670081242,1678,1307,249,1429,14569
15000US060670081251,2598,1846,506,2092,14570
15000US060670081252,889,625,90,799,14571
15000US060670081253,1498,1028,278,1220,14572
15000US060670081271,2113,1303,536,1577,14573
15000US060670081272,3355,2260,877,2478,14574
15000US060670081281,1001,723,215,786,14575
15000US060670081282,1313,792,356,957,14576
15000US060670081291,1592,881,613,979,14577
15000US060670081292,1900,964,392,1508,14578
15000US060670081301,1443,765,299,1144,14579
15000US060670081302,1491,937,226,1265,14580
15000US060670081303,1055,569,244,811,14581
15000US060670081311,946,712,106,840,14582
15000US060670081312,1838,1461,116,1722,14583
15000US060670081313,810,590,72,738,14584
15000US060670081314,1294,759,333,961,14585
15000US060670081321,1673,1445,54,1619,14586
15000US060670081322,2214,1536,260,1954,14587
15000US060670081331,1689,1206,176,1513,14588
15000US060670081332,1262,861,167,1095,14589
15000US060670081341,1549,1116,55,1494,14590
15000US060670081342,1775,877,348,1427,14591
15000US060670081343,1413,908,282,1131,14592
15000US060670081351,967,543,175,792,14593
15000US060670081352,1377,689,534,843,14594
15000US060670081353,804,624,83,721,14595
15000US060670081354,1212,1020,120,1092,14596
15000US060670081361,667,508,84,583,14597
15000US060670081362,1741,1432,57,1684,14598
15000US060670081371,1620,1468,138,1482,14599
15000US060670081372,945,761,130,815,14600
15000US060670081381,1040,681,320,720,14601
15000US060670081382,1692,805,740,952,14602
15000US060670081383,950,848,69,881,14603
15000US060670081391,1876,1021,630,1246,14604
15000US060670081392,1708,1321,208,1500,14605
15000US060670081401,1283,1062,47,1236,14606
15000US060670081402,1746,1111,347,1399,14607
15000US060670081411,879,675,47,832,14608
15000US060670081412,957,750,46,911,14609
15000US060670081413,837,475,362,475,14610
15000US060670081414,1652,954,329,1323,14611
15000US060670081415,2456,1252,912,1544,14612
15000US060670081421,2519,1441,695,1824,14613
15000US060670081422,1220,895,144,1076,14614
15000US060670081431,2425,1861,368,2057,14615
15000US060670081432,1504,969,527,977,14616
15000US060670081441,793,708,37,756,14617
15000US060670081442,1859,1448,197,1662,14618
15000US060670081451,1740,1408,146,1594,14619
15000US060670081452,2219,1806,224,1995,14620
15000US060670081453,738,401,212,526,14621
15000US060670081454,1443,1068,186,1257,14622
15000US060670081455,1024,848,115,909,14623
15000US060670081456,927,698,93,834,14624
15000US060670082031,2297,2026,77,2220,14625
15000US060670082032,2685,2038,379,2306,14626
15000US060670082041,2298,1726,305,1993,14627
15000US060670082042,2067,1763,208,1859,14628
15000US060670082061,786,717,32,754,14629
15000US060670082062,2624,2039,261,2363,14630
15000US060670082063,2464,2086,178,2286,14631
15000US060670082071,776,568,76,700,14632
15000US060670082072,603,531,30,573,14633
15000US060670082073,699,607,48,651,14634
15000US060670082074,679,578,58,621,14635
15000US060670082075,1551,1437,16,1535,14636
15000US060670082081,926,766,109,817,14637
15000US060670082082,1234,1045,138,1096,14638
15000US060670082083,1157,931,156,1001,14639
15000US060670082084,1283,966,205,1078,14640
15000US060670082091,1878,1429,193,1685,14641
15000US060670082092,2150,1823,181,1969,14642
15000US060670082101,2720,2269,98,2622,14643
15000US060670082102,1971,1515,228,1743,14644
15000US060670082103,1143,1021,89,1054,14645
15000US060670082111,1816,1532,100,1716,14646
15000US060670082112,1076,938,117,959,14647
15000US060670084021,1038,757,185,853,14648
15000US060670084022,1556,929,333,1223,14649
15000US060670084023,2880,2361,299,2581,14650
15000US060670084031,1637,1053,168,1469,14651
15000US060670084032,2309,1792,58,2251,14652
15000US060670084033,1788,1292,197,1591,14653
15000US060670084041,642,559,45,597,14654
15000US060670084042,1137,938,113,1024,14655
15000US060670084043,1368,817,416,952,14656
15000US060670085011,2274,1080,232,2042,14657
15000US060670085012,2496,1826,418,2078,14658
15000US060670085013,1667,1396,122,1545,14659
15000US060670085041,859,667,18,841,14660
15000US060670085042,3076,1960,374,2702,14661
15000US060670085043,711,571,53,658,14662
15000US060670085051,968,655,67,901,14663
15000US060670085052,1244,833,56,1188,14664
15000US060670085061,1861,1004,124,1737,14665
15000US060670085062,851,514,98,753,14666
15000US060670085071,1867,1301,230,1637,14667
15000US060670085072,1996,1166,238,1758,14668
15000US060670085081,2704,1194,247,2457,14669
15000US060670085082,2134,987,342,1792,14670
15000US060670085083,2673,1609,297,2376,14671
15000US060670085091,3274,2122,159,3115,14672
15000US060670085092,1510,1115,43,1467,14673
15000US060670085101,3014,2046,313,2701,14674
15000US060670085102,1731,1357,211,1520,14675
15000US060670085121,2551,1462,141,2410,14676
15000US060670085122,1856,1370,110,1746,14677
15000US060670085131,2166,1084,140,2026,14678
15000US060670085132,1212,693,92,1120,14679
15000US060670086001,1270,903,267,1003,14680
15000US060670086002,2453,2037,217,2236,14681
15000US060670086003,2456,1990,158,2298,14682
15000US060670086004,685,609,18,667,14683
15000US060670087021,1399,1165,30,1369,14684
15000US060670087022,1281,1023,72,1209,14685
15000US060670087031,1350,1070,99,1251,14686
15000US060670087032,1093,303,120,973,14687
15000US060670087033,2621,1763,174,2447,14688
15000US060670087041,2162,862,509,1653,14689
15000US060670087042,1663,641,64,1599,14690
15000US060670087051,4193,1838,600,3593,14691
15000US060670087052,2384,991,459,1925,14692
15000US060670088011,787,358,81,706,14693
15000US060670088012,3418,1905,464,2954,14694
15000US060670089051,1458,748,280,1178,14695
15000US060670089052,1546,1104,186,1360,14696
15000US060670089053,1722,1031,423,1299,14697
15000US060670089071,1172,774,137,1035,14698
15000US060670089072,2040,1500,213,1827,14699
15000US060670089073,981,259,507,474,14700
15000US060670089074,1154,685,307,847,14701
15000US060670089081,2884,1360,956,1928,14702
15000US060670089082,1831,1002,433,1398,14703
15000US060670089083,599,528,30,569,14704
15000US060670089091,1539,735,458,1081,14705
15000US060670089092,965,623,216,749,14706
15000US060670089101,1561,891,476,1085,14707
15000US060670089102,1944,983,509,1435,14708
15000US060670089111,860,578,142,718,14709
15000US060670089112,1452,365,521,931,14710
15000US060670089121,908,577,27,881,14711
15000US060670089122,1283,852,216,1067,14712
15000US060670089123,789,584,145,644,14713
15000US060670089131,835,724,8,827,14714
15000US060670089132,1039,653,174,865,14715
15000US060670089133,2507,1574,687,1820,14716
15000US060670090041,2260,1000,336,1924,14717
15000US060670090042,1333,903,182,1151,14718
15000US060670090051,2878,1545,654,2224,14719
15000US060670090052,523,242,97,426,14720
15000US060670090061,1947,811,527,1420,14721
15000US060670090062,2707,1506,432,2275,14722
15000US060670090063,679,212,230,449,14723
15000US060670090071,1071,593,266,805,14724
15000US060670090072,1869,773,190,1679,14725
15000US060670090081,1367,618,272,1095,14726
15000US060670090082,1446,603,514,932,14727
15000US060670090083,2217,1154,707,1510,14728
15000US060670090101,2712,829,875,1837,14729
15000US060670090102,1179,313,206,973,14730
15000US060670090103,1075,549,107,968,14731
15000US060670090111,2163,918,242,1921,14732
15000US060670090112,1847,731,333,1514,14733
15000US060670091031,1609,857,107,1502,14734
15000US060670091032,1471,629,455,1016,14735
15000US060670091051,1326,631,405,921,14736
15000US060670091052,477,256,84,393,14737
15000US060670091053,630,361,65,565,14738
15000US060670091061,1709,803,586,1123,14739
15000US060670091062,1265,815,346,919,14740
15000US060670091063,1065,502,143,922,14741
15000US060670091071,1010,425,110,900,14742
15000US060670091072,2103,1275,387,1716,14743
15000US060670091081,1372,798,252,1120,14744
15000US060670091082,1219,775,170,1049,14745
15000US060670091083,1237,720,257,980,14746
15000US060670091091,856,443,197,659,14747
15000US060670091092,1684,881,347,1337,14748
15000US060670091093,1549,888,335,1214,14749
15000US060670091094,977,491,174,803,14750
15000US060670091101,692,143,144,548,14751
15000US060670091102,1018,361,322,696,14752
15000US060670091111,1657,733,367,1290,14753
15000US060670091112,1748,730,322,1426,14754
15000US060670091113,2118,1124,339,1779,14755
15000US060670091121,1920,899,341,1579,14756
15000US060670091122,1954,970,643,1311,14757
15000US060670092011,647,250,77,570,14758
15000US060670092012,2917,1241,715,2202,14759
15000US060670093071,1733,1117,365,1368,14760
15000US060670093072,2051,1087,352,1699,14761
15000US060670093073,1686,1357,111,1575,14762
15000US060670093081,2185,1156,754,1431,14763
15000US060670093082,2496,1559,489,2007,14764
15000US060670093083,1579,1233,245,1334,14765
15000US060670093091,1632,1171,295,1337,14766
15000US060670093092,787,519,222,565,14767
15000US060670093101,1902,743,616,1286,14768
15000US060670093102,1132,939,127,1005,14769
15000US060670093103,1502,812,228,1274,14770
15000US060670093104,1571,821,352,1219,14771
15000US060670093105,1385,933,382,1003,14772
15000US060670093111,2286,973,456,1830,14773
15000US060670093112,4516,1335,1011,3505,14774
15000US060670093121,2020,843,197,1823,14775
15000US060670093122,3889,900,965,2924,14776
15000US060670093123,689,97,222,467,14777
15000US060670093141,2460,413,445,2015,14778
15000US060670093142,2056,1063,164,1892,14779
15000US060670093143,1505,629,264,1241,14780
15000US060670093161,2718,363,814,1904,14781
15000US060670093162,2066,158,171,1895,14782
15000US060670093171,2648,530,495,2153,14783
15000US060670093172,1559,329,659,900,14784
15000US060670093173,2300,775,474,1826,14785
15000US060670093181,2471,204,519,1952,14786
15000US060670093191,3125,521,532,2593,14787
15000US060670093192,1302,167,238,1064,14788
15000US060670093193,875,110,246,629,14789
15000US060670093201,1602,282,523,1079,14790
15000US060670093202,1851,421,156,1695,14791
15000US060670093203,1406,158,682,724,14792
15000US060670093211,2278,391,631,1647,14793
15000US060670093212,3680,896,846,2834,14794
15000US060670093221,4387,313,577,3810,14795
15000US060670093222,3956,838,783,3173,14796
15000US060670093223,2682,891,435,2247,14797
15000US060670093224,2830,662,665,2165,14798
15000US060670093231,2712,1409,363,2349,14799
15000US060670093232,2761,1007,474,2287,14800
15000US060670093241,1190,568,327,863,14801
15000US060670093242,1664,994,198,1466,14802
15000US060670093251,980,747,171,809,14803
15000US060670093261,2092,903,262,1830,14804
15000US060670093262,1359,383,204,1155,14805
15000US060670093263,1595,914,137,1458,14806
15000US060670093281,594,368,20,574,14807
15000US060670093282,2787,1029,442,2345,14808
15000US060670093283,1614,398,531,1083,14809
15000US060670093291,937,154,350,587,14810
15000US060670093292,1301,276,158,1143,14811
15000US060670093301,3934,1339,680,3254,14812
15000US060670093311,2029,769,270,1759,14813
15000US060670093312,1901,621,555,1346,14814
15000US060670093313,3622,1512,224,3398,14815
15000US060670093321,1251,600,156,1095,14816
15000US060670094031,1974,1291,492,1482,14817
15000US060670094041,988,898,75,913,14818
15000US060670094042,1946,1341,109,1837,14819
15000US060670094043,2354,1540,546,1808,14820
15000US060670094061,1042,740,257,785,14821
15000US060670094062,1352,943,230,1122,14822
15000US060670094071,3081,1463,1069,2012,14823
15000US060670094072,2074,1217,842,1232,14824
15000US060670094073,4839,1957,2335,2504,14825
15000US060670094081,1754,863,607,1147,14826
15000US060670095011,1372,527,815,557,14827
15000US060670095012,1486,384,994,492,14828
15000US060670095021,1548,1026,316,1232,14829
15000US060670095022,2843,1258,1490,1353,14830
15000US060670095023,1291,479,715,576,14831
15000US060670095024,2272,1457,793,1479,14832
15000US060670095031,1378,368,967,411,14833
15000US060670095032,830,527,268,562,14834
15000US060670095033,901,340,514,387,14835
15000US060670095041,2359,1170,1014,1345,14836
15000US060670096011,809,15,361,448,14837
15000US060670096012,2960,251,925,2035,14838
15000US060670096013,2785,211,645,2140,14839
15000US060670096061,1373,163,405,968,14840
15000US060670096062,1819,282,606,1213,14841
15000US060670096063,2919,634,705,2214,14842
15000US060670096064,1253,388,95,1158,14843
15000US060670096081,2277,459,298,1979,14844
15000US060670096082,5739,964,944,4795,14845
15000US060670096091,3271,480,1091,2180,14846
15000US060670096092,1984,228,322,1662,14847
15000US060670096101,1797,194,460,1337,14848
15000US060670096102,2644,292,800,1844,14849
15000US060670096103,1837,199,586,1251,14850
15000US060670096111,1220,384,362,858,14851
15000US060670096112,2111,849,430,1681,14852
15000US060670096121,4219,1191,1072,3147,14853
15000US060670096122,980,370,232,748,14854
15000US060670096141,4068,1188,640,3428,14855
15000US060670096142,2058,414,450,1608,14856
15000US060670096143,1423,271,389,1034,14857
15000US060670096151,1139,289,324,815,14858
15000US060670096152,1499,422,449,1050,14859
15000US060670096153,1751,747,156,1595,14860
15000US060670096154,909,402,18,891,14861
15000US060670096155,2589,635,1074,1515,14862
15000US060670096161,1124,617,264,860,14863
15000US060670096162,1022,390,356,666,14864
15000US060670096163,1997,1208,275,1722,14865
15000US060670096164,1672,602,116,1556,14866
15000US060670096171,859,379,192,667,14867
15000US060670096172,2807,1569,241,2566,14868
15000US060670096181,1947,809,276,1671,14869
15000US060670096182,2938,669,539,2399,14870
15000US060670096191,1223,291,152,1071,14871
15000US060670096192,3964,1201,1061,2903,14872
15000US060670096193,2949,1146,532,2417,14873
15000US060670096221,1074,248,392,682,14874
15000US060670096222,3633,1577,424,3209,14875
15000US060670096223,1625,457,293,1332,14876
15000US060670096224,1167,516,66,1101,14877
15000US060670096301,4326,1059,722,3604,14878
15000US060670096302,2633,537,598,2035,14879
15000US060670096303,1310,354,335,975,14880
15000US060670096304,2283,555,292,1991,14881
15000US060670096321,1433,344,282,1151,14882
15000US060670096322,2565,572,305,2260,14883
15000US060670096323,1907,431,361,1546,14884
15000US060670096324,1409,296,266,1143,14885
15000US060670096331,1552,152,605,947,14886
15000US060670096332,2023,298,624,1399,14887
15000US060670096341,2803,74,643,2160,14888
15000US060670096342,744,108,349,395,14889
15000US060670096343,1128,175,531,597,14890
15000US060670096351,3448,772,390,3058,14891
15000US060670096352,2802,1117,635,2167,14892
15000US060670096353,56,56,0,56,14893
15000US060670096361,1355,599,262,1093,14894
15000US060670096362,2901,520,497,2404,14895
15000US060670096363,2063,473,688,1375,14896
15000US060670096364,1852,306,207,1645,14897
15000US060670096371,997,167,269,728,14898
15000US060670096372,3599,711,522,3077,14899
15000US060670096373,1955,633,357,1598,14900
15000US060670096381,6852,2250,1304,5548,14901
15000US060670096382,924,320,287,637,14902
15000US060670096391,826,187,207,619,14903
15000US060670096392,1471,338,67,1404,14904
15000US060670096393,1547,405,494,1053,14905
15000US060670098001,1665,1165,423,1242,14906
15000US060670099001,1307,566,609,698,14907
15000US060670099002,1370,752,589,781,14908
15000US060670099003,695,175,379,316,14909
15000US060670099004,931,315,318,613,14910
15000US060679883001,5993,1356,1490,4503,14911
15000US060690001001,1068,745,259,809,14912
15000US060690001002,1790,602,1010,780,14913
15000US060690001003,1601,510,1056,545,14914
15000US060690001004,683,467,155,528,14915
15000US060690002001,1759,724,990,769,14916
15000US060690002002,631,153,415,216,14917
15000US060690002003,724,274,394,330,14918
15000US060690002004,1410,790,478,932,14919
15000US060690002005,1270,702,568,702,14920
15000US060690002006,653,421,232,421,14921
15000US060690003001,1657,62,1561,96,14922
15000US060690003002,806,158,623,183,14923
15000US060690003003,1951,153,1721,230,14924
15000US060690004001,994,92,856,138,14925
15000US060690004002,897,350,488,409,14926
15000US060690004003,889,126,760,129,14927
15000US060690004004,1646,500,1123,523,14928
15000US060690004005,748,215,479,269,14929
15000US060690004006,1023,369,646,377,14930
15000US060690005011,2814,1284,1318,1496,14931
15000US060690005012,2215,830,1295,920,14932
15000US060690005013,952,377,567,385,14933
15000US060690005021,1504,682,733,771,14934
15000US060690005022,1517,142,1314,203,14935
15000US060690005023,2427,196,2100,327,14936
15000US060690005024,928,208,621,307,14937
15000US060690006001,1644,656,867,777,14938
15000US060690006002,2927,1413,1216,1711,14939
15000US060690006003,2119,590,1278,841,14940
15000US060690006004,1568,997,551,1017,14941
15000US060690007011,2055,337,1669,386,14942
15000US060690007012,2250,234,1836,414,14943
15000US060690007021,1325,481,795,530,14944
15000US060690007022,2194,1094,903,1291,14945
15000US060690007023,1461,257,1084,377,14946
15000US060690008011,1932,1349,519,1413,14947
15000US060690008012,1303,883,339,964,14948
15000US060690008021,804,505,281,523,14949
15000US060690008022,635,278,347,288,14950
15000US060690008023,1277,778,417,860,14951
15000US060710001031,1530,393,638,892,14952
15000US060710001032,1471,387,288,1183,14953
15000US060710001033,2060,520,642,1418,14954
15000US060710001041,2756,538,712,2044,14955
15000US060710001042,1450,368,282,1168,14956
15000US060710001043,1939,497,730,1209,14957
15000US060710001051,1801,455,160,1641,14958
15000US060710001052,2422,754,266,2156,14959
15000US060710001053,2483,338,1105,1378,14960
15000US060710001071,3023,1439,1038,1985,14961
15000US060710001081,1409,729,253,1156,14962
15000US060710001082,1526,854,102,1424,14963
15000US060710001083,2406,920,587,1819,14964
15000US060710001091,1146,704,164,982,14965
15000US060710001092,757,432,145,612,14966
15000US060710001093,1403,826,289,1114,14967
15000US060710001094,2064,598,850,1214,14968
15000US060710001095,1416,723,474,942,14969
15000US060710001111,2601,1197,562,2039,14970
15000US060710001131,2849,733,984,1865,14971
15000US060710001132,2180,533,1074,1106,14972
15000US060710001133,1906,380,1098,808,14973
15000US060710001134,1630,615,506,1124,14974
15000US060710001135,2935,236,2087,848,14975
15000US060710001151,2331,1051,833,1498,14976
15000US060710001152,4952,1520,920,4032,14977
15000US060710001161,2284,338,438,1846,14978
15000US060710001162,4847,1926,746,4101,14979
15000US060710001163,1169,396,250,919,14980
15000US060710001164,3749,1077,1203,2546,14981
15000US060710001171,2228,928,209,2019,14982
15000US060710001172,2326,966,625,1701,14983
15000US060710001173,1220,177,198,1022,14984
15000US060710001174,1094,242,170,924,14985
15000US060710001181,2268,522,584,1684,14986
15000US060710001182,2320,587,409,1911,14987
15000US060710002011,954,47,830,124,14988
15000US060710002012,2405,335,1508,897,14989
15000US060710002013,1096,156,809,287,14990
15000US060710002031,2221,358,1575,646,14991
15000US060710002032,792,186,524,268,14992
15000US060710002033,1427,217,991,436,14993
15000US060710002051,2124,319,1415,709,14994
15000US060710002052,2184,524,1287,897,14995
15000US060710002053,813,157,552,261,14996
15000US060710002071,1128,208,804,324,14997
15000US060710002072,1397,180,1062,335,14998
15000US060710002073,2219,375,1778,441,14999
15000US060710002081,3436,758,2502,934,15000
15000US060710002082,1603,417,1093,510,15001
15000US060710003011,1502,149,1078,424,15002
15000US060710003012,2226,196,1657,569,15003
15000US060710003013,2244,64,1727,517,15004
15000US060710003014,2814,69,2207,607,15005
15000US060710003031,1795,105,1606,189,15006
15000US060710003032,1365,307,940,425,15007
15000US060710003033,2174,71,2103,71,15008
15000US060710003034,2465,165,1962,503,15009
15000US060710003041,2229,412,1340,889,15010
15000US060710003042,2121,350,1071,1050,15011
15000US060710003043,1585,245,1312,273,15012
15000US060710004011,1633,506,898,735,15013
15000US060710004012,1392,451,885,507,15014
15000US060710004013,1193,257,635,558,15015
15000US060710004014,2040,719,1072,968,15016
15000US060710004031,998,272,712,286,15017
15000US060710004032,1698,573,949,749,15018
15000US060710004033,1778,570,837,941,15019
15000US060710004041,2462,631,1474,988,15020
15000US060710004042,1860,636,974,886,15021
15000US060710005011,3107,517,1838,1269,15022
15000US060710005012,1538,247,1144,394,15023
15000US060710005013,1584,632,869,715,15024
15000US060710005031,1313,250,779,534,15025
15000US060710005032,1492,460,826,666,15026
15000US060710005033,1808,336,1172,636,15027
15000US060710005041,617,99,385,232,15028
15000US060710005042,1580,808,681,899,15029
15000US060710005043,2345,834,1091,1254,15030
15000US060710006031,2694,767,1489,1205,15031
15000US060710006032,2396,520,1506,890,15032
15000US060710006041,2324,1022,1216,1108,15033
15000US060710006042,2023,273,1661,362,15034
15000US060710006043,1374,501,660,714,15035
15000US060710006051,2570,226,2104,466,15036
15000US060710006052,2070,54,2016,54,15037
15000US060710006061,2405,560,1685,720,15038
15000US060710006062,1599,111,1214,385,15039
15000US060710008041,1198,792,174,1024,15040
15000US060710008042,1901,1196,379,1522,15041
15000US060710008081,1536,829,640,896,15042
15000US060710008082,2092,964,849,1243,15043
15000US060710008083,1429,479,484,945,15044
15000US060710008084,1417,591,767,650,15045
15000US060710008121,1908,1087,651,1257,15046
15000US060710008122,731,217,213,518,15047
15000US060710008123,839,583,182,657,15048
15000US060710008131,1892,1216,383,1509,15049
15000US060710008132,1720,1019,423,1297,15050
15000US060710008141,894,633,115,779,15051
15000US060710008142,1453,929,279,1174,15052
15000US060710008143,784,439,208,576,15053
15000US060710008144,846,483,276,570,15054
15000US060710008151,1656,837,354,1302,15055
15000US060710008152,1757,918,470,1287,15056
15000US060710008161,1013,743,256,757,15057
15000US060710008162,1531,759,604,927,15058
15000US060710008163,1718,1162,393,1325,15059
15000US060710008171,1019,507,326,693,15060
15000US060710008172,1770,1010,520,1250,15061
15000US060710008173,872,468,234,638,15062
15000US060710008181,1344,481,492,852,15063
15000US060710008182,1394,576,695,699,15064
15000US060710008183,1574,759,528,1046,15065
15000US060710008184,1219,827,344,875,15066
15000US060710008191,747,596,55,692,15067
15000US060710008192,2450,846,718,1732,15068
15000US060710008193,1727,1091,281,1446,15069
15000US060710008201,1665,1164,249,1416,15070
15000US060710008202,962,577,269,693,15071
15000US060710008203,1308,680,317,991,15072
15000US060710008211,3768,1322,1547,2221,15073
15000US060710008231,2011,821,1029,982,15074
15000US060710008232,1993,791,853,1140,15075
15000US060710008233,2716,732,1590,1126,15076
15000US060710008241,1288,471,731,557,15077
15000US060710008242,1288,511,445,843,15078
15000US060710008243,1289,523,716,573,15079
15000US060710008244,1254,177,764,490,15080
15000US060710008251,1045,218,512,533,15081
15000US060710008252,2445,309,1625,820,15082
15000US060710008253,714,200,408,306,15083
15000US060710008261,1520,549,792,728,15084
15000US060710008262,1025,276,452,573,15085
15000US060710008263,1693,651,890,803,15086
15000US060710009011,1586,542,747,839,15087
15000US060710009012,1838,575,1144,694,15088
15000US060710009013,1090,415,598,492,15089
15000US060710009031,775,372,321,454,15090
15000US060710009032,1947,164,1212,735,15091
15000US060710009033,1504,209,946,558,15092
15000US060710009041,2326,518,1422,904,15093
15000US060710009042,947,245,630,317,15094
15000US060710010011,1866,418,949,917,15095
15000US060710010012,1715,248,1184,531,15096
15000US060710010013,1919,426,1057,862,15097
15000US060710010021,1469,85,1347,122,15098
15000US060710010022,2772,130,2224,548,15099
15000US060710010023,1671,139,1471,200,15100
15000US060710011011,1386,75,1205,181,15101
15000US060710011012,1740,311,1181,559,15102
15000US060710011013,691,129,562,129,15103
15000US060710011031,2041,700,1214,827,15104
15000US060710011032,1259,537,688,571,15105
15000US060710011033,1268,257,874,394,15106
15000US060710011041,1891,680,1060,831,15107
15000US060710011042,1338,353,941,397,15108
15000US060710011043,2554,389,1846,708,15109
15000US060710012001,1805,244,1501,304,15110
15000US060710012002,1266,323,827,439,15111
15000US060710012003,1118,512,532,586,15112
15000US060710012004,806,509,277,529,15113
15000US060710013051,1929,140,1589,340,15114
15000US060710013052,1193,124,888,305,15115
15000US060710013053,1499,128,1371,128,15116
15000US060710013071,2623,377,1997,626,15117
15000US060710013072,1759,245,1339,420,15118
15000US060710013081,2125,281,1608,517,15119
15000US060710013082,2888,184,2384,504,15120
15000US060710013091,2195,183,1875,320,15121
15000US060710013092,1112,103,1009,103,15122
15000US060710013093,1108,221,572,536,15123
15000US060710013101,1632,280,1120,512,15124
15000US060710013102,2050,531,1503,547,15125
15000US060710013103,1543,40,1432,111,15126
15000US060710013104,909,170,709,200,15127
15000US060710013111,3548,723,1550,1998,15128
15000US060710013121,2156,302,1485,671,15129
15000US060710013122,2768,380,1400,1368,15130
15000US060710014001,1043,121,669,374,15131
15000US060710014002,1568,268,824,744,15132
15000US060710015011,2614,265,2331,283,15133
15000US060710015012,1563,134,1410,153,15134
15000US060710015031,2082,61,1862,220,15135
15000US060710015032,1909,183,1706,203,15136
15000US060710015041,3019,73,2326,693,15137
15000US060710015042,2552,426,1577,975,15138
15000US060710016001,1210,0,1200,10,15139
15000US060710016002,427,8,419,8,15140
15000US060710016003,1021,35,861,160,15141
15000US060710016004,1321,8,1296,25,15142
15000US060710016005,1763,12,1751,12,15143
15000US060710017021,2173,417,1478,695,15144
15000US060710017022,1339,320,888,451,15145
15000US060710017023,1561,509,638,923,15146
15000US060710017031,1430,458,659,771,15147
15000US060710017032,867,207,466,401,15148
15000US060710017033,2044,402,1574,470,15149
15000US060710017034,1466,335,801,665,15150
15000US060710017041,3061,557,2098,963,15151
15000US060710017042,2085,418,1402,683,15152
15000US060710017061,2189,65,2124,65,15153
15000US060710017062,698,50,610,88,15154
15000US060710017063,3037,565,1840,1197,15155
15000US060710017071,2095,379,1655,440,15156
15000US060710017072,1863,130,1441,422,15157
15000US060710017073,2782,425,1635,1147,15158
15000US060710018031,3156,561,2232,924,15159
15000US060710018041,1779,242,1288,491,15160
15000US060710018042,3462,879,1825,1637,15161
15000US060710018061,1324,220,912,412,15162
15000US060710018062,1302,244,935,367,15163
15000US060710018063,2290,529,1026,1264,15164
15000US060710018081,1964,215,1587,377,15165
15000US060710018082,1488,263,827,661,15166
15000US060710018083,1235,208,857,378,15167
15000US060710018091,1615,254,1329,286,15168
15000US060710018092,2716,273,2349,367,15169
15000US060710018093,792,342,366,426,15170
15000US060710018101,1959,94,1713,246,15171
15000US060710018102,1718,278,1210,508,15172
15000US060710018103,1540,66,1370,170,15173
15000US060710018121,1806,144,1563,243,15174
15000US060710018122,1909,171,1671,238,15175
15000US060710018131,2073,100,1762,311,15176
15000US060710018132,2825,176,2545,280,15177
15000US060710019011,1618,505,941,677,15178
15000US060710019012,1734,344,852,882,15179
15000US060710019013,1630,457,785,845,15180
15000US060710019031,7723,2365,2549,5174,15181
15000US060710019032,2012,511,747,1265,15182
15000US060710019051,2079,648,909,1170,15183
15000US060710019052,707,124,427,280,15184
15000US060710019053,753,246,452,301,15185
15000US060710019054,2416,637,1336,1080,15186
15000US060710019061,4746,993,2846,1900,15187
15000US060710019062,3932,596,2105,1827,15188
15000US060710020101,4832,1387,2061,2771,15189
15000US060710020102,2217,732,789,1428,15190
15000US060710020103,3018,1335,912,2106,15191
15000US060710020111,2457,1770,357,2100,15192
15000US060710020112,1772,945,571,1201,15193
15000US060710020131,2161,890,1021,1140,15194
15000US060710020132,2220,1514,617,1603,15195
15000US060710020141,2252,1055,901,1351,15196
15000US060710020142,2547,1667,655,1892,15197
15000US060710020151,2794,1221,1110,1684,15198
15000US060710020152,2271,1124,867,1404,15199
15000US060710020161,2053,1011,910,1143,15200
15000US060710020162,1810,994,643,1167,15201
15000US060710020171,2109,1242,357,1752,15202
15000US060710020172,3463,1826,1096,2367,15203
15000US060710020181,3290,1487,1088,2202,15204
15000US060710020182,2309,1105,728,1581,15205
15000US060710020191,2497,1026,784,1713,15206
15000US060710020192,2521,1000,1026,1495,15207
15000US060710020211,1655,830,244,1411,15208
15000US060710020212,2157,679,836,1321,15209
15000US060710020213,1688,794,526,1162,15210
15000US060710020221,3826,1738,1044,2782,15211
15000US060710020222,9086,2709,2890,6196,15212
15000US060710020231,2503,1198,917,1586,15213
15000US060710020232,3224,1058,1303,1921,15214
15000US060710020251,2648,1427,941,1707,15215
15000US060710020252,2803,1351,889,1914,15216
15000US060710020271,1757,627,670,1087,15217
15000US060710020272,1761,818,429,1332,15218
15000US060710020273,1988,954,682,1306,15219
15000US060710020281,2493,715,1087,1406,15220
15000US060710020282,2595,1194,977,1618,15221
15000US060710020291,1464,520,639,825,15222
15000US060710020292,1559,566,565,994,15223
15000US060710020293,1244,688,173,1071,15224
15000US060710020294,1795,883,581,1214,15225
15000US060710020311,1546,362,829,717,15226
15000US060710020312,2854,604,1093,1761,15227
15000US060710020313,2093,1019,503,1590,15228
15000US060710020331,4508,1551,1870,2638,15229
15000US060710020332,3154,1684,759,2395,15230
15000US060710020341,6919,1962,3435,3484,15231
15000US060710020342,8592,2140,3694,4898,15232
15000US060710020351,4263,1392,1114,3149,15233
15000US060710020352,2628,979,1172,1456,15234
15000US060710020361,10249,3613,2744,7505,15235
15000US060710020362,2513,567,776,1737,15236
15000US060710020371,1010,46,575,435,15237
15000US060710020372,1603,447,866,737,15238
15000US060710020373,5235,1172,2362,2873,15239
15000US060710020381,2990,779,1349,1641,15240
15000US060710020382,3064,1079,1246,1818,15241
15000US060710021011,2495,339,1692,803,15242
15000US060710021012,1946,491,1136,810,15243
15000US060710021031,1560,344,659,901,15244
15000US060710021032,3450,1251,1502,1948,15245
15000US060710021051,2153,680,1023,1130,15246
15000US060710021052,946,80,707,239,15247
15000US060710021053,2116,510,1235,881,15248
15000US060710021071,934,130,770,164,15249
15000US060710021072,2266,1062,906,1360,15250
15000US060710021073,2323,644,959,1364,15251
15000US060710021091,4318,1098,1751,2567,15252
15000US060710021092,738,144,219,519,15253
15000US060710021101,7227,1940,3000,4227,15254
15000US060710022041,840,32,748,92,15255
15000US060710022042,2068,237,1191,877,15256
15000US060710022043,4131,353,3457,674,15257
15000US060710022061,2243,382,1569,674,15258
15000US060710022062,1037,273,747,290,15259
15000US060710022063,1035,206,505,530,15260
15000US060710022064,2619,573,1460,1159,15261
15000US060710022071,2125,586,933,1192,15262
15000US060710022072,2816,783,1327,1489,15263
15000US060710023011,1260,285,889,371,15264
15000US060710023012,3302,507,2160,1142,15265
15000US060710023013,3924,382,2902,1022,15266
15000US060710023014,2432,62,1449,983,15267
15000US060710023041,4722,688,2276,2446,15268
15000US060710023042,10993,2539,5405,5588,15269
15000US060710023043,5038,1028,2825,2213,15270
15000US060710023051,5148,802,2351,2797,15271
15000US060710023052,1192,167,706,486,15272
15000US060710023053,1251,24,1114,137,15273
15000US060710023054,2542,331,2148,394,15274
15000US060710023061,1229,65,1017,212,15275
15000US060710023062,2908,318,2010,898,15276
15000US060710023071,2758,312,1782,976,15277
15000US060710023072,2693,281,2225,468,15278
15000US060710024011,1829,81,1625,204,15279
15000US060710024012,1745,65,1381,364,15280
15000US060710024013,1147,98,1009,138,15281
15000US060710024014,1004,41,954,50,15282
15000US060710024015,3122,184,2865,257,15283
15000US060710024021,2499,194,2130,369,15284
15000US060710024022,2364,99,2236,128,15285
15000US060710024023,1316,182,1014,302,15286
15000US060710024024,1987,102,1744,243,15287
15000US060710025011,1269,45,1224,45,15288
15000US060710025012,2147,131,1841,306,15289
15000US060710025013,1607,35,1420,187,15290
15000US060710025014,1162,108,941,221,15291
15000US060710025021,1982,75,1836,146,15292
15000US060710025022,2608,274,1813,795,15293
15000US060710025023,3167,130,2964,203,15294
15000US060710025024,987,97,819,168,15295
15000US060710026011,2819,646,2151,668,15296
15000US060710026012,6989,858,4426,2563,15297
15000US060710026021,1619,242,1089,530,15298
15000US060710026022,1385,165,907,478,15299
15000US060710026023,3132,184,2775,357,15300
15000US060710026024,1480,57,1181,299,15301
15000US060710026041,1782,341,1367,415,15302
15000US060710026042,1516,291,1069,447,15303
15000US060710026043,784,166,451,333,15304
15000US060710026044,2129,123,1656,473,15305
15000US060710026061,2935,227,2195,740,15306
15000US060710026062,2994,247,2451,543,15307
15000US060710026063,2116,262,1227,889,15308
15000US060710026071,2171,324,962,1209,15309
15000US060710026072,1886,205,1155,731,15310
15000US060710026073,1657,139,1075,582,15311
15000US060710026074,2404,122,1799,605,15312
15000US060710027031,2629,257,2009,620,15313
15000US060710027032,1465,441,796,669,15314
15000US060710027033,1458,566,753,705,15315
15000US060710027041,1946,173,1614,332,15316
15000US060710027042,7676,1966,3007,4669,15317
15000US060710027043,1354,88,533,821,15318
15000US060710027051,1146,227,825,321,15319
15000US060710027052,1640,145,1398,242,15320
15000US060710027053,1648,111,1381,267,15321
15000US060710027054,965,98,716,249,15322
15000US060710027061,6372,2288,2906,3466,15323
15000US060710027062,1687,159,1177,510,15324
15000US060710027063,2363,541,1042,1321,15325
15000US060710028011,2311,241,1906,405,15326
15000US060710028012,2069,63,1769,300,15327
15000US060710028013,1130,31,936,194,15328
15000US060710028031,1999,43,1779,220,15329
15000US060710028032,1017,138,771,246,15330
15000US060710028033,1177,169,934,243,15331
15000US060710028041,2635,179,2112,523,15332
15000US060710028042,1328,11,1317,11,15333
15000US060710028043,1995,59,1602,393,15334
15000US060710029011,1160,147,979,181,15335
15000US060710029012,1819,141,1604,215,15336
15000US060710029013,1184,176,990,194,15337
15000US060710029021,835,55,710,125,15338
15000US060710029022,1901,243,1375,526,15339
15000US060710029023,1755,138,1511,244,15340
15000US060710029024,911,352,559,352,15341
15000US060710029025,1177,203,779,398,15342
15000US060710030001,1865,234,1472,393,15343
15000US060710030002,1464,181,914,550,15344
15000US060710031011,674,131,543,131,15345
15000US060710031012,2199,327,1750,449,15346
15000US060710031013,1765,15,1732,33,15347
15000US060710031021,2027,294,1699,328,15348
15000US060710031022,1314,88,1207,107,15349
15000US060710031023,2598,148,2422,176,15350
15000US060710032001,2285,69,2178,107,15351
15000US060710032002,995,355,500,495,15352
15000US060710032003,2171,459,1712,459,15353
15000US060710032004,1193,248,945,248,15354
15000US060710032005,840,16,811,29,15355
15000US060710032006,1240,169,900,340,15356
15000US060710033011,2528,164,2127,401,15357
15000US060710033012,980,51,851,129,15358
15000US060710033013,1603,80,1275,328,15359
15000US060710033021,1416,239,1151,265,15360
15000US060710033022,1137,314,761,376,15361
15000US060710033023,2313,250,2023,290,15362
15000US060710033024,1231,249,910,321,15363
15000US060710034011,1989,308,1248,741,15364
15000US060710034012,1852,104,1217,635,15365
15000US060710034013,1915,390,1354,561,15366
15000US060710034014,1697,208,1489,208,15367
15000US060710034031,976,180,796,180,15368
15000US060710034032,1856,358,1339,517,15369
15000US060710034033,1138,196,767,371,15370
15000US060710034041,2233,268,1607,626,15371
15000US060710034042,1606,252,1315,291,15372
15000US060710034043,926,44,786,140,15373
15000US060710034051,1253,96,1071,182,15374
15000US060710034052,1314,61,1025,289,15375
15000US060710034053,2555,148,1698,857,15376
15000US060710035031,2399,14,1735,664,15377
15000US060710035032,2198,253,1516,682,15378
15000US060710035033,1424,165,1044,380,15379
15000US060710035051,2600,48,2287,313,15380
15000US060710035052,2024,120,1601,423,15381
15000US060710035053,1884,149,1478,406,15382
15000US060710035061,1227,76,648,579,15383
15000US060710035062,1906,303,1207,699,15384
15000US060710035063,2492,201,1913,579,15385
15000US060710035071,3234,312,2479,755,15386
15000US060710035072,1360,211,985,375,15387
15000US060710035091,1948,196,1675,273,15388
15000US060710035092,2387,240,1940,447,15389
15000US060710035101,3056,194,1791,1265,15390
15000US060710035102,1609,76,1392,217,15391
15000US060710036031,2108,165,1714,394,15392
15000US060710036032,1704,292,1192,512,15393
15000US060710036051,2192,391,1562,630,15394
15000US060710036052,2529,258,1778,751,15395
15000US060710036061,1324,33,1279,45,15396
15000US060710036062,756,160,510,246,15397
15000US060710036063,3268,252,2934,334,15398
15000US060710036071,3258,547,2488,770,15399
15000US060710036072,2368,205,1845,523,15400
15000US060710036091,887,66,806,81,15401
15000US060710036092,2476,169,2089,387,15402
15000US060710036093,1903,207,1446,457,15403
15000US060710036111,2693,426,1506,1187,15404
15000US060710036112,2088,86,1456,632,15405
15000US060710036121,2279,309,1769,510,15406
15000US060710036122,2243,226,1805,438,15407
15000US060710037001,1358,59,1281,77,15408
15000US060710037002,2587,205,1789,798,15409
15000US060710038011,805,92,568,237,15410
15000US060710038012,1804,127,1365,439,15411
15000US060710038013,2029,361,1222,807,15412
15000US060710038031,2138,116,1523,615,15413
15000US060710038032,3084,267,2380,704,15414
15000US060710038041,1441,126,955,486,15415
15000US060710038042,1526,200,1038,488,15416
15000US060710038043,1999,150,1375,624,15417
15000US060710039001,2703,185,2298,405,15418
15000US060710039002,1854,262,1541,313,15419
15000US060710039003,1413,77,1321,92,15420
15000US060710040011,2825,575,2112,713,15421
15000US060710040012,1598,169,1374,224,15422
15000US060710040031,1759,75,1676,83,15423
15000US060710040032,4206,418,3637,569,15424
15000US060710040041,3436,305,2934,502,15425
15000US060710040042,2613,519,1994,619,15426
15000US060710041011,2571,343,1878,693,15427
15000US060710041012,3109,392,2679,430,15428
15000US060710041031,2213,142,1726,487,15429
15000US060710041032,1719,72,1512,207,15430
15000US060710041033,2609,88,2389,220,15431
15000US060710041041,2682,146,2320,362,15432
15000US060710041042,3459,169,2964,495,15433
15000US060710042011,1541,87,1116,425,15434
15000US060710042012,1418,84,777,641,15435
15000US060710042013,1722,121,787,935,15436
15000US060710042014,2211,13,1409,802,15437
15000US060710042021,2196,69,1749,447,15438
15000US060710042022,1965,85,1318,647,15439
15000US060710042023,1878,61,1470,408,15440
15000US060710043011,2044,41,1830,214,15441
15000US060710043012,852,91,647,205,15442
15000US060710043013,2083,107,1338,745,15443
15000US060710043021,1316,33,1232,84,15444
15000US060710043022,460,17,443,17,15445
15000US060710043023,2801,168,2184,617,15446
15000US060710044011,1255,153,1084,171,15447
15000US060710044012,1711,153,1496,215,15448
15000US060710044013,1342,115,963,379,15449
15000US060710044031,2220,247,1803,417,15450
15000US060710044032,725,53,603,122,15451
15000US060710044033,3217,120,2531,686,15452
15000US060710044041,2007,102,1810,197,15453
15000US060710044042,1042,89,930,112,15454
15000US060710044043,2235,143,1675,560,15455
15000US060710045031,2853,845,1529,1324,15456
15000US060710045032,1192,695,460,732,15457
15000US060710045041,2025,218,1163,862,15458
15000US060710045042,2102,757,1017,1085,15459
15000US060710045043,4038,968,1557,2481,15460
15000US060710045051,1223,595,355,868,15461
15000US060710045052,1495,448,902,593,15462
15000US060710045053,1916,442,1116,800,15463
15000US060710045071,1193,358,724,469,15464
15000US060710045072,2008,259,1049,959,15465
15000US060710045073,1880,454,1193,687,15466
15000US060710045091,1576,510,847,729,15467
15000US060710045092,1960,335,1108,852,15468
15000US060710045093,1657,529,802,855,15469
15000US060710045101,2308,407,1294,1014,15470
15000US060710045102,2509,302,979,1530,15471
15000US060710045103,1012,219,536,476,15472
15000US060710046011,1389,360,837,552,15473
15000US060710046012,1548,695,702,846,15474
15000US060710046013,1098,409,415,683,15475
15000US060710046014,1470,296,1110,360,15476
15000US060710046015,683,262,357,326,15477
15000US060710046031,734,330,394,340,15478
15000US060710046032,835,229,451,384,15479
15000US060710046033,2475,657,861,1614,15480
15000US060710046034,1576,330,628,948,15481
15000US060710046041,1522,152,1285,237,15482
15000US060710046042,1327,152,766,561,15483
15000US060710046043,1149,256,646,503,15484
15000US060710046044,1440,259,1133,307,15485
15000US060710047001,1109,51,964,145,15486
15000US060710047002,957,14,826,131,15487
15000US060710047003,1012,0,966,46,15488
15000US060710047004,1010,88,833,177,15489
15000US060710047005,1055,11,978,77,15490
15000US060710048001,2122,27,2008,114,15491
15000US060710048002,1320,11,1258,62,15492
15000US060710049001,1188,133,967,221,15493
15000US060710049002,2423,55,2280,143,15494
15000US060710049003,2760,153,2509,251,15495
15000US060710049004,1485,125,1287,198,15496
15000US060710051001,1186,335,832,354,15497
15000US060710051002,1020,294,648,372,15498
15000US060710051003,1051,389,431,620,15499
15000US060710051004,1701,408,1107,594,15500
15000US060710051005,974,613,361,613,15501
15000US060710051006,1653,211,680,973,15502
15000US060710051007,1124,244,598,526,15503
15000US060710052001,1045,286,437,608,15504
15000US060710052002,1388,223,852,536,15505
15000US060710052003,902,92,743,159,15506
15000US060710052004,642,337,246,396,15507
15000US060710053001,1472,127,1173,299,15508
15000US060710053002,1106,157,841,265,15509
15000US060710053003,984,177,681,303,15510
15000US060710053004,1244,165,710,534,15511
15000US060710053005,655,256,342,313,15512
15000US060710054001,1711,276,1127,584,15513
15000US060710054002,1368,177,884,484,15514
15000US060710054003,1981,196,1241,740,15515
15000US060710054004,1789,346,1175,614,15516
15000US060710055001,2302,227,1290,1012,15517
15000US060710055002,1943,18,1640,303,15518
15000US060710055003,2067,132,1419,648,15519
15000US060710055004,1482,89,960,522,15520
15000US060710055005,1017,69,916,101,15521
15000US060710056001,959,113,778,181,15522
15000US060710056002,1782,181,1241,541,15523
15000US060710056003,1436,21,1318,118,15524
15000US060710056004,1575,34,1264,311,15525
15000US060710056005,1135,37,853,282,15526
15000US060710057011,871,72,391,480,15527
15000US060710057012,1222,138,1045,177,15528
15000US060710058001,1519,190,836,683,15529
15000US060710058002,1227,61,966,261,15530
15000US060710058003,976,31,817,159,15531
15000US060710061001,420,221,77,343,15532
15000US060710061002,1126,420,613,513,15533
15000US060710061003,2068,575,908,1160,15534
15000US060710061004,1285,32,1015,270,15535
15000US060710061005,1576,318,1174,402,15536
15000US060710061006,1638,662,791,847,15537
15000US060710061007,626,398,99,527,15538
15000US060710062011,726,247,465,261,15539
15000US060710062012,1002,129,828,174,15540
15000US060710062013,1833,362,1323,510,15541
15000US060710062031,2337,216,1166,1171,15542
15000US060710062032,2309,397,1059,1250,15543
15000US060710062041,1782,256,799,983,15544
15000US060710062042,2129,314,952,1177,15545
15000US060710063011,1625,378,906,719,15546
15000US060710063012,911,146,673,238,15547
15000US060710063013,1676,345,1153,523,15548
15000US060710063014,1309,213,899,410,15549
15000US060710063021,2220,481,1314,906,15550
15000US060710063022,1488,145,1101,387,15551
15000US060710063023,3193,259,2563,630,15552
15000US060710063024,1801,284,1417,384,15553
15000US060710063025,681,133,500,181,15554
15000US060710064011,881,10,547,334,15555
15000US060710064012,2512,82,2224,288,15556
15000US060710064021,2789,367,1312,1477,15557
15000US060710064022,2430,247,1829,601,15558
15000US060710065001,1467,192,1068,399,15559
15000US060710065002,1472,192,1105,367,15560
15000US060710065003,2553,104,2202,351,15561
15000US060710065004,2563,447,1310,1253,15562
15000US060710066011,2326,341,1712,614,15563
15000US060710066012,1374,152,1212,162,15564
15000US060710066013,1245,137,1102,143,15565
15000US060710066031,2437,140,2258,179,15566
15000US060710066032,3691,448,2634,1057,15567
15000US060710066041,2208,267,1714,494,15568
15000US060710066042,1675,16,1434,241,15569
15000US060710067001,1456,278,1165,291,15570
15000US060710067002,1108,120,976,132,15571
15000US060710067003,804,116,679,125,15572
15000US060710067004,1056,143,906,150,15573
15000US060710070001,2203,204,1944,259,15574
15000US060710070002,1836,294,1542,294,15575
15000US060710070003,2018,243,1306,712,15576
15000US060710070004,823,148,675,148,15577
15000US060710071041,831,455,285,546,15578
15000US060710071042,911,350,265,646,15579
15000US060710071043,1494,642,564,930,15580
15000US060710071044,896,404,453,443,15581
15000US060710071051,1384,394,654,730,15582
15000US060710071052,1661,747,673,988,15583
15000US060710071061,652,289,313,339,15584
15000US060710071062,769,324,213,556,15585
15000US060710071063,1119,364,679,440,15586
15000US060710071064,1571,689,794,777,15587
15000US060710071071,2411,414,1081,1330,15588
15000US060710071072,833,106,681,152,15589
15000US060710071081,2359,433,1311,1048,15590
15000US060710071091,2007,712,1039,968,15591
15000US060710071092,1520,596,644,876,15592
15000US060710071093,2030,651,937,1093,15593
15000US060710071094,1217,327,614,603,15594
15000US060710071101,1297,405,626,671,15595
15000US060710071102,1789,470,1102,687,15596
15000US060710071103,2155,483,551,1604,15597
15000US060710072001,1527,409,459,1068,15598
15000US060710072002,1513,189,1271,242,15599
15000US060710072003,2421,256,1595,826,15600
15000US060710072004,1566,168,696,870,15601
15000US060710073021,1695,754,300,1395,15602
15000US060710073022,1389,802,191,1198,15603
15000US060710073023,2104,733,334,1770,15604
15000US060710073024,2394,1254,151,2243,15605
15000US060710073025,1521,444,232,1289,15606
15000US060710073026,823,304,128,695,15607
15000US060710073031,1852,98,833,1019,15608
15000US060710073032,1683,438,565,1118,15609
15000US060710073033,1429,736,215,1214,15610
15000US060710073051,3542,855,1608,1934,15611
15000US060710073052,1435,301,446,989,15612
15000US060710073061,2232,865,645,1587,15613
15000US060710073062,3323,565,1223,2100,15614
15000US060710074031,1998,352,1185,813,15615
15000US060710074032,1560,186,877,683,15616
15000US060710074033,1799,197,837,962,15617
15000US060710074034,1630,367,350,1280,15618
15000US060710074035,712,281,398,314,15619
15000US060710074041,670,264,316,354,15620
15000US060710074042,1335,575,563,772,15621
15000US060710074043,718,425,124,594,15622
15000US060710074044,760,533,34,726,15623
15000US060710074045,520,203,176,344,15624
15000US060710074071,1123,83,504,619,15625
15000US060710074072,1208,98,994,214,15626
15000US060710074073,648,100,391,257,15627
15000US060710074081,1529,87,1226,303,15628
15000US060710074082,2574,269,1458,1116,15629
15000US060710074091,2690,726,1641,1049,15630
15000US060710074092,2393,407,1558,835,15631
15000US060710074093,1596,608,659,937,15632
15000US060710074101,765,75,251,514,15633
15000US060710074102,1533,779,386,1147,15634
15000US060710074103,2758,683,1545,1213,15635
15000US060710076011,2395,243,1431,964,15636
15000US060710076012,2464,134,2203,261,15637
15000US060710076013,1676,206,1142,534,15638
15000US060710076014,1165,266,771,394,15639
15000US060710076031,1607,388,804,803,15640
15000US060710076032,1217,450,444,773,15641
15000US060710076033,1975,237,1350,625,15642
15000US060710076041,1043,378,597,446,15643
15000US060710076042,1548,345,552,996,15644
15000US060710076043,2090,595,951,1139,15645
15000US060710078001,1661,952,238,1423,15646
15000US060710078002,2400,1314,526,1874,15647
15000US060710078003,1349,543,553,796,15648
15000US060710079011,694,432,171,523,15649
15000US060710079012,1082,623,125,957,15650
15000US060710079013,1641,973,284,1357,15651
15000US060710079014,4607,2667,930,3677,15652
15000US060710079031,1686,958,369,1317,15653
15000US060710079032,1578,777,435,1143,15654
15000US060710079033,1181,550,463,718,15655
15000US060710079041,1306,713,441,865,15656
15000US060710079042,1880,1182,315,1565,15657
15000US060710079043,4107,1789,1636,2471,15658
15000US060710080011,1344,328,880,464,15659
15000US060710080012,1672,371,1048,624,15660
15000US060710080013,4122,1567,1457,2665,15661
15000US060710080021,497,101,16,481,15662
15000US060710080022,662,30,573,89,15663
15000US060710080023,939,102,606,333,15664
15000US060710080024,2279,579,1490,789,15665
15000US060710080025,1331,13,1258,73,15666
15000US060710080026,1636,233,1107,529,15667
15000US060710081001,1028,648,227,801,15668
15000US060710081002,2485,612,944,1541,15669
15000US060710082001,1865,885,528,1337,15670
15000US060710082002,1509,1336,116,1393,15671
15000US060710082003,778,598,139,639,15672
15000US060710082004,1431,1162,210,1221,15673
15000US060710083011,956,564,376,580,15674
15000US060710083012,933,797,111,822,15675
15000US060710083013,1655,1178,66,1589,15676
15000US060710083014,1402,926,333,1069,15677
15000US060710083015,1454,851,296,1158,15678
15000US060710083021,793,586,91,702,15679
15000US060710083022,921,647,117,804,15680
15000US060710083023,1269,1000,135,1134,15681
15000US060710084011,2079,377,1119,960,15682
15000US060710084012,1998,540,424,1574,15683
15000US060710084013,2018,1156,744,1274,15684
15000US060710084014,1072,586,231,841,15685
15000US060710084015,2976,1729,671,2305,15686
15000US060710084021,957,670,281,676,15687
15000US060710084022,2692,1813,603,2089,15688
15000US060710084023,1459,1032,377,1082,15689
15000US060710084024,1474,758,580,894,15690
15000US060710084031,1340,900,142,1198,15691
15000US060710084032,1683,1364,121,1562,15692
15000US060710084033,1709,1128,257,1452,15693
15000US060710084034,1058,606,386,672,15694
15000US060710084041,614,307,281,333,15695
15000US060710084042,1966,519,1001,965,15696
15000US060710085001,2877,2220,105,2772,15697
15000US060710085002,917,577,268,649,15698
15000US060710085003,2320,1895,155,2165,15699
15000US060710085004,1538,1166,196,1342,15700
15000US060710085005,605,453,151,454,15701
15000US060710086011,1118,699,360,758,15702
15000US060710086012,1380,599,525,855,15703
15000US060710086013,2077,1277,608,1469,15704
15000US060710086014,1992,1148,543,1449,15705
15000US060710086021,1939,964,563,1376,15706
15000US060710086022,1844,1117,604,1240,15707
15000US060710087031,2033,1257,709,1324,15708
15000US060710087032,1361,853,377,984,15709
15000US060710087033,2342,1819,358,1984,15710
15000US060710087034,1549,1249,227,1322,15711
15000US060710087041,1654,913,337,1317,15712
15000US060710087042,1754,860,865,889,15713
15000US060710087043,1219,743,461,758,15714
15000US060710087044,2628,1852,712,1916,15715
15000US060710087045,1186,447,739,447,15716
15000US060710087051,1456,685,616,840,15717
15000US060710087052,1016,624,382,634,15718
15000US060710087053,1318,592,667,651,15719
15000US060710087054,1321,707,597,724,15720
15000US060710087061,2133,1128,1002,1131,15721
15000US060710087062,4403,3045,1018,3385,15722
15000US060710087063,4190,1945,1389,2801,15723
15000US060710087064,1152,1067,85,1067,15724
15000US060710087065,1493,783,321,1172,15725
15000US060710087081,1374,852,496,878,15726
15000US060710087082,1708,1302,350,1358,15727
15000US060710087083,1191,979,121,1070,15728
15000US060710087091,432,280,122,310,15729
15000US060710087092,1195,672,420,775,15730
15000US060710087093,1086,475,592,494,15731
15000US060710087094,1156,863,271,885,15732
15000US060710087101,1361,522,823,538,15733
15000US060710087102,2540,1471,1019,1521,15734
15000US060710087103,1224,676,375,849,15735
15000US060710088001,1162,542,584,578,15736
15000US060710088002,2308,1310,998,1310,15737
15000US060710088003,1920,1195,592,1328,15738
15000US060710088004,670,370,261,409,15739
15000US060710089011,730,607,36,694,15740
15000US060710089012,394,380,4,390,15741
15000US060710089013,866,654,167,699,15742
15000US060710091071,2715,1762,702,2013,15743
15000US060710091072,1623,947,661,962,15744
15000US060710091073,2458,1338,1102,1356,15745
15000US060710091081,2314,901,1353,961,15746
15000US060710091082,2272,1039,852,1420,15747
15000US060710091083,2217,1680,366,1851,15748
15000US060710091091,2086,721,889,1197,15749
15000US060710091092,1474,1148,200,1274,15750
15000US060710091093,1242,1151,91,1151,15751
15000US060710091094,1613,1196,392,1221,15752
15000US060710091101,11305,1963,5567,5738,15753
15000US060710091102,6185,1325,3652,2533,15754
15000US060710091121,8933,981,6014,2919,15755
15000US060710091141,6335,659,4191,2144,15756
15000US060710091142,3816,727,1982,1834,15757
15000US060710091161,1138,184,831,307,15758
15000US060710091162,1633,281,1041,592,15759
15000US060710091163,3233,830,1320,1913,15760
15000US060710091164,1634,257,985,649,15761
15000US060710091171,5391,1335,3217,2174,15762
15000US060710091172,733,417,233,500,15763
15000US060710091173,992,238,638,354,15764
15000US060710091181,3476,1361,1640,1836,15765
15000US060710091182,7917,1595,4138,3779,15766
15000US060710091183,13191,2629,7714,5477,15767
15000US060710091191,1624,867,692,932,15768
15000US060710091192,1854,1210,472,1382,15769
15000US060710091193,1990,1471,492,1498,15770
15000US060710092011,1495,1184,301,1194,15771
15000US060710092012,1477,1151,157,1320,15772
15000US060710092013,1538,1359,159,1379,15773
15000US060710092021,1445,934,292,1153,15774
15000US060710092022,979,601,349,630,15775
15000US060710093001,1476,621,707,769,15776
15000US060710094001,1702,319,848,854,15777
15000US060710094002,2138,419,978,1160,15778
15000US060710095001,2094,596,948,1146,15779
15000US060710095002,1139,401,710,429,15780
15000US060710095003,1355,381,726,629,15781
15000US060710095004,2036,620,566,1470,15782
15000US060710095005,989,477,448,541,15783
15000US060710097071,3043,2419,350,2693,15784
15000US060710097072,2837,1542,890,1947,15785
15000US060710097081,1311,788,492,819,15786
15000US060710097082,2525,1794,586,1939,15787
15000US060710097083,1088,902,140,948,15788
15000US060710097091,3260,1642,1253,2007,15789
15000US060710097092,797,625,118,679,15790
15000US060710097093,2383,1023,1066,1317,15791
15000US060710097101,3973,1466,1747,2226,15792
15000US060710097102,1841,449,1012,829,15793
15000US060710097103,1122,413,374,748,15794
15000US060710097111,2944,1872,792,2152,15795
15000US060710097112,2807,1969,439,2368,15796
15000US060710097113,1728,824,812,916,15797
15000US060710097114,2348,1287,665,1683,15798
15000US060710097121,1313,372,810,503,15799
15000US060710097122,1837,907,706,1131,15800
15000US060710097123,1279,615,543,736,15801
15000US060710097124,1884,711,990,894,15802
15000US060710097131,1572,554,858,714,15803
15000US060710097132,1370,893,311,1059,15804
15000US060710097133,2678,1515,838,1840,15805
15000US060710097134,1186,450,544,642,15806
15000US060710097141,1237,802,319,918,15807
15000US060710097142,1057,556,429,628,15808
15000US060710097143,1565,641,719,846,15809
15000US060710097151,1411,932,282,1129,15810
15000US060710097152,2615,1038,1325,1290,15811
15000US060710097153,1392,964,290,1102,15812
15000US060710097154,1622,934,358,1264,15813
15000US060710097155,1767,1204,309,1458,15814
15000US060710097161,3413,2179,1044,2369,15815
15000US060710097162,2208,779,867,1341,15816
15000US060710097163,1704,627,662,1042,15817
15000US060710097171,1925,1076,713,1212,15818
15000US060710097172,2653,1653,638,2015,15819
15000US060710098001,885,165,632,253,15820
15000US060710098002,813,151,592,221,15821
15000US060710098003,1747,203,1253,494,15822
15000US060710098004,1128,235,689,439,15823
15000US060710099041,1942,427,930,1012,15824
15000US060710099042,2487,660,1306,1181,15825
15000US060710099043,7943,1439,5170,2773,15826
15000US060710099051,3630,447,2426,1204,15827
15000US060710099052,1657,225,662,995,15828
15000US060710099053,2608,928,1185,1423,15829
15000US060710099061,1494,479,455,1039,15830
15000US060710099062,2979,772,1276,1703,15831
15000US060710099081,2803,684,1567,1236,15832
15000US060710099082,2130,907,912,1218,15833
15000US060710099101,2043,645,714,1329,15834
15000US060710099102,3474,774,2446,1028,15835
15000US060710099111,4395,739,2404,1991,15836
15000US060710099112,2372,770,1145,1227,15837
15000US060710099121,1831,190,554,1277,15838
15000US060710099122,1639,638,521,1118,15839
15000US060710099123,1470,521,617,853,15840
15000US060710099131,2532,927,1360,1172,15841
15000US060710099132,2848,600,1917,931,15842
15000US060710100041,1112,956,45,1067,15843
15000US060710100042,1553,1108,229,1324,15844
15000US060710100043,868,693,106,762,15845
15000US060710100044,2380,1627,465,1915,15846
15000US060710100045,1838,1184,555,1283,15847
15000US060710100091,1848,445,1056,792,15848
15000US060710100092,1607,581,945,662,15849
15000US060710100101,1339,371,900,439,15850
15000US060710100102,1532,325,1049,483,15851
15000US060710100103,2418,603,1478,940,15852
15000US060710100104,1943,511,1397,546,15853
15000US060710100111,1384,458,874,510,15854
15000US060710100112,2406,342,1899,507,15855
15000US060710100113,1468,263,979,489,15856
15000US060710100121,1010,399,465,545,15857
15000US060710100122,1746,863,820,926,15858
15000US060710100123,1910,1001,852,1058,15859
15000US060710100131,1599,698,813,786,15860
15000US060710100132,1878,816,1045,833,15861
15000US060710100133,1884,781,885,999,15862
15000US060710100134,2340,367,1759,581,15863
15000US060710100141,891,405,413,478,15864
15000US060710100142,2102,492,1369,733,15865
15000US060710100143,1849,181,1521,328,15866
15000US060710100151,3215,1080,1849,1366,15867
15000US060710100152,2887,1058,1747,1140,15868
15000US060710100161,3169,886,1936,1233,15869
15000US060710100162,2519,794,1620,899,15870
15000US060710100171,1820,1184,531,1289,15871
15000US060710100172,10996,3424,5399,5597,15872
15000US060710100173,3117,1453,1106,2011,15873
15000US060710100181,4284,1213,2409,1875,15874
15000US060710100182,2922,1249,1543,1379,15875
15000US060710100191,2052,658,1223,829,15876
15000US060710100192,1951,736,1199,752,15877
15000US060710100193,1359,640,695,664,15878
15000US060710100201,1910,550,1196,714,15879
15000US060710100202,3113,763,1573,1540,15880
15000US060710100203,2777,1026,1410,1367,15881
15000US060710100211,1674,813,842,832,15882
15000US060710100212,2452,978,1112,1340,15883
15000US060710100213,2378,1341,904,1474,15884
15000US060710100221,2626,1337,1197,1429,15885
15000US060710100222,1683,1105,507,1176,15886
15000US060710100231,2584,1104,1338,1246,15887
15000US060710100232,3441,1696,1532,1909,15888
15000US060710100241,998,321,633,365,15889
15000US060710100242,2413,1823,545,1868,15890
15000US060710100243,2174,1191,859,1315,15891
15000US060710100251,3489,970,1575,1914,15892
15000US060710100252,4531,1080,2473,2058,15893
15000US060710100261,6681,1982,2873,3808,15894
15000US060710100262,3843,1146,1913,1930,15895
15000US060710103001,796,244,499,297,15896
15000US060710103002,1369,993,149,1220,15897
15000US060710103003,537,361,163,374,15898
15000US060710103004,812,445,140,672,15899
15000US060710104021,9341,5527,2168,7173,15900
15000US060710104091,1787,1116,405,1382,15901
15000US060710104092,900,765,0,900,15902
15000US060710104101,1906,1513,270,1636,15903
15000US060710104102,1351,907,359,992,15904
15000US060710104111,889,793,81,808,15905
15000US060710104112,3629,2382,542,3087,15906
15000US060710104113,1083,624,344,739,15907
15000US060710104114,1079,697,56,1023,15908
15000US060710104121,2490,1476,493,1997,15909
15000US060710104122,1074,1046,0,1074,15910
15000US060710104123,4416,3328,662,3754,15911
15000US060710104131,2231,1376,727,1504,15912
15000US060710104132,796,697,85,711,15913
15000US060710104133,1683,978,363,1320,15914
15000US060710104134,1714,1124,341,1373,15915
15000US060710104151,1284,815,208,1076,15916
15000US060710104152,2953,1999,256,2697,15917
15000US060710104153,1575,904,548,1027,15918
15000US060710104161,1780,1100,313,1467,15919
15000US060710104162,635,546,41,594,15920
15000US060710104163,1040,785,195,845,15921
15000US060710104171,1557,1323,207,1350,15922
15000US060710104172,729,484,245,484,15923
15000US060710104173,540,491,35,505,15924
15000US060710104191,1749,1146,531,1218,15925
15000US060710104192,1020,841,97,923,15926
15000US060710104193,1824,967,513,1311,15927
15000US060710104201,1198,837,243,955,15928
15000US060710104202,1114,844,228,886,15929
15000US060710104203,1321,797,378,943,15930
15000US060710104211,2297,1642,118,2179,15931
15000US060710104212,3970,1288,1636,2334,15932
15000US060710104221,356,177,106,250,15933
15000US060710104222,1265,861,227,1038,15934
15000US060710104231,1309,913,242,1067,15935
15000US060710104232,1382,1131,192,1190,15936
15000US060710104233,792,620,96,696,15937
15000US060710104241,548,431,92,456,15938
15000US060710104242,1330,1177,126,1204,15939
15000US060710107001,617,357,210,407,15940
15000US060710107002,1633,1132,249,1384,15941
15000US060710107003,1684,1042,492,1192,15942
15000US060710108021,1690,1061,453,1237,15943
15000US060710108022,716,559,116,600,15944
15000US060710108023,831,787,31,800,15945
15000US060710108024,622,468,121,501,15946
15000US060710108025,1199,896,102,1097,15947
15000US060710108031,648,509,114,534,15948
15000US060710108032,371,245,94,277,15949
15000US060710108033,795,733,62,733,15950
15000US060710108034,841,545,273,568,15951
15000US060710108041,974,745,178,796,15952
15000US060710108042,1216,741,404,812,15953
15000US060710108043,316,279,19,297,15954
15000US060710109011,721,685,36,685,15955
15000US060710109012,471,328,23,448,15956
15000US060710109013,2570,1964,425,2145,15957
15000US060710109014,407,364,0,407,15958
15000US060710109015,763,687,76,687,15959
15000US060710109021,872,765,107,765,15960
15000US060710109022,417,365,16,401,15961
15000US060710109023,451,409,42,409,15962
15000US060710109024,928,598,134,794,15963
15000US060710109025,495,257,223,272,15964
15000US060710110011,653,403,213,440,15965
15000US060710110012,801,460,300,501,15966
15000US060710110013,920,568,222,698,15967
15000US060710110021,960,329,486,474,15968
15000US060710110022,700,507,177,523,15969
15000US060710111011,853,746,18,835,15970
15000US060710111012,992,907,85,907,15971
15000US060710111013,756,584,132,624,15972
15000US060710111014,978,693,157,821,15973
15000US060710111021,811,570,132,679,15974
15000US060710111022,786,642,44,742,15975
15000US060710111023,209,209,0,209,15976
15000US060710112031,752,626,58,694,15977
15000US060710112032,483,421,57,426,15978
15000US060710112041,278,210,68,210,15979
15000US060710112042,442,353,34,408,15980
15000US060710112043,550,463,79,471,15981
15000US060710112051,426,323,83,343,15982
15000US060710112052,1136,611,476,660,15983
15000US060710112061,424,302,103,321,15984
15000US060710112062,740,533,175,565,15985
15000US060710113001,217,205,12,205,15986
15000US060710113002,939,681,238,701,15987
15000US060710114011,1608,1355,120,1488,15988
15000US060710114012,1735,1172,503,1232,15989
15000US060710114013,593,463,130,463,15990
15000US060710114014,1551,905,627,924,15991
15000US060710114031,767,594,173,594,15992
15000US060710114032,862,657,139,723,15993
15000US060710114033,932,884,37,895,15994
15000US060710114034,743,500,207,536,15995
15000US060710114041,1995,1516,440,1555,15996
15000US060710114042,2157,1742,260,1897,15997
15000US060710115001,752,620,75,677,15998
15000US060710115002,1427,1130,240,1187,15999
15000US060710116001,1990,1004,896,1094,16000
15000US060710116002,4543,2807,1088,3455,16001
15000US060710116003,2082,1567,253,1829,16002
15000US060710117001,1489,600,783,706,16003
15000US060710118001,1479,487,420,1059,16004
15000US060710118002,1084,517,439,645,16005
15000US060710118003,2885,922,1901,984,16006
15000US060710118004,1836,824,870,966,16007
15000US060710119001,638,527,100,538,16008
15000US060710119002,385,174,159,226,16009
15000US060710119003,1447,868,544,903,16010
15000US060710119004,1188,427,510,678,16011
15000US060710120011,1777,669,738,1039,16012
15000US060710120012,2424,853,809,1615,16013
15000US060710120013,1425,363,823,602,16014
15000US060710120021,192,161,31,161,16015
15000US060710120022,968,315,550,418,16016
15000US060710120023,992,352,432,560,16017
15000US060710120024,3229,835,1489,1740,16018
15000US060710121011,643,353,225,418,16019
15000US060710121012,4031,2331,1036,2995,16020
15000US060710121013,700,241,227,473,16021
15000US060710121031,1350,1106,166,1184,16022
15000US060710121032,2462,1630,532,1930,16023
15000US060710121041,1959,1236,607,1352,16024
15000US060710121042,2611,2050,348,2263,16025
15000US060710122001,15970,3921,5521,10449,16026
15000US060710123001,4400,1642,1269,3131,16027
15000US060710124001,1562,208,1202,360,16028
15000US060710124002,810,95,664,146,16029
15000US060710124003,962,55,862,100,16030
15000US060710125001,1255,41,1193,62,16031
15000US060710125002,1537,18,1519,18,16032
15000US060710125003,949,66,822,127,16033
15000US060710125004,1241,119,882,359,16034
15000US060710127001,1593,587,616,977,16035
15000US060710127002,2187,535,1339,848,16036
15000US060710250001,9337,4467,2160,7177,16037
15000US060710251001,906,428,139,767,16038
15000US060710251002,532,168,116,416,16039
15000US060719401001,523,414,72,451,16040
15000US060719401002,809,643,112,697,16041
15000US060719801001,0,0,0,0,16042
15000US060719802001,4364,572,2311,2053,16043
15000US060730001001,1219,1062,102,1117,16044
15000US060730001002,1554,1214,188,1366,16045
15000US060730002011,2158,1628,389,1769,16046
15000US060730002021,1477,1216,195,1282,16047
15000US060730002022,757,698,42,715,16048
15000US060730002023,2594,1563,530,2064,16049
15000US060730003001,456,271,96,360,16050
15000US060730003002,907,318,379,528,16051
15000US060730003003,1406,1176,105,1301,16052
15000US060730003004,1236,867,239,997,16053
15000US060730003005,941,805,67,874,16054
15000US060730004001,1953,1245,371,1582,16055
15000US060730004002,742,470,150,592,16056
15000US060730004003,1221,940,128,1093,16057
15000US060730005001,798,674,110,688,16058
15000US060730005002,1181,875,215,966,16059
15000US060730005003,978,579,195,783,16060
15000US060730006001,818,420,262,556,16061
15000US060730006002,1132,790,259,873,16062
15000US060730006003,971,640,154,817,16063
15000US060730007001,1572,1092,323,1249,16064
15000US060730007002,1838,1404,325,1513,16065
15000US060730007003,1097,872,125,972,16066
15000US060730008001,626,491,106,520,16067
15000US060730008002,766,451,197,569,16068
15000US060730008003,1080,669,278,802,16069
15000US060730008004,1760,1073,244,1516,16070
15000US060730009001,1351,747,390,961,16071
15000US060730009002,898,378,343,555,16072
15000US060730009003,872,355,245,627,16073
15000US060730009004,705,521,71,634,16074
15000US060730009005,869,449,263,606,16075
15000US060730009006,1101,348,470,631,16076
15000US060730010001,1370,807,192,1178,16077
15000US060730010002,1288,680,488,800,16078
15000US060730010003,1519,1013,384,1135,16079
15000US060730010004,1151,587,256,895,16080
15000US060730011001,1166,862,133,1033,16081
15000US060730011002,1415,848,462,953,16082
15000US060730011003,775,340,228,547,16083
15000US060730012001,1340,596,613,727,16084
15000US060730012002,1425,594,733,692,16085
15000US060730012003,1728,852,556,1172,16086
15000US060730012004,1490,897,389,1101,16087
15000US060730013001,784,266,180,604,16088
15000US060730013002,2039,1146,385,1654,16089
15000US060730013003,1281,496,488,793,16090
15000US060730013004,989,513,222,767,16091
15000US060730013005,1438,500,570,868,16092
15000US060730014001,483,359,58,425,16093
15000US060730014002,620,458,104,516,16094
15000US060730014003,2095,1312,468,1627,16095
15000US060730015001,1400,624,658,742,16096
15000US060730015002,946,444,435,511,16097
15000US060730015003,836,706,70,766,16098
15000US060730015004,712,287,165,547,16099
15000US060730016001,1397,191,1009,388,16100
15000US060730016002,1627,422,760,867,16101
15000US060730016003,1083,175,761,322,16102
15000US060730016004,905,420,163,742,16103
15000US060730017001,2040,493,1048,992,16104
15000US060730017002,1050,467,514,536,16105
15000US060730017003,879,363,389,490,16106
15000US060730017004,599,303,41,558,16107
15000US060730018001,786,364,339,447,16108
15000US060730018002,1417,678,678,739,16109
15000US060730018003,628,139,87,541,16110
15000US060730018004,739,311,154,585,16111
15000US060730018005,907,499,313,594,16112
15000US060730018006,758,451,155,603,16113
15000US060730019001,1197,795,289,908,16114
15000US060730019002,1432,987,256,1176,16115
15000US060730019003,692,454,119,573,16116
15000US060730020011,975,786,37,938,16117
15000US060730020012,1569,1420,30,1539,16118
15000US060730020013,917,603,292,625,16119
15000US060730020021,1090,786,22,1068,16120
15000US060730020022,1566,1161,274,1292,16121
15000US060730021001,1158,557,110,1048,16122
15000US060730021002,1065,595,323,742,16123
15000US060730021003,811,255,474,337,16124
15000US060730021004,927,302,467,460,16125
15000US060730021005,919,456,122,797,16126
15000US060730022011,1607,174,602,1005,16127
15000US060730022012,1964,145,1320,644,16128
15000US060730022021,1624,91,1206,418,16129
15000US060730022022,2616,212,1812,804,16130
15000US060730022023,1093,34,754,339,16131
15000US060730023011,932,289,429,503,16132
15000US060730023012,1202,217,492,710,16133
15000US060730023013,922,141,400,522,16134
15000US060730023021,3187,498,981,2206,16135
15000US060730023022,1960,65,1215,745,16136
15000US060730023023,2321,64,1739,582,16137
15000US060730024011,1283,170,936,347,16138
15000US060730024012,1985,663,1061,924,16139
15000US060730024013,1490,440,590,900,16140
15000US060730024021,2893,117,2049,844,16141
15000US060730024022,2214,191,1539,675,16142
15000US060730025011,2921,259,2051,870,16143
15000US060730025012,1457,360,676,781,16144
15000US060730025013,1728,110,1249,479,16145
15000US060730025021,2756,856,1217,1539,16146
15000US060730025022,2641,432,1455,1186,16147
15000US060730025023,929,349,389,540,16148
15000US060730026011,2350,180,1832,518,16149
15000US060730026012,1608,34,1110,498,16150
15000US060730026013,1705,268,1009,696,16151
15000US060730026021,1163,134,608,555,16152
15000US060730026022,1544,102,1050,494,16153
15000US060730026023,1479,109,1072,407,16154
15000US060730027021,1337,517,302,1035,16155
15000US060730027022,1787,634,608,1179,16156
15000US060730027023,2848,792,707,2141,16157
15000US060730027031,2539,906,1090,1449,16158
15000US060730027032,1505,344,652,853,16159
15000US060730027033,1859,339,1275,584,16160
15000US060730027034,1487,323,328,1159,16161
15000US060730027051,2754,220,865,1889,16162
15000US060730027052,2003,260,723,1280,16163
15000US060730027071,1762,8,1182,580,16164
15000US060730027072,901,23,437,464,16165
15000US060730027073,974,14,776,198,16166
15000US060730027074,1965,83,1215,750,16167
15000US060730027081,1446,190,680,766,16168
15000US060730027082,395,22,271,124,16169
15000US060730027083,2024,70,972,1052,16170
15000US060730027084,2049,0,1416,633,16171
15000US060730027091,2315,144,1191,1124,16172
15000US060730027092,1598,264,818,780,16173
15000US060730027101,1528,155,868,660,16174
15000US060730027102,2996,190,868,2128,16175
15000US060730027111,1817,493,531,1286,16176
15000US060730027112,1579,296,508,1071,16177
15000US060730027121,1550,563,543,1007,16178
15000US060730027122,1486,89,357,1129,16179
15000US060730027123,1799,101,762,1037,16180
15000US060730028011,1828,991,395,1433,16181
15000US060730028012,1376,798,280,1096,16182
15000US060730028031,1514,548,511,1003,16183
15000US060730028032,2106,437,955,1151,16184
15000US060730028033,614,478,0,614,16185
15000US060730028034,1261,822,213,1048,16186
15000US060730028041,2499,1666,244,2255,16187
15000US060730028042,1718,1325,269,1449,16188
15000US060730028043,976,585,256,720,16189
15000US060730029021,2761,1746,215,2546,16190
15000US060730029022,4415,1228,2141,2274,16191
15000US060730029031,1460,369,628,832,16192
15000US060730029032,1233,473,470,763,16193
15000US060730029033,1432,641,285,1147,16194
15000US060730029041,3051,1924,431,2620,16195
15000US060730029042,3368,2092,626,2742,16196
15000US060730029043,1182,504,265,917,16197
15000US060730029044,844,337,174,670,16198
15000US060730029051,1609,378,252,1357,16199
15000US060730029052,1119,348,458,661,16200
15000US060730029053,1955,971,275,1680,16201
15000US060730030011,670,77,119,551,16202
15000US060730030012,2039,46,1438,601,16203
15000US060730030013,1713,167,972,741,16204
15000US060730030031,1851,359,745,1106,16205
15000US060730030032,1906,554,1028,878,16206
15000US060730030033,1394,371,788,606,16207
15000US060730030041,2356,74,1788,568,16208
15000US060730030042,2760,277,1768,992,16209
15000US060730031011,792,55,553,239,16210
15000US060730031012,1243,26,573,670,16211
15000US060730031013,1811,70,936,875,16212
15000US060730031031,2570,215,840,1730,16213
15000US060730031032,2185,119,954,1231,16214
15000US060730031033,1804,96,969,835,16215
15000US060730031051,2833,336,1769,1064,16216
15000US060730031052,1540,55,1236,304,16217
15000US060730031071,3393,799,1329,2064,16218
15000US060730031072,1996,161,520,1476,16219
15000US060730031073,1037,103,407,630,16220
15000US060730031081,2479,605,1452,1027,16221
15000US060730031082,1402,309,811,591,16222
15000US060730031091,1051,139,68,983,16223
15000US060730031092,1266,59,131,1135,16224
15000US060730031093,1056,174,90,966,16225
15000US060730031111,2553,14,2356,197,16226
15000US060730031112,2219,59,1320,899,16227
15000US060730031113,2448,101,373,2075,16228
15000US060730031121,1986,251,989,997,16229
15000US060730031122,2592,214,933,1659,16230
15000US060730031131,2478,126,435,2043,16231
15000US060730031132,3157,295,522,2635,16232
15000US060730031141,1405,70,282,1123,16233
15000US060730031142,2363,198,292,2071,16234
15000US060730031151,2348,236,1353,995,16235
15000US060730031152,1566,189,569,997,16236
15000US060730031153,942,225,160,782,16237
15000US060730031154,2211,135,433,1778,16238
15000US060730032011,1535,128,262,1273,16239
15000US060730032012,1772,195,1033,739,16240
15000US060730032013,2114,775,335,1779,16241
15000US060730032021,1887,285,1294,593,16242
15000US060730032022,2826,500,2039,787,16243
15000US060730032041,1650,673,743,907,16244
15000US060730032042,2069,358,1486,583,16245
15000US060730032071,2497,405,1663,834,16246
15000US060730032072,1495,519,824,671,16247
15000US060730032073,2514,546,1467,1047,16248
15000US060730032081,1516,29,904,612,16249
15000US060730032082,663,47,45,618,16250
15000US060730032083,1401,88,495,906,16251
15000US060730032084,910,28,18,892,16252
15000US060730032085,2351,135,1342,1009,16253
15000US060730032091,2790,105,644,2146,16254
15000US060730032092,1339,147,742,597,16255
15000US060730032093,1292,203,311,981,16256
15000US060730032111,2024,396,1229,795,16257
15000US060730032112,1472,150,779,693,16258
15000US060730032121,1215,125,399,816,16259
15000US060730032122,2500,625,1220,1280,16260
15000US060730032131,2263,190,342,1921,16261
15000US060730032132,2185,180,864,1321,16262
15000US060730032141,2025,302,657,1368,16263
15000US060730032142,1745,377,791,954,16264
15000US060730032143,1508,252,489,1019,16265
15000US060730033011,1692,13,1321,371,16266
15000US060730033012,1748,83,1059,689,16267
15000US060730033031,1846,313,1327,519,16268
15000US060730033032,2756,100,1890,866,16269
15000US060730033041,1962,63,909,1053,16270
15000US060730033042,2350,107,1869,481,16271
15000US060730033051,996,86,188,808,16272
15000US060730033052,2292,16,1500,792,16273
15000US060730033053,2625,46,1675,950,16274
15000US060730034011,2793,172,1241,1552,16275
15000US060730034012,1070,279,128,942,16276
15000US060730034013,1093,326,271,822,16277
15000US060730034014,1901,659,418,1483,16278
15000US060730034031,904,67,664,240,16279
15000US060730034032,1425,73,1069,356,16280
15000US060730034033,1254,17,929,325,16281
15000US060730034041,1996,152,1443,553,16282
15000US060730034042,3213,221,1990,1223,16283
15000US060730035011,2518,168,2225,293,16284
15000US060730035012,1103,16,974,129,16285
15000US060730035013,1393,68,1207,186,16286
15000US060730035021,704,0,529,175,16287
15000US060730035022,2114,153,1729,385,16288
15000US060730035023,2062,67,1780,282,16289
15000US060730036011,2839,64,2656,183,16290
15000US060730036021,1827,18,1531,296,16291
15000US060730036022,1571,43,1402,169,16292
15000US060730036031,2298,15,2278,20,16293
15000US060730036032,1515,77,1101,414,16294
15000US060730036033,726,114,421,305,16295
15000US060730038001,6640,3424,1221,5419,16296
15000US060730039011,1372,35,1185,187,16297
15000US060730039012,1391,0,1243,148,16298
15000US060730039013,1524,19,1333,191,16299
15000US060730039021,1169,27,1093,76,16300
15000US060730039022,1402,5,1172,230,16301
15000US060730039023,1555,87,1381,174,16302
15000US060730039024,685,16,658,27,16303
15000US060730040001,1777,34,1696,81,16304
15000US060730040002,722,75,551,171,16305
15000US060730040003,1713,78,1406,307,16306
15000US060730040004,982,51,793,189,16307
15000US060730041001,1000,217,595,405,16308
15000US060730041002,1756,707,799,957,16309
15000US060730041003,2206,494,1287,919,16310
15000US060730041004,2299,803,1174,1125,16311
15000US060730042001,2359,1026,881,1478,16312
15000US060730042002,2137,1444,535,1602,16313
15000US060730042003,689,689,0,689,16314
15000US060730042004,895,552,325,570,16315
15000US060730043001,588,321,247,341,16316
15000US060730043002,2005,1396,385,1620,16317
15000US060730043003,1277,687,432,845,16318
15000US060730044001,1015,660,204,811,16319
15000US060730044002,1349,819,432,917,16320
15000US060730044003,907,539,275,632,16321
15000US060730044004,743,490,158,585,16322
15000US060730045011,1512,557,702,810,16323
15000US060730045012,639,189,410,229,16324
15000US060730045013,532,191,268,264,16325
15000US060730046001,1344,674,307,1037,16326
15000US060730046002,533,311,94,439,16327
15000US060730047001,863,166,634,229,16328
15000US060730047002,1075,114,896,179,16329
15000US060730048001,1403,53,1092,311,16330
15000US060730048002,1693,112,1548,145,16331
15000US060730048003,1058,158,839,219,16332
15000US060730049001,1490,53,1273,217,16333
15000US060730049002,1615,153,1462,153,16334
15000US060730049003,2372,120,2151,221,16335
15000US060730050001,2528,175,2200,328,16336
15000US060730051001,1645,544,851,794,16337
15000US060730051002,4998,2502,1407,3591,16338
15000US060730052001,2881,1180,729,2152,16339
15000US060730052002,2927,1659,495,2432,16340
15000US060730053001,750,469,186,564,16341
15000US060730053002,1074,688,65,1009,16342
15000US060730053003,2420,765,1198,1222,16343
15000US060730053004,1217,949,79,1138,16344
15000US060730054001,630,562,68,562,16345
15000US060730054002,2576,1514,455,2121,16346
15000US060730054003,925,495,77,848,16347
15000US060730054004,3124,2115,380,2744,16348
15000US060730055001,216,114,52,164,16349
15000US060730056001,2486,1585,506,1980,16350
15000US060730056002,1791,1443,192,1599,16351
15000US060730057001,502,272,149,353,16352
15000US060730057002,1139,637,177,962,16353
15000US060730058001,3078,2542,351,2727,16354
15000US060730059001,1320,836,386,934,16355
15000US060730059002,934,559,260,674,16356
15000US060730059003,922,684,128,794,16357
15000US060730060001,1052,964,19,1033,16358
15000US060730060002,1199,751,166,1033,16359
15000US060730060003,1630,1340,163,1467,16360
15000US060730061001,1785,1167,253,1532,16361
15000US060730061002,580,364,119,461,16362
15000US060730062001,23,10,6,17,16363
15000US060730063001,3335,1949,890,2445,16364
15000US060730065001,1064,719,110,954,16365
15000US060730065002,853,495,229,624,16366
15000US060730065003,1050,509,445,605,16367
15000US060730066001,1726,773,366,1360,16368
15000US060730068011,2404,1811,229,2175,16369
15000US060730068021,1860,818,610,1250,16370
15000US060730068022,2280,1458,421,1859,16371
15000US060730068023,1486,1051,299,1187,16372
15000US060730069001,3491,2348,660,2831,16373
15000US060730069002,917,644,201,716,16374
15000US060730069003,1252,917,302,950,16375
15000US060730070021,1749,1317,269,1480,16376
15000US060730070022,765,580,127,638,16377
15000US060730070023,583,539,25,558,16378
15000US060730071001,1369,1294,49,1320,16379
15000US060730071002,2506,1976,351,2155,16380
15000US060730071003,836,651,113,723,16381
15000US060730072001,2296,1868,207,2089,16382
15000US060730072002,3844,2986,453,3391,16383
15000US060730073011,1089,815,235,854,16384
15000US060730073012,1421,1168,223,1198,16385
15000US060730073013,1704,1446,178,1526,16386
15000US060730073014,664,562,90,574,16387
15000US060730073021,580,513,48,532,16388
15000US060730073022,823,748,52,771,16389
15000US060730073023,719,633,36,683,16390
15000US060730074001,1040,741,240,800,16391
15000US060730074002,1254,950,183,1071,16392
15000US060730074003,1082,929,63,1019,16393
15000US060730074004,1383,1064,113,1270,16394
15000US060730074005,1078,617,383,695,16395
15000US060730074006,905,858,47,858,16396
15000US060730075011,785,624,85,700,16397
15000US060730075012,668,561,96,572,16398
15000US060730075013,975,611,255,720,16399
15000US060730075014,958,736,204,754,16400
15000US060730075015,630,436,143,487,16401
15000US060730075021,994,793,140,854,16402
15000US060730075022,852,637,188,664,16403
15000US060730075023,1184,921,167,1017,16404
15000US060730076001,658,414,231,427,16405
15000US060730076002,1009,863,78,931,16406
15000US060730076003,743,687,0,743,16407
15000US060730076004,519,458,13,506,16408
15000US060730076005,728,688,0,728,16409
15000US060730076006,503,468,35,468,16410
15000US060730076007,452,418,0,452,16411
15000US060730077011,1400,1315,40,1360,16412
15000US060730077012,856,740,60,796,16413
15000US060730077013,1766,1343,342,1424,16414
15000US060730077021,819,706,60,759,16415
15000US060730077022,1385,1302,34,1351,16416
15000US060730077023,956,837,119,837,16417
15000US060730077024,754,618,136,618,16418
15000US060730078001,1974,1051,910,1064,16419
15000US060730078002,829,545,82,747,16420
15000US060730078003,1818,988,524,1294,16421
15000US060730078004,506,506,0,506,16422
15000US060730078005,917,719,17,900,16423
15000US060730079031,919,601,167,752,16424
15000US060730079032,1639,1463,46,1593,16425
15000US060730079033,775,590,159,616,16426
15000US060730079034,1002,859,106,896,16427
15000US060730079051,1362,991,323,1039,16428
15000US060730079052,1685,1609,28,1657,16429
15000US060730079071,1847,1414,258,1589,16430
15000US060730079072,1622,1118,410,1212,16431
15000US060730079081,612,375,187,425,16432
15000US060730079082,2617,1707,775,1842,16433
15000US060730079101,1366,1137,117,1249,16434
15000US060730079102,1683,1409,104,1579,16435
15000US060730080021,745,635,63,682,16436
15000US060730080022,1215,985,72,1143,16437
15000US060730080023,1024,866,76,948,16438
15000US060730080031,1317,1124,147,1170,16439
15000US060730080032,1400,1080,238,1162,16440
15000US060730080033,1299,887,265,1034,16441
15000US060730080061,605,542,9,596,16442
15000US060730080062,943,756,168,775,16443
15000US060730080063,569,525,26,543,16444
15000US060730080064,1064,933,70,994,16445
15000US060730080065,870,667,138,732,16446
15000US060730081011,574,523,36,538,16447
15000US060730081012,730,607,71,659,16448
15000US060730081013,1083,1037,46,1037,16449
15000US060730081014,672,515,92,580,16450
15000US060730081015,839,669,49,790,16451
15000US060730081021,700,613,28,672,16452
15000US060730081022,1261,1069,114,1147,16453
15000US060730081023,1406,1168,111,1295,16454
15000US060730082001,800,746,54,746,16455
15000US060730082002,1063,858,65,998,16456
15000US060730082003,739,636,38,701,16457
15000US060730083011,1163,1090,39,1124,16458
15000US060730083012,1101,941,141,960,16459
15000US060730083013,779,648,10,769,16460
15000US060730083031,1291,1192,50,1241,16461
15000US060730083032,1839,1521,175,1664,16462
15000US060730083033,415,406,9,406,16463
15000US060730083051,0,0,0,0,16464
15000US060730083052,2070,951,269,1801,16465
15000US060730083061,891,622,0,891,16466
15000US060730083062,962,803,72,890,16467
15000US060730083063,1395,1125,136,1259,16468
15000US060730083071,1008,743,35,973,16469
15000US060730083072,1751,1219,250,1501,16470
15000US060730083073,1043,744,193,850,16471
15000US060730083101,1358,799,398,960,16472
15000US060730083102,1957,1542,71,1886,16473
15000US060730083103,2727,2253,281,2446,16474
15000US060730083111,1777,1223,195,1582,16475
15000US060730083112,1328,1210,0,1328,16476
15000US060730083121,619,552,14,605,16477
15000US060730083122,1267,967,150,1117,16478
15000US060730083123,561,442,81,480,16479
15000US060730083124,1254,1108,57,1197,16480
15000US060730083131,980,720,103,877,16481
15000US060730083132,1176,921,106,1070,16482
15000US060730083241,2699,2106,133,2566,16483
15000US060730083242,2431,1962,93,2338,16484
15000US060730083243,552,329,0,552,16485
15000US060730083244,1203,913,219,984,16486
15000US060730083271,2309,1485,223,2086,16487
15000US060730083272,2554,1800,144,2410,16488
15000US060730083273,1134,848,60,1074,16489
15000US060730083281,5795,3101,356,5439,16490
15000US060730083291,3291,1886,336,2955,16491
15000US060730083292,1541,1065,160,1381,16492
15000US060730083293,1733,1284,123,1610,16493
15000US060730083301,2598,1644,87,2511,16494
15000US060730083302,3261,1386,397,2864,16495
15000US060730083311,2459,1709,148,2311,16496
15000US060730083331,7543,3410,253,7290,16497
15000US060730083332,8006,4451,794,7212,16498
15000US060730083351,916,670,7,909,16499
15000US060730083352,787,408,140,647,16500
15000US060730083353,8253,3914,797,7456,16501
15000US060730083361,863,471,91,772,16502
15000US060730083362,1346,978,143,1203,16503
15000US060730083371,1979,1116,86,1893,16504
15000US060730083372,1047,600,149,898,16505
15000US060730083373,1487,1091,136,1351,16506
15000US060730083391,2106,879,421,1685,16507
15000US060730083401,4266,2195,170,4096,16508
15000US060730083402,393,85,16,377,16509
15000US060730083403,2476,848,139,2337,16510
15000US060730083404,1860,1149,159,1701,16511
15000US060730083411,2301,1302,268,2033,16512
15000US060730083412,5640,2140,385,5255,16513
15000US060730083431,2836,1004,707,2129,16514
15000US060730083432,1456,566,199,1257,16515
15000US060730083433,914,257,181,733,16516
15000US060730083441,1758,1233,197,1561,16517
15000US060730083442,1765,1187,269,1496,16518
15000US060730083451,1300,647,337,963,16519
15000US060730083452,1626,1110,226,1400,16520
15000US060730083453,1182,647,287,895,16521
15000US060730083461,3081,1485,318,2763,16522
15000US060730083462,1940,521,230,1710,16523
15000US060730083471,3183,887,780,2403,16524
15000US060730083472,1662,458,133,1529,16525
15000US060730083473,1374,762,62,1312,16526
15000US060730083474,618,107,73,545,16527
15000US060730083481,2176,683,98,2078,16528
15000US060730083482,1300,420,274,1026,16529
15000US060730083483,2360,407,206,2154,16530
15000US060730083491,1436,518,248,1188,16531
15000US060730083492,2454,545,213,2241,16532
15000US060730083501,2464,717,356,2108,16533
15000US060730083502,1193,446,83,1110,16534
15000US060730083503,924,346,67,857,16535
15000US060730083504,1746,443,61,1685,16536
15000US060730083511,1355,278,194,1161,16537
15000US060730083512,591,187,9,582,16538
15000US060730083513,812,316,78,734,16539
15000US060730083514,1495,345,168,1327,16540
15000US060730083521,1179,250,264,915,16541
15000US060730083522,1749,321,216,1533,16542
15000US060730083523,1270,192,191,1079,16543
15000US060730083531,1169,395,216,953,16544
15000US060730083532,3146,884,329,2817,16545
15000US060730083533,956,343,192,764,16546
15000US060730083541,5381,1148,1036,4345,16547
15000US060730083542,2322,618,127,2195,16548
15000US060730083551,1034,235,114,920,16549
15000US060730083552,2468,513,162,2306,16550
15000US060730083561,1864,651,243,1621,16551
15000US060730083562,2380,583,265,2115,16552
15000US060730083571,1672,516,102,1570,16553
15000US060730083572,1714,435,196,1518,16554
15000US060730083573,1963,288,117,1846,16555
15000US060730083581,2355,391,212,2143,16556
15000US060730083582,600,292,123,477,16557
15000US060730083583,2657,878,396,2261,16558
15000US060730083584,1865,634,510,1355,16559
15000US060730083591,2328,818,430,1898,16560
15000US060730083592,2331,675,767,1564,16561
15000US060730083601,2363,558,494,1869,16562
15000US060730083602,1411,298,225,1186,16563
15000US060730083603,2710,564,288,2422,16564
15000US060730083611,1830,1100,170,1660,16565
15000US060730083612,663,385,96,567,16566
15000US060730083621,1262,753,156,1106,16567
15000US060730083622,703,623,18,685,16568
15000US060730083623,1396,904,71,1325,16569
15000US060730083631,1114,447,163,951,16570
15000US060730083632,2782,760,226,2556,16571
15000US060730083633,1731,305,13,1718,16572
15000US060730083641,1349,596,104,1245,16573
15000US060730083642,2415,1155,299,2116,16574
15000US060730083643,2034,837,55,1979,16575
15000US060730083651,1992,934,100,1892,16576
15000US060730083652,1295,664,53,1242,16577
15000US060730083661,7277,3355,681,6596,16578
15000US060730085011,1614,1144,450,1164,16579
15000US060730085012,2095,1726,266,1829,16580
15000US060730085013,941,763,143,798,16581
15000US060730085014,1026,521,149,877,16582
15000US060730085021,1356,990,92,1264,16583
15000US060730085022,866,465,165,701,16584
15000US060730085023,898,697,72,826,16585
15000US060730085024,1176,757,205,971,16586
15000US060730085025,2028,944,966,1062,16587
15000US060730085031,1696,1294,252,1444,16588
15000US060730085032,1296,573,629,667,16589
15000US060730085033,2105,1249,628,1477,16590
15000US060730085034,1477,1092,267,1210,16591
15000US060730085041,838,597,210,628,16592
15000US060730085042,1624,955,623,1001,16593
15000US060730085043,1011,606,165,846,16594
15000US060730085044,666,507,32,634,16595
15000US060730085045,1906,1309,245,1661,16596
15000US060730085051,1437,728,441,996,16597
15000US060730085052,1405,452,481,924,16598
15000US060730085053,738,306,71,667,16599
15000US060730085054,1134,876,215,919,16600
15000US060730085055,1723,685,586,1137,16601
15000US060730085061,1474,565,548,926,16602
15000US060730085062,1705,752,678,1027,16603
15000US060730085063,1412,1188,142,1270,16604
15000US060730085071,1191,516,18,1173,16605
15000US060730085072,1173,466,134,1039,16606
15000US060730085073,1389,537,252,1137,16607
15000US060730085074,1710,1015,408,1302,16608
15000US060730085075,1294,960,113,1181,16609
15000US060730085076,1555,397,963,592,16610
15000US060730085091,938,520,99,839,16611
15000US060730085092,1121,516,35,1086,16612
15000US060730085093,786,618,73,713,16613
15000US060730085094,3844,1512,839,3005,16614
15000US060730085095,1122,540,324,798,16615
15000US060730085101,1688,750,414,1274,16616
15000US060730085102,1974,1282,165,1809,16617
15000US060730085103,1734,775,524,1210,16618
15000US060730085104,1463,727,417,1046,16619
15000US060730085111,3750,1665,958,2792,16620
15000US060730085121,586,395,71,515,16621
15000US060730085122,1398,1058,178,1220,16622
15000US060730085123,2599,1747,428,2171,16623
15000US060730085131,1887,1252,232,1655,16624
15000US060730085132,1058,825,192,866,16625
15000US060730086001,2846,1257,700,2146,16626
15000US060730086002,1630,119,1236,394,16627
15000US060730086003,599,73,236,363,16628
15000US060730086004,1785,18,1320,465,16629
15000US060730087011,1655,774,346,1309,16630
15000US060730087012,1681,716,459,1222,16631
15000US060730087021,1886,1014,415,1471,16632
15000US060730087022,1816,822,542,1274,16633
15000US060730087023,1378,539,349,1029,16634
15000US060730088001,2129,369,415,1714,16635
15000US060730088002,1194,267,364,830,16636
15000US060730088003,1649,442,270,1379,16637
15000US060730088004,2250,211,768,1482,16638
15000US060730089011,838,162,335,503,16639
15000US060730089012,396,205,62,334,16640
15000US060730089013,1770,1000,602,1168,16641
15000US060730089014,1926,1044,590,1336,16642
15000US060730089021,1064,756,171,893,16643
15000US060730089022,1046,720,178,868,16644
15000US060730090001,3068,617,1797,1271,16645
15000US060730090002,1364,681,325,1039,16646
15000US060730091011,1039,860,74,965,16647
15000US060730091012,2073,1506,392,1681,16648
15000US060730091013,996,880,0,996,16649
15000US060730091014,1602,1102,343,1259,16650
15000US060730091021,1612,857,347,1265,16651
15000US060730091022,1894,929,724,1170,16652
15000US060730091031,821,503,243,578,16653
15000US060730091032,713,522,165,548,16654
15000US060730091033,1138,793,153,985,16655
15000US060730091034,902,693,112,790,16656
15000US060730091041,1228,1015,131,1097,16657
15000US060730091042,1848,1285,324,1524,16658
15000US060730091061,1006,747,184,822,16659
15000US060730091062,2854,1942,462,2392,16660
15000US060730091063,774,539,182,592,16661
15000US060730091071,2700,1454,804,1896,16662
15000US060730091072,1904,1464,155,1749,16663
15000US060730092011,1479,423,458,1021,16664
15000US060730092012,1473,315,202,1271,16665
15000US060730092013,1363,910,304,1059,16666
15000US060730092014,1353,623,303,1050,16667
15000US060730092021,2074,1488,191,1883,16668
15000US060730092022,3652,2128,642,3010,16669
15000US060730093011,851,396,158,693,16670
15000US060730093012,1353,691,329,1024,16671
15000US060730093013,1787,676,578,1209,16672
15000US060730093014,869,334,185,684,16673
15000US060730093041,2331,1250,649,1682,16674
15000US060730093042,1364,961,105,1259,16675
15000US060730093043,4887,3238,748,4139,16676
15000US060730093051,2835,1479,575,2260,16677
15000US060730093052,1022,552,307,715,16678
15000US060730093053,1115,451,603,512,16679
15000US060730093061,2610,1682,179,2431,16680
15000US060730093062,530,214,27,503,16681
15000US060730093063,1032,387,198,834,16682
15000US060730093064,1506,892,278,1228,16683
15000US060730094001,5110,2942,1250,3860,16684
15000US060730095021,1605,1067,270,1335,16685
15000US060730095022,2390,1296,309,2081,16686
15000US060730095041,5677,3250,711,4966,16687
15000US060730095042,814,681,84,730,16688
15000US060730095051,1398,1016,150,1248,16689
15000US060730095052,1185,935,87,1098,16690
15000US060730095053,2514,983,524,1990,16691
15000US060730095054,2063,1151,120,1943,16692
15000US060730095061,2495,1565,444,2051,16693
15000US060730095062,1821,1316,122,1699,16694
15000US060730095071,2057,1317,284,1773,16695
15000US060730095072,522,388,113,409,16696
15000US060730095073,919,506,277,642,16697
15000US060730095091,2694,1385,458,2236,16698
15000US060730095092,1324,820,8,1316,16699
15000US060730095101,1454,655,220,1234,16700
15000US060730095102,2280,1108,598,1682,16701
15000US060730095103,1046,621,314,732,16702
15000US060730095111,1968,1329,498,1470,16703
15000US060730095112,2450,1297,524,1926,16704
15000US060730096021,1329,990,69,1260,16705
15000US060730096022,748,398,182,566,16706
15000US060730096023,969,741,189,780,16707
15000US060730096024,824,545,122,702,16708
15000US060730096031,1394,627,312,1082,16709
15000US060730096032,1344,827,282,1062,16710
15000US060730096033,1306,423,377,929,16711
15000US060730096034,1053,545,234,819,16712
15000US060730096041,631,453,127,504,16713
15000US060730096042,640,341,151,489,16714
15000US060730096043,1423,767,360,1063,16715
15000US060730096044,1073,519,409,664,16716
15000US060730097031,1069,752,202,867,16717
15000US060730097032,943,638,96,847,16718
15000US060730097033,1478,1116,266,1212,16719
15000US060730097041,1252,752,293,959,16720
15000US060730097042,1110,746,105,1005,16721
15000US060730097043,1345,1217,50,1295,16722
15000US060730097044,813,520,19,794,16723
15000US060730097045,1297,742,247,1050,16724
15000US060730097051,635,474,98,537,16725
15000US060730097052,1716,1131,434,1282,16726
15000US060730097053,1482,1054,192,1290,16727
15000US060730097061,1144,897,150,994,16728
15000US060730097062,1386,600,583,803,16729
15000US060730097063,1455,914,312,1143,16730
15000US060730097064,620,467,135,485,16731
15000US060730097065,1011,788,14,997,16732
15000US060730097066,918,547,371,547,16733
15000US060730097067,726,677,29,697,16734
15000US060730098011,1195,979,178,1017,16735
15000US060730098012,1588,1041,349,1239,16736
15000US060730098013,1542,1287,100,1442,16737
15000US060730098014,805,700,32,773,16738
15000US060730098021,1047,640,110,937,16739
15000US060730098022,1307,879,119,1188,16740
15000US060730098023,1355,716,489,866,16741
15000US060730098024,2051,1352,438,1613,16742
15000US060730098025,592,310,92,500,16743
15000US060730098041,1730,1024,611,1119,16744
15000US060730098042,794,686,77,717,16745
15000US060730098043,673,482,173,500,16746
15000US060730098044,1433,1133,255,1178,16747
15000US060730098051,1109,792,266,843,16748
15000US060730098052,771,619,52,719,16749
15000US060730098053,1117,931,56,1061,16750
15000US060730098054,1836,1228,272,1564,16751
15000US060730099011,808,359,205,603,16752
15000US060730099021,0,0,0,0,16753
15000US060730100011,1291,156,921,370,16754
15000US060730100012,2306,358,1419,887,16755
15000US060730100031,1820,89,1172,648,16756
15000US060730100032,1635,146,1170,465,16757
15000US060730100033,1583,103,1097,486,16758
15000US060730100034,1352,216,867,485,16759
15000US060730100041,1780,204,1351,429,16760
15000US060730100042,2874,233,2016,858,16761
15000US060730100051,2263,46,2039,224,16762
15000US060730100052,1200,10,1190,10,16763
15000US060730100053,2989,170,2697,292,16764
15000US060730100054,1487,37,1428,59,16765
15000US060730100091,3893,44,3791,102,16766
15000US060730100092,2022,141,1803,219,16767
15000US060730100093,396,0,396,0,16768
15000US060730100094,862,27,827,35,16769
15000US060730100101,1478,217,1143,335,16770
15000US060730100102,2554,198,1910,644,16771
15000US060730100103,1732,217,1125,607,16772
15000US060730100111,2051,209,1527,524,16773
15000US060730100112,2187,170,1439,748,16774
15000US060730100121,692,34,658,34,16775
15000US060730100122,2898,34,2864,34,16776
15000US060730100123,1639,0,1535,104,16777
15000US060730100131,2709,0,2641,68,16778
15000US060730100132,3135,30,3059,76,16779
15000US060730100141,3998,1253,1493,2505,16780
15000US060730100142,16853,2144,9085,7768,16781
15000US060730100151,2872,135,2442,430,16782
15000US060730101031,2089,130,1918,171,16783
15000US060730101032,1567,183,1269,298,16784
15000US060730101033,2918,598,1739,1179,16785
15000US060730101041,1871,503,1050,821,16786
15000US060730101042,1754,509,978,776,16787
15000US060730101061,2375,225,1988,387,16788
15000US060730101062,2261,184,1960,301,16789
15000US060730101063,1733,59,1667,66,16790
15000US060730101071,2608,234,2023,585,16791
15000US060730101072,919,197,568,351,16792
15000US060730101073,2237,115,1588,649,16793
15000US060730101074,1100,209,800,300,16794
15000US060730101091,2390,296,1589,801,16795
15000US060730101092,2626,132,2082,544,16796
15000US060730101101,2061,242,1330,731,16797
15000US060730101102,2631,141,2154,477,16798
15000US060730101103,1470,152,579,891,16799
15000US060730101104,1543,0,1392,151,16800
15000US060730101105,969,321,488,481,16801
15000US060730101111,1519,121,1313,206,16802
15000US060730101112,1969,153,1748,221,16803
15000US060730101121,2938,196,2531,407,16804
15000US060730101122,2041,142,1818,223,16805
15000US060730102001,1348,586,347,1001,16806
15000US060730102002,533,286,131,402,16807
15000US060730102003,1160,652,417,743,16808
15000US060730102004,1270,477,567,703,16809
15000US060730102005,922,642,186,736,16810
15000US060730102006,1099,507,591,508,16811
15000US060730103001,717,480,225,492,16812
15000US060730103002,1728,788,646,1082,16813
15000US060730103003,1875,281,986,889,16814
15000US060730103004,532,399,62,470,16815
15000US060730104011,2513,836,1192,1321,16816
15000US060730104021,2175,419,1563,612,16817
15000US060730104022,1071,308,542,529,16818
15000US060730104023,2817,287,1978,839,16819
15000US060730105011,1466,804,521,945,16820
15000US060730105021,1105,272,589,516,16821
15000US060730105022,1406,224,916,490,16822
15000US060730105023,1532,251,1011,521,16823
15000US060730105024,1848,323,1279,569,16824
15000US060730106011,1340,996,215,1125,16825
15000US060730106012,1283,721,472,811,16826
15000US060730108001,1106,914,31,1075,16827
15000US060730108002,1654,1619,14,1640,16828
15000US060730109001,757,648,61,696,16829
15000US060730109002,1306,1107,144,1162,16830
15000US060730110001,2257,1633,520,1737,16831
15000US060730110002,1389,1206,122,1267,16832
15000US060730111001,2493,1928,421,2072,16833
15000US060730111002,1425,1118,131,1294,16834
15000US060730111003,709,588,40,669,16835
15000US060730113001,2913,1490,598,2315,16836
15000US060730116011,1781,50,1537,244,16837
15000US060730116012,1410,29,1151,259,16838
15000US060730116013,2496,80,2121,375,16839
15000US060730116021,2277,316,1697,580,16840
15000US060730116022,1383,104,1193,190,16841
15000US060730117001,2833,75,1568,1265,16842
15000US060730117002,1881,83,1465,416,16843
15000US060730117003,839,194,482,357,16844
15000US060730117004,948,72,334,614,16845
15000US060730118011,2002,196,1323,679,16846
15000US060730118012,911,115,738,173,16847
15000US060730118013,857,89,595,262,16848
15000US060730118021,3383,142,2632,751,16849
15000US060730118022,2168,35,1767,401,16850
15000US060730118023,2137,192,1578,559,16851
15000US060730119021,1124,41,619,505,16852
15000US060730119022,2020,503,913,1107,16853
15000US060730119023,984,165,598,386,16854
15000US060730119024,1503,32,1106,397,16855
15000US060730120021,1278,88,511,767,16856
15000US060730120022,2494,67,981,1513,16857
15000US060730120031,1162,251,625,537,16858
15000US060730120032,2424,88,1742,682,16859
15000US060730121011,2517,276,1927,590,16860
15000US060730121021,1574,164,1056,518,16861
15000US060730121022,2341,94,2038,303,16862
15000US060730122001,803,143,588,215,16863
15000US060730122002,2607,276,1745,862,16864
15000US060730123021,1729,427,1182,547,16865
15000US060730123031,2407,453,1616,791,16866
15000US060730123032,1252,475,489,763,16867
15000US060730123041,925,138,726,199,16868
15000US060730123042,2543,1038,1392,1151,16869
15000US060730124011,1098,262,624,474,16870
15000US060730124012,2769,352,2139,630,16871
15000US060730124021,1243,263,830,413,16872
15000US060730124022,1254,278,807,447,16873
15000US060730124023,2860,343,2210,650,16874
15000US060730125011,1579,444,952,627,16875
15000US060730125012,1297,108,1113,184,16876
15000US060730125021,1575,133,1299,276,16877
15000US060730125022,1967,154,1606,361,16878
15000US060730125023,1114,135,854,260,16879
15000US060730126001,1004,152,747,257,16880
15000US060730126002,998,168,798,200,16881
15000US060730126003,1307,193,983,324,16882
15000US060730126004,1193,190,979,214,16883
15000US060730127001,3291,270,2750,541,16884
15000US060730127002,1766,398,1238,528,16885
15000US060730128001,941,439,349,592,16886
15000US060730128002,1044,316,672,372,16887
15000US060730128003,1871,327,1374,497,16888
15000US060730129001,1520,426,902,618,16889
15000US060730129002,795,196,577,218,16890
15000US060730129003,1004,277,554,450,16891
15000US060730130001,1603,466,821,782,16892
15000US060730130002,1584,191,1086,498,16893
15000US060730130003,1964,324,1529,435,16894
15000US060730130004,1466,355,853,613,16895
15000US060730131021,1540,336,1202,338,16896
15000US060730131022,3154,403,2062,1092,16897
15000US060730131023,2135,336,1671,464,16898
15000US060730131031,1053,63,956,97,16899
15000US060730131032,1672,275,1197,475,16900
15000US060730131041,2172,167,1924,248,16901
15000US060730131042,912,273,566,346,16902
15000US060730131043,1970,204,1655,315,16903
15000US060730131044,916,38,837,79,16904
15000US060730132031,1073,152,830,243,16905
15000US060730132032,735,37,585,150,16906
15000US060730132033,3730,70,3482,248,16907
15000US060730132034,1738,109,1497,241,16908
15000US060730132041,1461,19,1406,55,16909
15000US060730132042,798,80,633,165,16910
15000US060730132043,1730,91,1584,146,16911
15000US060730132051,2392,73,2242,150,16912
15000US060730132061,3133,70,2600,533,16913
15000US060730132062,2045,158,1848,197,16914
15000US060730132063,2024,350,1526,498,16915
15000US060730133011,2721,1051,1349,1372,16916
15000US060730133012,2507,730,1624,883,16917
15000US060730133021,2091,597,1259,832,16918
15000US060730133022,2964,581,2083,881,16919
15000US060730133031,2572,523,1814,758,16920
15000US060730133032,1435,221,1141,294,16921
15000US060730133033,1189,157,961,228,16922
15000US060730133061,1946,375,1219,727,16923
15000US060730133062,2309,407,1439,870,16924
15000US060730133071,1334,213,988,346,16925
15000US060730133072,3085,425,2282,803,16926
15000US060730133081,2711,263,1971,740,16927
15000US060730133082,1054,22,991,63,16928
15000US060730133091,1229,414,698,531,16929
15000US060730133092,1138,273,225,913,16930
15000US060730133093,1061,248,509,552,16931
15000US060730133094,2252,325,1516,736,16932
15000US060730133095,1532,414,733,799,16933
15000US060730133101,9036,1899,3619,5417,16934
15000US060730133102,19825,2045,9563,10262,16935
15000US060730133111,5670,851,2744,2926,16936
15000US060730133112,2476,559,1278,1198,16937
15000US060730133113,1093,168,368,725,16938
15000US060730133114,2025,601,944,1081,16939
15000US060730133121,2831,450,2006,825,16940
15000US060730133131,14371,2139,5329,9042,16941
15000US060730133141,19151,3252,9489,9662,16942
15000US060730134011,2221,833,1248,973,16943
15000US060730134012,1978,605,1173,805,16944
15000US060730134091,1267,386,786,481,16945
15000US060730134092,2236,587,1198,1038,16946
15000US060730134093,1935,497,1085,850,16947
15000US060730134101,5630,1323,2201,3429,16948
15000US060730134102,1159,438,446,713,16949
15000US060730134103,1370,309,732,638,16950
15000US060730134111,1862,711,876,986,16951
15000US060730134112,1110,567,332,778,16952
15000US060730134113,781,337,346,435,16953
15000US060730134114,1505,532,547,958,16954
15000US060730134121,2774,989,1213,1561,16955
15000US060730134122,2074,451,1092,982,16956
15000US060730134141,2580,473,1172,1408,16957
15000US060730134142,2329,975,1096,1233,16958
15000US060730134143,1317,821,161,1156,16959
15000US060730134144,1540,705,462,1078,16960
15000US060730134151,1436,515,694,742,16961
15000US060730134161,1826,415,965,861,16962
15000US060730134162,1935,774,701,1234,16963
15000US060730134171,2227,737,991,1236,16964
15000US060730134181,1183,273,441,742,16965
15000US060730134182,2800,375,2032,768,16966
15000US060730134183,993,337,550,443,16967
15000US060730134184,1148,288,368,780,16968
15000US060730134191,7062,1389,3384,3678,16969
15000US060730134192,1269,244,725,544,16970
15000US060730134201,1354,364,361,993,16971
15000US060730134202,2245,321,942,1303,16972
15000US060730134211,1071,161,543,528,16973
15000US060730134212,2145,491,999,1146,16974
15000US060730134213,1532,390,759,773,16975
15000US060730135031,1895,662,634,1261,16976
15000US060730135032,2206,927,833,1373,16977
15000US060730135033,1721,1021,360,1361,16978
15000US060730135041,979,286,302,677,16979
15000US060730135042,684,363,253,431,16980
15000US060730135043,2008,899,522,1486,16981
15000US060730135051,2757,1180,880,1877,16982
15000US060730135052,1579,892,409,1170,16983
15000US060730135053,504,290,78,426,16984
15000US060730135061,4280,1722,1671,2609,16985
15000US060730136011,692,637,31,661,16986
15000US060730136012,1573,935,522,1051,16987
15000US060730136013,1559,916,391,1168,16988
15000US060730136014,1405,398,598,807,16989
15000US060730136041,1088,703,285,803,16990
15000US060730136042,945,830,115,830,16991
15000US060730136043,2433,1789,423,2010,16992
15000US060730136044,1875,987,437,1438,16993
15000US060730136051,3254,1972,1138,2116,16994
15000US060730136052,1688,1326,203,1485,16995
15000US060730136053,1738,1303,291,1447,16996
15000US060730136061,1064,568,254,810,16997
15000US060730136062,1761,1082,440,1321,16998
15000US060730136063,2433,1290,614,1819,16999
15000US060730136064,1713,1279,368,1345,17000
15000US060730137011,1510,1178,263,1247,17001
15000US060730137012,868,518,196,672,17002
15000US060730137021,3002,691,1420,1582,17003
15000US060730137022,1573,159,768,805,17004
15000US060730137023,1071,655,252,819,17005
15000US060730138011,1820,803,857,963,17006
15000US060730138012,1378,772,514,864,17007
15000US060730138013,1790,781,449,1341,17008
15000US060730138021,1640,511,747,893,17009
15000US060730138022,1376,314,757,619,17010
15000US060730139031,1537,388,726,811,17011
15000US060730139032,2982,1058,1089,1893,17012
15000US060730139051,1897,882,553,1344,17013
15000US060730139052,1007,302,385,622,17014
15000US060730139053,989,278,233,756,17015
15000US060730139061,4209,1467,1788,2421,17016
15000US060730139062,1084,208,378,706,17017
15000US060730139071,1673,66,1447,226,17018
15000US060730139072,2810,347,2232,578,17019
15000US060730139081,879,333,294,585,17020
15000US060730139082,3553,508,1996,1557,17021
15000US060730139091,1668,597,484,1184,17022
15000US060730139092,2922,585,2055,867,17023
15000US060730140011,781,307,309,472,17024
15000US060730140012,934,172,349,585,17025
15000US060730140013,1400,687,611,789,17026
15000US060730140014,1460,668,441,1019,17027
15000US060730140021,2284,689,1199,1085,17028
15000US060730140022,2257,683,769,1488,17029
15000US060730141011,2106,765,1245,861,17030
15000US060730141012,1780,831,586,1194,17031
15000US060730141021,2503,192,627,1876,17032
15000US060730141022,1514,273,1027,487,17033
15000US060730142001,2140,505,1020,1120,17034
15000US060730142002,1360,600,412,948,17035
15000US060730142003,1873,483,975,898,17036
15000US060730142004,910,570,258,652,17037
15000US060730143001,2418,705,1556,862,17038
15000US060730143002,1628,558,735,893,17039
15000US060730144001,1991,395,1070,921,17040
15000US060730144002,1937,234,838,1099,17041
15000US060730145001,1337,565,245,1092,17042
15000US060730145002,1564,470,544,1020,17043
15000US060730145003,1113,449,444,669,17044
15000US060730146011,2014,1453,303,1711,17045
15000US060730146012,2004,876,626,1378,17046
15000US060730146013,713,187,311,402,17047
15000US060730146021,1359,1091,210,1149,17048
15000US060730146022,1682,606,379,1303,17049
15000US060730146023,1934,1036,396,1538,17050
15000US060730147001,2644,1541,355,2289,17051
15000US060730147002,1602,627,758,844,17052
15000US060730147003,2261,1302,385,1876,17053
15000US060730147004,1537,1076,415,1122,17054
15000US060730148031,1774,728,900,874,17055
15000US060730148032,2136,1007,921,1215,17056
15000US060730148033,1186,842,181,1005,17057
15000US060730148041,909,644,263,646,17058
15000US060730148042,1934,1577,135,1799,17059
15000US060730148043,1057,559,228,829,17060
15000US060730148051,1110,652,317,793,17061
15000US060730148052,1752,994,442,1310,17062
15000US060730148053,1543,954,368,1175,17063
15000US060730148061,1253,551,507,746,17064
15000US060730148062,1484,912,416,1068,17065
15000US060730149011,1039,842,83,956,17066
15000US060730149012,2184,721,841,1343,17067
15000US060730149013,1383,1088,222,1161,17068
15000US060730149021,2656,1498,667,1989,17069
15000US060730149022,881,447,378,503,17070
15000US060730150001,1532,980,456,1076,17071
15000US060730150002,2856,1231,729,2127,17072
15000US060730150003,1213,632,93,1120,17073
15000US060730150004,888,537,274,614,17074
15000US060730151001,940,637,242,698,17075
15000US060730151002,1845,1015,462,1383,17076
15000US060730151003,1107,671,282,825,17077
15000US060730151004,1081,784,149,932,17078
15000US060730152001,1137,973,138,999,17079
15000US060730152002,1201,888,213,988,17080
15000US060730152003,665,480,47,618,17081
15000US060730152004,731,520,110,621,17082
15000US060730153011,1412,999,290,1122,17083
15000US060730153012,1736,848,340,1396,17084
15000US060730153021,2799,1752,645,2154,17085
15000US060730153022,1192,1070,88,1104,17086
15000US060730154031,1510,1243,112,1398,17087
15000US060730154032,1170,1052,79,1091,17088
15000US060730154041,2713,1823,724,1989,17089
15000US060730154042,1530,925,45,1485,17090
15000US060730154043,1831,1240,219,1612,17091
15000US060730154044,2275,1422,744,1531,17092
15000US060730154051,2441,1567,689,1752,17093
15000US060730154052,1355,1210,106,1249,17094
15000US060730154053,1865,1523,267,1598,17095
15000US060730154061,2714,1910,261,2453,17096
15000US060730155011,953,705,103,850,17097
15000US060730155012,2776,1850,681,2095,17098
15000US060730155013,1373,1155,206,1167,17099
15000US060730155021,1315,726,414,901,17100
15000US060730155022,1534,1202,275,1259,17101
15000US060730156011,2883,1481,1254,1629,17102
15000US060730156012,1814,1177,354,1460,17103
15000US060730156013,1472,815,477,995,17104
15000US060730156021,1169,898,200,969,17105
15000US060730156022,1136,875,179,957,17106
15000US060730157011,1128,416,602,526,17107
15000US060730157012,3175,1064,1193,1982,17108
15000US060730157013,2195,680,1039,1156,17109
15000US060730157031,1564,884,422,1142,17110
15000US060730157032,2425,1887,286,2139,17111
15000US060730157033,2803,1388,859,1944,17112
15000US060730157041,1794,945,621,1173,17113
15000US060730157042,2319,1058,862,1457,17114
15000US060730158011,2198,847,760,1438,17115
15000US060730158012,1223,386,617,606,17116
15000US060730158021,937,565,219,718,17117
15000US060730158022,2655,1473,805,1850,17118
15000US060730158023,1447,715,586,861,17119
15000US060730159011,2231,700,1238,993,17120
15000US060730159012,1415,417,775,640,17121
15000US060730159021,876,419,380,496,17122
15000US060730159022,1552,714,411,1141,17123
15000US060730159023,873,496,272,601,17124
15000US060730159024,2018,984,609,1409,17125
15000US060730160001,798,217,348,450,17126
15000US060730160002,1617,1052,352,1265,17127
15000US060730161001,2631,1939,374,2257,17128
15000US060730161002,2247,1455,207,2040,17129
15000US060730161003,1455,1010,243,1212,17130
15000US060730162011,2250,1685,345,1905,17131
15000US060730162012,1328,1075,220,1108,17132
15000US060730162013,1994,1587,96,1898,17133
15000US060730162021,903,521,241,662,17134
15000US060730162022,2464,1411,540,1924,17135
15000US060730163011,2312,1233,635,1677,17136
15000US060730163012,2913,1321,1201,1712,17137
15000US060730163021,1325,865,266,1059,17138
15000US060730163022,2471,1130,1041,1430,17139
15000US060730163023,2139,887,843,1296,17140
15000US060730164011,511,293,169,342,17141
15000US060730164012,2089,1407,501,1588,17142
15000US060730164013,2629,1896,484,2145,17143
15000US060730164021,2469,1895,409,2060,17144
15000US060730164022,306,266,25,281,17145
15000US060730164023,1692,425,631,1061,17146
15000US060730164024,1787,1127,579,1208,17147
15000US060730164025,1985,1190,684,1301,17148
15000US060730165021,760,484,42,718,17149
15000US060730165022,2090,1072,591,1499,17150
15000US060730165023,2241,1409,741,1500,17151
15000US060730165024,2177,1010,847,1330,17152
15000US060730165031,1693,750,605,1088,17153
15000US060730165032,1268,898,136,1132,17154
15000US060730165041,3106,993,1602,1504,17155
15000US060730165042,2960,1480,1017,1943,17156
15000US060730165043,1029,364,440,589,17157
15000US060730165044,412,142,195,217,17158
15000US060730166051,1964,1345,347,1617,17159
15000US060730166052,2831,2166,486,2345,17160
15000US060730166053,914,787,109,805,17161
15000US060730166054,1587,864,424,1163,17162
15000US060730166061,2029,1372,273,1756,17163
15000US060730166062,2037,1377,470,1567,17164
15000US060730166071,3056,2254,481,2575,17165
15000US060730166072,1655,1286,216,1439,17166
15000US060730166073,1802,1443,234,1568,17167
15000US060730166081,2647,2136,309,2338,17168
15000US060730166091,2206,1858,249,1957,17169
15000US060730166092,1107,954,99,1008,17170
15000US060730166093,2022,1220,603,1419,17171
15000US060730166101,2211,1372,548,1663,17172
15000US060730166102,1839,1463,82,1757,17173
15000US060730166121,2480,1992,387,2093,17174
15000US060730166122,730,478,161,569,17175
15000US060730166123,2702,1711,716,1986,17176
15000US060730166131,849,576,144,705,17177
15000US060730166132,1054,822,114,940,17178
15000US060730166141,2219,1842,188,2031,17179
15000US060730166142,1825,1208,370,1455,17180
15000US060730166151,3951,2458,915,3036,17181
15000US060730166161,1735,1125,415,1320,17182
15000US060730166162,2424,1773,420,2004,17183
15000US060730166171,1008,819,121,887,17184
15000US060730166172,2400,1500,582,1818,17185
15000US060730167011,8467,5817,1484,6983,17186
15000US060730167012,1389,992,201,1188,17187
15000US060730167021,1747,1424,199,1548,17188
15000US060730167022,2717,1492,896,1821,17189
15000US060730167023,656,576,80,576,17190
15000US060730167024,2148,1737,280,1868,17191
15000US060730168021,696,688,0,696,17192
15000US060730168022,2477,2032,351,2126,17193
15000US060730168023,1018,901,95,923,17194
15000US060730168024,3047,2807,176,2871,17195
15000US060730168041,2405,1550,651,1754,17196
15000US060730168042,1897,1326,452,1445,17197
15000US060730168043,1623,1057,313,1310,17198
15000US060730168044,1526,1100,395,1131,17199
15000US060730168061,1704,1199,477,1227,17200
15000US060730168062,1142,621,457,685,17201
15000US060730168063,1802,1267,363,1439,17202
15000US060730168071,796,682,44,752,17203
15000US060730168072,2222,1780,164,2058,17204
15000US060730168073,2624,1953,476,2148,17205
15000US060730168074,1413,1201,184,1229,17206
15000US060730168091,1148,827,148,1000,17207
15000US060730168092,1932,1439,282,1650,17208
15000US060730168093,2328,1813,286,2042,17209
15000US060730168101,2976,2486,302,2674,17210
15000US060730168111,2738,2011,626,2112,17211
15000US060730168112,1569,943,513,1056,17212
15000US060730169011,1850,1701,118,1732,17213
15000US060730169012,1213,872,205,1008,17214
15000US060730169013,1261,916,172,1089,17215
15000US060730169014,2472,1204,395,2077,17216
15000US060730169021,2591,1643,420,2171,17217
15000US060730170061,1561,1096,144,1417,17218
15000US060730170062,1287,1069,46,1241,17219
15000US060730170091,2389,1430,668,1721,17220
15000US060730170092,1679,834,522,1157,17221
15000US060730170101,1147,773,66,1081,17222
15000US060730170102,2057,1369,385,1672,17223
15000US060730170141,1257,1099,75,1182,17224
15000US060730170142,1190,1099,32,1158,17225
15000US060730170151,820,624,47,773,17226
15000US060730170152,794,479,242,552,17227
15000US060730170153,4809,2883,548,4261,17228
15000US060730170154,1395,986,65,1330,17229
15000US060730170181,2956,757,465,2491,17230
15000US060730170182,1846,1052,261,1585,17231
15000US060730170191,1497,1316,77,1420,17232
15000US060730170192,1413,1247,38,1375,17233
15000US060730170193,3067,2173,101,2966,17234
15000US060730170201,2493,1939,374,2119,17235
15000US060730170202,1260,1123,57,1203,17236
15000US060730170211,1360,1114,80,1280,17237
15000US060730170212,1350,1186,84,1266,17238
15000US060730170221,887,556,297,590,17239
15000US060730170222,716,495,23,693,17240
15000US060730170223,635,547,14,621,17241
15000US060730170224,1271,675,393,878,17242
15000US060730170225,993,756,36,957,17243
15000US060730170226,1310,883,44,1266,17244
15000US060730170291,6478,4437,828,5650,17245
15000US060730170292,2486,1956,392,2094,17246
15000US060730170301,15322,7616,1456,13866,17247
15000US060730170302,891,591,0,891,17248
15000US060730170303,816,721,10,806,17249
15000US060730170304,3180,1767,415,2765,17250
15000US060730170311,954,587,45,909,17251
15000US060730170312,763,589,47,716,17252
15000US060730170313,2137,1090,600,1537,17253
15000US060730170321,11636,4970,1127,10509,17254
15000US060730170322,2420,1576,0,2420,17255
15000US060730170331,1543,577,306,1237,17256
15000US060730170332,745,616,72,673,17257
15000US060730170333,2535,1292,163,2372,17258
15000US060730170341,2498,1287,473,2025,17259
15000US060730170342,923,634,48,875,17260
15000US060730170343,1870,1192,231,1639,17261
15000US060730170351,1017,647,116,901,17262
15000US060730170352,696,437,70,626,17263
15000US060730170353,1180,576,68,1112,17264
15000US060730170361,1331,501,102,1229,17265
15000US060730170362,967,518,79,888,17266
15000US060730170363,1278,602,116,1162,17267
15000US060730170371,1848,1143,181,1667,17268
15000US060730170372,1179,644,414,765,17269
15000US060730170373,2101,816,365,1736,17270
15000US060730170374,749,418,68,681,17271
15000US060730170391,633,421,28,605,17272
15000US060730170392,3742,1879,305,3437,17273
15000US060730170393,3107,1414,599,2508,17274
15000US060730170401,2081,1423,298,1783,17275
15000US060730170402,1274,899,82,1192,17276
15000US060730170403,1512,377,345,1167,17277
15000US060730170411,2212,1930,237,1975,17278
15000US060730170412,1714,1093,355,1359,17279
15000US060730170413,775,611,38,737,17280
15000US060730170414,1357,852,210,1147,17281
15000US060730170421,3495,1722,391,3104,17282
15000US060730170422,1743,840,239,1504,17283
15000US060730170423,2422,1359,23,2399,17284
15000US060730170431,3855,1786,524,3331,17285
15000US060730170432,2756,1157,462,2294,17286
15000US060730170441,2558,1175,192,2366,17287
15000US060730170442,3147,1744,282,2865,17288
15000US060730170451,2778,1542,149,2629,17289
15000US060730170461,2493,1665,54,2439,17290
15000US060730170462,1187,773,160,1027,17291
15000US060730170471,1567,943,111,1456,17292
15000US060730170472,1127,784,146,981,17293
15000US060730170473,1358,1123,89,1269,17294
15000US060730170481,2750,728,1474,1276,17295
15000US060730170482,1524,953,255,1269,17296
15000US060730170483,2324,1200,457,1867,17297
15000US060730170484,831,365,201,630,17298
15000US060730170491,1078,866,84,994,17299
15000US060730170492,2188,974,895,1293,17300
15000US060730170501,1530,975,159,1371,17301
15000US060730170502,1733,907,498,1235,17302
15000US060730170511,1304,778,31,1273,17303
15000US060730170512,1086,603,188,898,17304
15000US060730170513,2180,1334,175,2005,17305
15000US060730170521,1866,975,388,1478,17306
15000US060730170522,1966,1183,168,1798,17307
15000US060730170523,1386,614,67,1319,17308
15000US060730170531,1571,1335,80,1491,17309
15000US060730170532,1737,1359,214,1523,17310
15000US060730170541,1556,812,245,1311,17311
15000US060730170542,800,633,80,720,17312
15000US060730170543,994,652,248,746,17313
15000US060730170544,2534,2029,193,2341,17314
15000US060730170551,1342,917,140,1202,17315
15000US060730170552,1910,1232,113,1797,17316
15000US060730170553,2046,804,166,1880,17317
15000US060730170561,2529,1404,380,2149,17318
15000US060730170562,1937,1038,188,1749,17319
15000US060730171041,1940,1725,65,1875,17320
15000US060730171042,1899,1471,352,1547,17321
15000US060730171061,1674,1467,154,1520,17322
15000US060730171062,1314,1136,105,1209,17323
15000US060730171063,1115,1001,84,1031,17324
15000US060730171064,764,625,70,694,17325
15000US060730171071,1706,1413,146,1560,17326
15000US060730171072,1149,950,55,1094,17327
15000US060730171081,803,659,22,781,17328
15000US060730171082,1490,1260,70,1420,17329
15000US060730171083,1602,1093,398,1204,17330
15000US060730171084,967,830,46,921,17331
15000US060730171091,2656,2440,90,2566,17332
15000US060730171092,1329,960,196,1133,17333
15000US060730171093,761,554,19,742,17334
15000US060730171094,1829,1477,100,1729,17335
15000US060730171101,1832,1665,135,1697,17336
15000US060730171102,7596,5222,1551,6045,17337
15000US060730171103,1949,1728,2,1947,17338
15000US060730172001,1355,1331,0,1355,17339
15000US060730172002,1095,1012,83,1012,17340
15000US060730172003,982,734,139,843,17341
15000US060730172004,880,762,99,781,17342
15000US060730173031,958,850,33,925,17343
15000US060730173032,1348,1238,83,1265,17344
15000US060730173033,546,441,70,476,17345
15000US060730173041,1268,953,251,1017,17346
15000US060730173042,1706,862,674,1032,17347
15000US060730173043,1306,1153,79,1227,17348
15000US060730173044,1952,1532,334,1618,17349
15000US060730173051,1149,1021,6,1143,17350
15000US060730173052,570,534,0,570,17351
15000US060730173053,1211,1023,36,1175,17352
15000US060730173061,1750,1418,202,1548,17353
15000US060730173062,1014,715,32,982,17354
15000US060730174011,2143,1978,68,2075,17355
15000US060730174012,1453,1176,78,1375,17356
15000US060730174013,1523,1410,53,1470,17357
15000US060730174014,1072,992,12,1060,17358
15000US060730174031,1130,730,71,1059,17359
15000US060730174032,1223,1160,0,1223,17360
15000US060730174033,1451,1350,26,1425,17361
15000US060730174034,1394,1158,236,1158,17362
15000US060730174041,1421,1004,350,1071,17363
15000US060730174042,1027,788,103,924,17364
15000US060730174043,2240,1728,377,1863,17365
15000US060730174044,1608,1472,123,1485,17366
15000US060730174045,795,708,50,745,17367
15000US060730175011,543,482,35,508,17368
15000US060730175012,1159,854,194,965,17369
15000US060730175013,1198,970,135,1063,17370
15000US060730175021,1160,633,462,698,17371
15000US060730175022,1291,942,202,1089,17372
15000US060730175023,1363,702,616,747,17373
15000US060730176011,1231,851,33,1198,17374
15000US060730176012,2143,1571,325,1818,17375
15000US060730176013,2223,2062,75,2148,17376
15000US060730176031,1129,849,249,880,17377
15000US060730176032,1437,880,423,1014,17378
15000US060730176041,3593,2363,610,2983,17379
15000US060730176042,2109,1672,269,1840,17380
15000US060730176043,1456,1058,176,1280,17381
15000US060730177011,733,688,0,733,17382
15000US060730177012,1604,1210,253,1351,17383
15000US060730177013,967,908,27,940,17384
15000US060730177014,1969,1346,586,1383,17385
15000US060730177021,1105,940,144,961,17386
15000US060730177022,1059,923,112,947,17387
15000US060730177023,943,826,76,867,17388
15000US060730178011,1059,873,173,886,17389
15000US060730178012,991,742,249,742,17390
15000US060730178013,1981,1710,117,1864,17391
15000US060730178014,2467,1119,560,1907,17392
15000US060730178081,1192,1143,30,1162,17393
15000US060730178082,2269,1650,434,1835,17394
15000US060730178083,1147,1041,36,1111,17395
15000US060730178084,1634,1279,80,1554,17396
15000US060730178091,2431,1917,313,2118,17397
15000US060730178101,1971,1590,213,1758,17398
15000US060730178102,2811,2530,183,2628,17399
15000US060730178111,1340,996,294,1046,17400
15000US060730178112,3104,2170,292,2812,17401
15000US060730178113,1975,1515,129,1846,17402
15000US060730178114,1042,700,291,751,17403
15000US060730178131,1953,1651,185,1768,17404
15000US060730178132,2442,2001,221,2221,17405
15000US060730179001,2148,1465,501,1647,17406
15000US060730179002,1121,759,194,927,17407
15000US060730179003,1060,446,531,529,17408
15000US060730179004,1888,757,1130,758,17409
15000US060730179005,873,681,163,710,17410
15000US060730180001,703,629,68,635,17411
15000US060730180002,2058,1838,110,1948,17412
15000US060730180003,513,399,35,478,17413
15000US060730181001,2231,1369,771,1460,17414
15000US060730181002,981,845,118,863,17415
15000US060730181003,895,718,80,815,17416
15000US060730181004,831,606,170,661,17417
15000US060730181005,656,451,148,508,17418
15000US060730181006,990,732,197,793,17419
15000US060730182001,1696,941,578,1118,17420
15000US060730182002,1100,504,520,580,17421
15000US060730182003,1709,562,996,713,17422
15000US060730182004,2114,284,1803,311,17423
15000US060730182005,1008,390,438,570,17424
15000US060730183001,679,540,60,619,17425
15000US060730183002,714,437,215,499,17426
15000US060730183003,620,463,124,496,17427
15000US060730183004,476,466,10,466,17428
15000US060730184001,1254,736,453,801,17429
15000US060730184002,773,369,317,456,17430
15000US060730184003,1169,455,422,747,17431
15000US060730185041,1232,931,270,962,17432
15000US060730185042,1696,1110,366,1330,17433
15000US060730185043,2150,924,637,1513,17434
15000US060730185044,1979,1528,77,1902,17435
15000US060730185071,1760,498,1026,734,17436
15000US060730185072,3021,686,1913,1108,17437
15000US060730185073,751,435,194,557,17438
15000US060730185074,3291,1507,643,2648,17439
15000US060730185091,1365,161,951,414,17440
15000US060730185092,1690,466,942,748,17441
15000US060730185093,1154,213,698,456,17442
15000US060730185094,553,348,106,447,17443
15000US060730185101,990,697,101,889,17444
15000US060730185102,2278,414,1708,570,17445
15000US060730185111,857,698,97,760,17446
15000US060730185112,684,442,198,486,17447
15000US060730185113,566,412,59,507,17448
15000US060730185114,2587,846,1202,1385,17449
15000US060730185121,1595,1092,391,1204,17450
15000US060730185122,1264,659,379,885,17451
15000US060730185123,842,687,104,738,17452
15000US060730185131,2556,1357,719,1837,17453
15000US060730185132,5213,2904,1122,4091,17454
15000US060730185133,1622,1061,362,1260,17455
15000US060730185141,3743,1665,1034,2709,17456
15000US060730185142,2480,1035,845,1635,17457
15000US060730185143,2087,1331,361,1726,17458
15000US060730185151,581,521,13,568,17459
15000US060730185152,4233,2619,728,3505,17460
15000US060730185161,2527,1565,514,2013,17461
15000US060730185162,1387,430,805,582,17462
15000US060730185171,2009,1008,868,1141,17463
15000US060730185172,2897,1730,603,2294,17464
15000US060730185181,1541,309,1087,454,17465
15000US060730185182,1840,471,1026,814,17466
15000US060730185191,1688,644,688,1000,17467
15000US060730185192,2669,400,1948,721,17468
15000US060730185193,1562,225,1274,288,17469
15000US060730186011,1246,780,398,848,17470
15000US060730186012,3703,2116,804,2899,17471
15000US060730186031,1731,578,968,763,17472
15000US060730186032,1894,694,1043,851,17473
15000US060730186033,1982,418,974,1008,17474
15000US060730186034,1038,256,720,318,17475
15000US060730186081,2107,1162,504,1603,17476
15000US060730186082,1117,547,466,651,17477
15000US060730186091,2356,958,751,1605,17478
15000US060730186092,1555,569,776,779,17479
15000US060730186093,2431,137,1885,546,17480
15000US060730186101,2347,1114,804,1543,17481
15000US060730186102,899,96,648,251,17482
15000US060730186103,1450,361,712,738,17483
15000US060730186104,3325,330,2398,927,17484
15000US060730186111,1249,1153,35,1214,17485
15000US060730186112,5220,2781,1347,3873,17486
15000US060730186113,2189,767,781,1408,17487
15000US060730186121,2235,1537,427,1808,17488
15000US060730186122,1704,743,817,887,17489
15000US060730186131,3094,1381,990,2104,17490
15000US060730186132,637,239,307,330,17491
15000US060730186141,1414,636,539,875,17492
15000US060730186142,1600,517,479,1121,17493
15000US060730186143,3081,1216,1268,1813,17494
15000US060730187001,40616,24707,9171,31445,17495
15000US060730188011,1644,1329,240,1404,17496
15000US060730188012,2054,1466,558,1496,17497
15000US060730188021,1538,1188,109,1429,17498
15000US060730188022,1543,1239,143,1400,17499
15000US060730188023,1175,797,199,976,17500
15000US060730188024,1495,1340,42,1453,17501
15000US060730188025,2390,1811,542,1848,17502
15000US060730188031,485,335,112,373,17503
15000US060730188032,931,514,286,645,17504
15000US060730188033,3363,2181,763,2600,17505
15000US060730189031,1289,891,387,902,17506
15000US060730189032,819,717,31,788,17507
15000US060730189033,2148,549,1491,657,17508
15000US060730189034,760,387,319,441,17509
15000US060730189041,1235,216,907,328,17510
15000US060730189042,936,227,679,257,17511
15000US060730189043,1260,569,489,771,17512
15000US060730189044,2835,1479,1266,1569,17513
15000US060730189051,2864,697,1798,1066,17514
15000US060730189052,1205,129,1053,152,17515
15000US060730189053,2767,1437,1171,1596,17516
15000US060730189061,2780,645,2027,753,17517
15000US060730189062,1147,480,444,703,17518
15000US060730189063,2363,1626,624,1739,17519
15000US060730190011,1130,691,405,725,17520
15000US060730190012,2077,1492,444,1633,17521
15000US060730190013,3371,2391,342,3029,17522
15000US060730190021,1692,929,691,1001,17523
15000US060730191011,1379,193,257,1122,17524
15000US060730191012,878,262,560,318,17525
15000US060730191013,4057,2547,1269,2788,17526
15000US060730191014,1132,330,432,700,17527
15000US060730191031,1237,1060,177,1060,17528
15000US060730191032,2523,1947,162,2361,17529
15000US060730191033,1591,1432,159,1432,17530
15000US060730191051,985,590,355,630,17531
15000US060730191052,2968,2396,183,2785,17532
15000US060730191053,2727,2442,170,2557,17533
15000US060730191061,3140,1418,982,2158,17534
15000US060730191062,1441,1025,345,1096,17535
15000US060730191063,2400,1302,647,1753,17536
15000US060730191064,1995,1168,761,1234,17537
15000US060730191071,1885,1274,408,1477,17538
15000US060730192031,657,493,139,518,17539
15000US060730192032,2060,1337,551,1509,17540
15000US060730192051,1052,422,582,470,17541
15000US060730192052,3240,1006,1761,1479,17542
15000US060730192053,1521,382,1102,419,17543
15000US060730192054,829,312,308,521,17544
15000US060730192061,2703,196,2473,230,17545
15000US060730192062,2334,667,1413,921,17546
15000US060730192063,1264,262,843,421,17547
15000US060730192071,3305,2276,505,2800,17548
15000US060730192072,2425,1085,1126,1299,17549
15000US060730192073,2287,308,1951,336,17550
15000US060730192074,1280,408,833,447,17551
15000US060730192081,971,637,269,702,17552
15000US060730192082,2242,1575,535,1707,17553
15000US060730193011,1296,1152,116,1180,17554
15000US060730193012,2570,1696,391,2179,17555
15000US060730193013,3280,1713,1135,2145,17556
15000US060730193021,988,666,286,702,17557
15000US060730193022,2155,1481,304,1851,17558
15000US060730193023,2755,884,1390,1365,17559
15000US060730193024,1740,1093,398,1342,17560
15000US060730193031,2547,1530,740,1807,17561
15000US060730193032,2307,788,1141,1166,17562
15000US060730193033,2328,1480,741,1587,17563
15000US060730194031,3387,1508,1319,2068,17564
15000US060730194032,1823,230,1456,367,17565
15000US060730194033,424,213,97,327,17566
15000US060730194041,1267,358,758,509,17567
15000US060730194042,2045,387,1557,488,17568
15000US060730194051,993,417,419,574,17569
15000US060730194052,1588,234,1229,359,17570
15000US060730194053,1466,712,658,808,17571
15000US060730194061,1250,616,553,697,17572
15000US060730194062,2227,1042,942,1285,17573
15000US060730194063,1437,702,658,779,17574
15000US060730195011,2138,143,1922,216,17575
15000US060730195012,1495,227,1111,384,17576
15000US060730195021,2396,121,2256,140,17577
15000US060730195022,2271,164,2098,173,17578
15000US060730195023,1201,282,868,333,17579
15000US060730195031,2207,454,1609,598,17580
15000US060730195032,1150,423,711,439,17581
15000US060730195033,1835,553,961,874,17582
15000US060730196011,1872,875,985,887,17583
15000US060730196012,1300,995,269,1031,17584
15000US060730196013,2367,1335,923,1444,17585
15000US060730196014,1020,845,50,970,17586
15000US060730196021,994,717,190,804,17587
15000US060730196022,2191,1472,601,1590,17588
15000US060730196023,1816,450,1017,799,17589
15000US060730197011,3291,1875,770,2521,17590
15000US060730197012,2536,827,1155,1381,17591
15000US060730197013,981,750,57,924,17592
15000US060730197021,710,401,232,478,17593
15000US060730197022,1178,600,520,658,17594
15000US060730197023,1183,897,187,996,17595
15000US060730197024,1892,1264,591,1301,17596
15000US060730198031,1995,1483,267,1728,17597
15000US060730198032,1811,1367,128,1683,17598
15000US060730198033,844,510,284,560,17599
15000US060730198041,1672,1232,288,1384,17600
15000US060730198042,1252,1098,110,1142,17601
15000US060730198043,1586,1286,168,1418,17602
15000US060730198051,2608,1011,1436,1172,17603
15000US060730198052,782,372,326,456,17604
15000US060730198053,527,325,174,353,17605
15000US060730198061,3050,2127,554,2496,17606
15000US060730198062,658,658,0,658,17607
15000US060730198063,4859,3018,1140,3719,17608
15000US060730198064,3808,2713,466,3342,17609
15000US060730198081,911,814,92,819,17610
15000US060730198082,2035,998,481,1554,17611
15000US060730198083,1693,1565,56,1637,17612
15000US060730198091,1572,1185,173,1399,17613
15000US060730198092,1608,1154,158,1450,17614
15000US060730198093,1012,824,137,875,17615
15000US060730199021,3073,1889,954,2119,17616
15000US060730199022,1117,372,685,432,17617
15000US060730199031,2381,1506,809,1572,17618
15000US060730199032,2308,1333,803,1505,17619
15000US060730199041,3100,2279,496,2604,17620
15000US060730199042,1310,842,240,1070,17621
15000US060730199043,2594,1464,546,2048,17622
15000US060730199051,1150,921,138,1012,17623
15000US060730199052,2615,1618,673,1942,17624
15000US060730199053,479,338,23,456,17625
15000US060730200131,7139,4814,1206,5933,17626
15000US060730200132,4113,2041,649,3464,17627
15000US060730200133,2558,1755,211,2347,17628
15000US060730200141,1296,1234,14,1282,17629
15000US060730200142,2611,1673,186,2425,17630
15000US060730200143,1889,1618,160,1729,17631
15000US060730200144,1775,1210,306,1469,17632
15000US060730200151,2253,1779,101,2152,17633
15000US060730200152,2475,2084,109,2366,17634
15000US060730200161,2193,1781,54,2139,17635
15000US060730200162,1909,1642,51,1858,17636
15000US060730200163,3079,2717,163,2916,17637
15000US060730200164,1250,892,260,990,17638
15000US060730200165,1147,936,164,983,17639
15000US060730200171,1472,896,465,1007,17640
15000US060730200172,1286,340,757,529,17641
15000US060730200173,674,220,363,311,17642
15000US060730200181,1450,226,792,658,17643
15000US060730200182,1561,225,1327,234,17644
15000US060730200183,1851,223,1572,279,17645
15000US060730200184,3234,1150,1676,1558,17646
15000US060730200191,2058,1637,273,1785,17647
15000US060730200192,2101,800,923,1178,17648
15000US060730200193,2869,1727,936,1933,17649
15000US060730200201,4770,2150,1311,3459,17650
15000US060730200202,2838,1444,525,2313,17651
15000US060730200211,3239,805,1706,1533,17652
15000US060730200212,1907,202,1500,407,17653
15000US060730200213,1098,343,465,633,17654
15000US060730200221,2689,1924,226,2463,17655
15000US060730200222,1641,1144,273,1368,17656
15000US060730200223,3672,1084,2130,1542,17657
15000US060730200231,2658,1425,921,1737,17658
15000US060730200232,1479,1048,230,1249,17659
15000US060730200241,1979,1258,412,1567,17660
15000US060730200242,930,482,383,547,17661
15000US060730200243,1294,479,607,687,17662
15000US060730200251,1542,733,363,1179,17663
15000US060730200252,1591,718,751,840,17664
15000US060730200253,2042,1085,693,1349,17665
15000US060730200261,827,653,114,713,17666
15000US060730200262,2176,1197,491,1685,17667
15000US060730200263,1384,890,216,1168,17668
15000US060730200271,12052,8464,1285,10767,17669
15000US060730200272,820,586,101,719,17670
15000US060730200273,2857,1968,775,2082,17671
15000US060730200281,1976,54,1880,96,17672
15000US060730200282,2250,264,1894,356,17673
15000US060730200291,2304,1067,1018,1286,17674
15000US060730200292,755,296,334,421,17675
15000US060730200293,2705,149,2297,408,17676
15000US060730201031,4173,2098,1311,2862,17677
15000US060730201032,2277,1119,842,1435,17678
15000US060730201033,3452,2423,753,2699,17679
15000US060730201034,907,655,191,716,17680
15000US060730201051,1195,794,212,983,17681
15000US060730201052,2818,1320,1093,1725,17682
15000US060730201061,2138,1117,737,1401,17683
15000US060730201062,1443,325,1047,396,17684
15000US060730201071,2041,1243,462,1579,17685
15000US060730201072,2084,713,1288,796,17686
15000US060730201081,1748,116,1554,194,17687
15000US060730201082,1209,556,546,663,17688
15000US060730201083,1710,246,1346,364,17689
15000US060730201084,1355,340,831,524,17690
15000US060730201091,1030,352,625,405,17691
15000US060730201092,1916,412,1429,487,17692
15000US060730201093,965,363,469,496,17693
15000US060730201094,1681,825,610,1071,17694
15000US060730202021,2335,320,1836,499,17695
15000US060730202022,2937,248,2540,397,17696
15000US060730202023,1865,188,1536,329,17697
15000US060730202061,1480,434,957,523,17698
15000US060730202062,1588,440,1026,562,17699
15000US060730202063,2410,453,1837,573,17700
15000US060730202071,2622,469,2034,588,17701
15000US060730202072,2563,725,1633,930,17702
15000US060730202081,2638,715,1777,861,17703
15000US060730202091,2272,606,1610,662,17704
15000US060730202092,2139,577,1109,1030,17705
15000US060730202093,896,540,287,609,17706
15000US060730202101,2494,938,953,1541,17707
15000US060730202102,2336,809,1317,1019,17708
15000US060730202111,1258,452,730,528,17709
15000US060730202112,2137,533,1548,589,17710
15000US060730202113,2037,521,1180,857,17711
15000US060730202114,1609,477,755,854,17712
15000US060730202131,1643,154,1457,186,17713
15000US060730202132,970,312,582,388,17714
15000US060730202133,1265,88,1097,168,17715
15000US060730202141,2045,552,1409,636,17716
15000US060730202142,2719,822,1699,1020,17717
15000US060730202143,1310,152,1150,160,17718
15000US060730203041,1816,1380,302,1514,17719
15000US060730203042,880,514,131,749,17720
15000US060730203043,1673,1013,336,1337,17721
15000US060730203044,2066,1226,661,1405,17722
15000US060730203051,2986,2016,302,2684,17723
15000US060730203052,1301,507,636,665,17724
15000US060730203053,1781,867,723,1058,17725
15000US060730203061,6964,4497,1239,5725,17726
15000US060730203062,2017,1125,433,1584,17727
15000US060730203071,2631,1856,369,2262,17728
15000US060730203072,1065,724,176,889,17729
15000US060730203073,2002,719,1121,881,17730
15000US060730203074,1895,1043,799,1096,17731
15000US060730203081,838,422,87,751,17732
15000US060730203082,1343,525,796,547,17733
15000US060730203083,3269,1855,862,2407,17734
15000US060730203091,2228,1406,653,1575,17735
15000US060730203092,2143,357,1505,638,17736
15000US060730204011,965,789,122,843,17737
15000US060730204012,1364,1221,85,1279,17738
15000US060730204031,2001,799,760,1241,17739
15000US060730204032,2057,1233,572,1485,17740
15000US060730204041,1260,596,439,821,17741
15000US060730204042,1713,778,517,1196,17742
15000US060730204043,1737,1226,156,1581,17743
15000US060730204051,1312,1146,93,1219,17744
15000US060730204052,1857,1481,147,1710,17745
15000US060730205001,1061,582,441,620,17746
15000US060730205002,2128,707,1365,763,17747
15000US060730205003,2380,765,1443,937,17748
15000US060730206011,1896,692,1100,796,17749
15000US060730206012,1736,281,1195,541,17750
15000US060730206013,2409,460,1913,496,17751
15000US060730206021,1295,93,1194,101,17752
15000US060730206022,1540,763,552,988,17753
15000US060730206023,1477,617,738,739,17754
15000US060730206024,1762,1091,493,1269,17755
15000US060730207051,1328,474,563,765,17756
15000US060730207052,1181,494,583,598,17757
15000US060730207053,2482,1748,574,1908,17758
15000US060730207061,2748,2269,268,2480,17759
15000US060730207062,1727,818,785,942,17760
15000US060730207063,1884,1515,77,1807,17761
15000US060730207071,3173,810,2172,1001,17762
15000US060730207072,1986,742,1019,967,17763
15000US060730207081,1864,1210,264,1600,17764
15000US060730207082,1993,982,840,1153,17765
15000US060730207091,3083,1992,607,2476,17766
15000US060730207092,1131,844,102,1029,17767
15000US060730207093,2006,1099,426,1580,17768
15000US060730207094,1816,455,827,989,17769
15000US060730207101,1638,1106,330,1308,17770
15000US060730208011,1153,599,542,611,17771
15000US060730208012,2140,1880,94,2046,17772
15000US060730208013,2056,1610,363,1693,17773
15000US060730208051,1498,899,563,935,17774
15000US060730208052,2336,1060,897,1439,17775
15000US060730208061,1597,848,685,912,17776
15000US060730208062,2403,1446,912,1491,17777
15000US060730208063,2031,1643,271,1760,17778
15000US060730208071,2756,2025,581,2175,17779
15000US060730208091,2242,1226,630,1612,17780
15000US060730208092,3787,2032,1623,2164,17781
15000US060730208093,2279,1134,812,1467,17782
15000US060730208101,934,758,127,807,17783
15000US060730208102,676,509,159,517,17784
15000US060730208103,3671,3031,503,3168,17785
15000US060730208111,1575,1260,221,1354,17786
15000US060730208112,1854,1530,134,1720,17787
15000US060730208113,2399,2001,263,2136,17788
15000US060730209021,325,251,29,296,17789
15000US060730209022,1940,1711,108,1832,17790
15000US060730209031,315,239,56,259,17791
15000US060730209032,259,100,41,218,17792
15000US060730209033,2426,1553,355,2071,17793
15000US060730209041,1064,784,193,871,17794
15000US060730209042,552,512,31,521,17795
15000US060730209043,575,499,76,499,17796
15000US060730210001,864,773,91,773,17797
15000US060730210002,694,291,386,308,17798
15000US060730210003,790,680,110,680,17799
15000US060730210004,871,613,1,870,17800
15000US060730211001,1645,474,1171,474,17801
15000US060730211002,1698,892,209,1489,17802
15000US060730211003,3546,2207,1044,2502,17803
15000US060730211004,330,163,111,219,17804
15000US060730212021,1716,1220,300,1416,17805
15000US060730212022,1518,982,480,1038,17806
15000US060730212041,2424,2199,103,2321,17807
15000US060730212042,2624,2102,442,2182,17808
15000US060730212043,772,601,69,703,17809
15000US060730212051,2721,2127,547,2174,17810
15000US060730212052,1714,1269,385,1329,17811
15000US060730212053,3102,1950,828,2274,17812
15000US060730212061,2806,2312,233,2573,17813
15000US060730213021,5270,1772,2242,3028,17814
15000US060730213022,2729,1955,719,2010,17815
15000US060730213031,1816,928,409,1407,17816
15000US060730213032,6304,2521,2150,4154,17817
15000US060730213033,743,468,275,468,17818
15000US060730213041,1488,1012,384,1104,17819
15000US060730213042,1057,709,189,868,17820
15000US060730214001,4074,2642,491,3583,17821
15000US060730214002,1751,1050,461,1290,17822
15000US060730214003,1138,854,163,975,17823
15000US060730215001,4899,2136,845,4054,17824
15000US060730215002,3233,2062,0,3233,17825
15000US060730215003,728,364,109,619,17826
15000US060730216001,2607,1625,588,2019,17827
15000US060730216002,1062,855,164,898,17828
15000US060730218001,1284,1200,35,1249,17829
15000US060730218002,1267,1017,201,1066,17830
15000US060730219001,4469,1632,1344,3125,17831
15000US060730219002,776,73,636,140,17832
15000US060730220001,1804,141,696,1108,17833
15000US060730220002,2461,176,1444,1017,17834
15000US060730221001,2360,2061,210,2150,17835
15000US060730221002,3790,1580,1599,2191,17836
15000US060730221003,3430,2424,422,3008,17837
15000US060739901000,0,0,0,0,17838
15000US060750101001,1101,473,79,1022,17839
15000US060750101002,2899,1378,381,2518,17840
15000US060750102001,1491,1092,119,1372,17841
15000US060750102002,1736,1507,48,1688,17842
15000US060750102003,1073,873,0,1073,17843
15000US060750103001,1910,1064,195,1715,17844
15000US060750103002,1263,482,331,932,17845
15000US060750103003,1168,777,32,1136,17846
15000US060750104001,683,390,11,672,17847
15000US060750104002,1678,951,134,1544,17848
15000US060750104003,1635,1062,179,1456,17849
15000US060750104004,1032,428,194,838,17850
15000US060750105001,934,450,77,857,17851
15000US060750105002,1750,920,72,1678,17852
15000US060750106001,1059,505,39,1020,17853
15000US060750106002,1278,366,82,1196,17854
15000US060750106003,1230,326,26,1204,17855
15000US060750107001,879,477,42,837,17856
15000US060750107002,1364,290,77,1287,17857
15000US060750107003,1857,196,190,1667,17858
15000US060750107004,1409,57,0,1409,17859
15000US060750108001,1299,630,63,1236,17860
15000US060750108002,1409,443,59,1350,17861
15000US060750108003,1806,876,305,1501,17862
15000US060750109001,845,716,25,820,17863
15000US060750109002,1869,1189,63,1806,17864
15000US060750109003,1733,1269,0,1733,17865
15000US060750110001,712,366,97,615,17866
15000US060750110002,1915,993,144,1771,17867
15000US060750110003,2115,951,57,2058,17868
15000US060750111001,1967,1001,109,1858,17869
15000US060750111002,1944,1056,206,1738,17870
15000US060750111003,1170,890,45,1125,17871
15000US060750112001,1476,713,72,1404,17872
15000US060750112002,1348,892,37,1311,17873
15000US060750112003,511,284,23,488,17874
15000US060750113001,1649,334,0,1649,17875
15000US060750113002,1412,307,37,1375,17876
15000US060750117001,835,295,127,708,17877
15000US060750117002,881,278,167,714,17878
15000US060750118001,1562,167,95,1467,17879
15000US060750119011,1084,720,42,1042,17880
15000US060750119012,1486,697,214,1272,17881
15000US060750119021,2186,1045,355,1831,17882
15000US060750119022,653,300,64,589,17883
15000US060750120001,1765,934,84,1681,17884
15000US060750120002,2197,786,317,1880,17885
15000US060750121001,2568,1226,384,2184,17886
15000US060750121002,1340,473,416,924,17887
15000US060750122011,2937,953,691,2246,17888
15000US060750122012,1791,649,619,1172,17889
15000US060750122021,3271,1144,900,2371,17890
15000US060750123011,1182,325,468,714,17891
15000US060750123012,1007,261,255,752,17892
15000US060750123021,1447,665,281,1166,17893
15000US060750123022,1082,393,80,1002,17894
15000US060750124011,2310,832,469,1841,17895
15000US060750124012,2283,689,778,1505,17896
15000US060750124021,1060,347,393,667,17897
15000US060750124022,873,440,90,783,17898
15000US060750124023,1735,539,267,1468,17899
15000US060750125011,2388,551,472,1916,17900
15000US060750125012,1272,479,179,1093,17901
15000US060750125021,1624,310,229,1395,17902
15000US060750125022,1961,383,411,1550,17903
15000US060750126011,2408,1841,329,2079,17904
15000US060750126021,1605,1255,70,1535,17905
15000US060750126022,1295,1067,35,1260,17906
15000US060750127001,1625,1342,30,1595,17907
15000US060750127002,1451,1179,0,1451,17908
15000US060750127003,784,560,152,632,17909
15000US060750128001,2127,1757,175,1952,17910
15000US060750128002,850,696,154,696,17911
15000US060750128003,1298,864,90,1208,17912
15000US060750128004,508,349,76,432,17913
15000US060750129011,1063,898,35,1028,17914
15000US060750129012,1668,1308,71,1597,17915
15000US060750129021,1389,976,140,1249,17916
15000US060750129022,1293,906,65,1228,17917
15000US060750129023,956,734,42,914,17918
15000US060750130001,1195,851,63,1132,17919
15000US060750130002,1000,765,18,982,17920
15000US060750130003,1606,1298,114,1492,17921
15000US060750130004,987,882,75,912,17922
15000US060750131011,1976,1450,159,1817,17923
15000US060750131012,2096,1430,168,1928,17924
15000US060750131021,1412,1090,74,1338,17925
15000US060750131022,1501,1089,152,1349,17926
15000US060750132001,1798,1219,125,1673,17927
15000US060750132002,547,462,0,547,17928
15000US060750132003,1532,1056,88,1444,17929
15000US060750133001,706,465,136,570,17930
15000US060750133002,1119,767,16,1103,17931
15000US060750133003,1348,890,124,1224,17932
15000US060750133004,737,569,38,699,17933
15000US060750133005,651,463,31,620,17934
15000US060750134001,991,648,69,922,17935
15000US060750134002,1947,1511,74,1873,17936
15000US060750134003,1062,797,54,1008,17937
15000US060750135001,1402,1066,100,1302,17938
15000US060750135002,1302,750,82,1220,17939
15000US060750151001,1370,962,98,1272,17940
15000US060750151002,808,327,81,727,17941
15000US060750152001,2024,1161,54,1970,17942
15000US060750152002,1088,731,74,1014,17943
15000US060750152003,1155,717,94,1061,17944
15000US060750153001,990,659,66,924,17945
15000US060750153002,1244,714,150,1094,17946
15000US060750154001,1128,380,107,1021,17947
15000US060750154002,1159,771,47,1112,17948
15000US060750154003,1456,1017,87,1369,17949
15000US060750154004,877,464,46,831,17950
15000US060750154005,1541,1136,39,1502,17951
15000US060750155001,1785,990,187,1598,17952
15000US060750155002,1305,502,121,1184,17953
15000US060750155003,561,328,11,550,17954
15000US060750156001,660,271,6,654,17955
15000US060750156002,1635,865,226,1409,17956
15000US060750156003,979,463,48,931,17957
15000US060750157001,1423,604,209,1214,17958
15000US060750157002,1867,1370,123,1744,17959
15000US060750157003,1980,1079,100,1880,17960
15000US060750157004,3640,1528,774,2866,17961
15000US060750158011,506,97,34,472,17962
15000US060750158012,2327,750,137,2190,17963
15000US060750158013,1288,580,211,1077,17964
15000US060750158021,1962,1174,246,1716,17965
15000US060750158022,1359,926,99,1260,17966
15000US060750159001,1698,732,187,1511,17967
15000US060750159002,2634,830,211,2423,17968
15000US060750160001,2769,1240,249,2520,17969
15000US060750161001,1575,42,106,1469,17970
15000US060750161002,1106,473,36,1070,17971
15000US060750161003,947,195,12,935,17972
15000US060750161004,1870,575,107,1763,17973
15000US060750162001,735,397,90,645,17974
15000US060750162002,964,516,111,853,17975
15000US060750162003,1238,928,130,1108,17976
15000US060750163001,586,83,15,571,17977
15000US060750163002,1077,551,149,928,17978
15000US060750163003,2806,1796,263,2543,17979
15000US060750164001,2349,1644,181,2168,17980
15000US060750164002,1971,1208,109,1862,17981
15000US060750165001,2321,1138,409,1912,17982
15000US060750165002,1150,888,92,1058,17983
15000US060750165003,1299,1006,73,1226,17984
15000US060750165004,1120,812,128,992,17985
15000US060750166001,1980,1362,72,1908,17986
15000US060750166002,1252,852,108,1144,17987
15000US060750166003,1413,916,157,1256,17988
15000US060750166004,968,739,52,916,17989
15000US060750167001,1685,1352,148,1537,17990
15000US060750167002,578,416,84,494,17991
15000US060750167003,1183,863,131,1052,17992
15000US060750167004,1417,845,205,1212,17993
15000US060750168011,1176,867,62,1114,17994
15000US060750168012,1192,887,79,1113,17995
15000US060750168013,864,563,156,708,17996
15000US060750168021,972,567,107,865,17997
15000US060750168022,1406,770,194,1212,17998
15000US060750168023,915,398,339,576,17999
15000US060750169001,1859,1324,225,1634,18000
15000US060750169002,1048,703,63,985,18001
15000US060750170001,973,749,96,877,18002
15000US060750170002,2235,1715,129,2106,18003
15000US060750170003,751,558,54,697,18004
15000US060750171011,1515,1105,136,1379,18005
15000US060750171012,1210,1000,68,1142,18006
15000US060750171013,1089,909,60,1029,18007
15000US060750171021,1114,751,110,1004,18008
15000US060750171022,641,512,31,610,18009
15000US060750171023,2005,1688,131,1874,18010
15000US060750176011,0,0,0,0,18011
15000US060750176012,2390,833,319,2071,18012
15000US060750176013,2454,705,494,1960,18013
15000US060750176014,1408,340,75,1333,18014
15000US060750176015,1582,261,87,1495,18015
15000US060750177001,168,83,32,136,18016
15000US060750177002,1623,628,553,1070,18017
15000US060750178011,1094,164,18,1076,18018
15000US060750178012,2115,799,104,2011,18019
15000US060750178021,3168,1165,504,2664,18020
15000US060750178022,1688,732,268,1420,18021
15000US060750179021,3090,762,980,2110,18022
15000US060750180001,2175,868,252,1923,18023
15000US060750180002,1104,406,200,904,18024
15000US060750201001,1261,509,121,1140,18025
15000US060750201002,1823,503,1004,819,18026
15000US060750201003,1100,242,647,453,18027
15000US060750201004,1775,382,1013,762,18028
15000US060750202001,1085,601,106,979,18029
15000US060750202002,2316,1309,253,2063,18030
15000US060750202003,2612,1250,911,1701,18031
15000US060750203001,1245,678,129,1116,18032
15000US060750203002,737,557,73,664,18033
15000US060750203003,1179,780,244,935,18034
15000US060750204011,1188,820,82,1106,18035
15000US060750204012,721,514,15,706,18036
15000US060750204013,1209,880,65,1144,18037
15000US060750204021,2339,1435,317,2022,18038
15000US060750204022,2122,1353,495,1627,18039
15000US060750205001,962,753,122,840,18040
15000US060750205002,917,753,38,879,18041
15000US060750205003,1011,800,64,947,18042
15000US060750206001,1496,1111,107,1389,18043
15000US060750206002,978,639,87,891,18044
15000US060750206003,1102,774,36,1066,18045
15000US060750206004,1476,1214,67,1409,18046
15000US060750207001,2172,1415,191,1981,18047
15000US060750207002,1886,1216,279,1607,18048
15000US060750207003,1111,714,270,841,18049
15000US060750208001,914,356,270,644,18050
15000US060750208002,1964,808,647,1317,18051
15000US060750208003,1511,471,752,759,18052
15000US060750208004,1903,471,983,920,18053
15000US060750209001,2137,601,1170,967,18054
15000US060750209002,989,280,460,529,18055
15000US060750209003,837,283,407,430,18056
15000US060750209004,964,501,347,617,18057
15000US060750210001,1056,511,154,902,18058
15000US060750210002,1046,833,145,901,18059
15000US060750210003,1126,788,75,1051,18060
15000US060750210004,1390,570,583,807,18061
15000US060750211001,1166,946,64,1102,18062
15000US060750211002,934,541,97,837,18063
15000US060750211003,1109,799,174,935,18064
15000US060750211004,971,713,73,898,18065
15000US060750212001,826,622,39,787,18066
15000US060750212002,1285,920,139,1146,18067
15000US060750212003,987,752,59,928,18068
15000US060750213001,1027,677,49,978,18069
15000US060750213002,1687,1256,152,1535,18070
15000US060750214001,786,611,28,758,18071
15000US060750214002,1523,1009,298,1225,18072
15000US060750214003,1427,963,131,1296,18073
15000US060750215001,797,580,62,735,18074
15000US060750215002,1443,1086,78,1365,18075
15000US060750215003,752,567,55,697,18076
15000US060750215004,883,655,89,794,18077
15000US060750215005,1045,799,107,938,18078
15000US060750216001,2266,1640,136,2130,18079
15000US060750216002,2285,904,492,1793,18080
15000US060750217001,1072,534,77,995,18081
15000US060750217002,1086,768,116,970,18082
15000US060750217003,1936,939,390,1546,18083
15000US060750218001,1228,923,103,1125,18084
15000US060750218002,1177,864,104,1073,18085
15000US060750218003,757,456,154,603,18086
15000US060750218004,950,745,113,837,18087
15000US060750226001,743,475,99,644,18088
15000US060750226002,1339,762,85,1254,18089
15000US060750227021,1119,783,77,1042,18090
15000US060750227022,1120,762,145,975,18091
15000US060750227041,1093,698,102,991,18092
15000US060750227042,2318,1641,139,2179,18093
15000US060750228011,1096,500,113,983,18094
15000US060750228012,2413,944,1061,1352,18095
15000US060750228013,1769,666,718,1051,18096
15000US060750228021,663,304,214,449,18097
15000US060750228022,1739,477,888,851,18098
15000US060750228031,1741,642,893,848,18099
15000US060750228032,1627,670,671,956,18100
15000US060750228033,1269,437,660,609,18101
15000US060750229011,1685,748,705,980,18102
15000US060750229012,2026,440,1176,850,18103
15000US060750229013,1980,393,1583,397,18104
15000US060750229021,1282,595,495,787,18105
15000US060750229022,1430,489,620,810,18106
15000US060750229031,1646,401,981,665,18107
15000US060750229032,721,261,294,427,18108
15000US060750229033,781,283,249,532,18109
15000US060750230011,1983,181,199,1784,18110
15000US060750230012,1547,52,164,1383,18111
15000US060750230013,1674,95,23,1651,18112
15000US060750230031,3277,237,590,2687,18113
15000US060750230032,1053,92,200,853,18114
15000US060750231021,2915,197,254,2661,18115
15000US060750231022,1738,54,345,1393,18116
15000US060750231031,371,48,31,340,18117
15000US060750231032,2533,78,495,2038,18118
15000US060750232001,1426,63,364,1062,18119
15000US060750232002,1610,101,878,732,18120
15000US060750232003,1378,87,480,898,18121
15000US060750233001,3203,237,618,2585,18122
15000US060750234001,1417,88,429,988,18123
15000US060750234002,1759,64,607,1152,18124
15000US060750251001,1815,1037,397,1418,18125
15000US060750251002,858,442,68,790,18126
15000US060750251003,947,379,225,722,18127
15000US060750252001,1863,732,745,1118,18128
15000US060750252002,1644,1041,198,1446,18129
15000US060750252003,1126,735,174,952,18130
15000US060750252004,1212,896,248,964,18131
15000US060750253001,1061,708,191,870,18132
15000US060750253002,752,503,90,662,18133
15000US060750253003,800,317,272,528,18134
15000US060750253004,1736,821,534,1202,18135
15000US060750254011,1450,586,532,918,18136
15000US060750254012,1167,596,449,718,18137
15000US060750254013,1427,331,827,600,18138
15000US060750254021,1149,516,120,1029,18139
15000US060750254022,835,211,400,435,18140
15000US060750254023,981,610,96,885,18141
15000US060750254031,1950,681,928,1022,18142
15000US060750254032,3365,552,1182,2183,18143
15000US060750255001,1621,373,564,1057,18144
15000US060750255002,1513,279,486,1027,18145
15000US060750255003,1402,307,306,1096,18146
15000US060750255004,916,154,0,916,18147
15000US060750255005,1440,231,809,631,18148
15000US060750255006,2554,553,1209,1345,18149
15000US060750256001,2130,245,480,1650,18150
15000US060750256002,712,112,122,590,18151
15000US060750256003,1033,325,158,875,18152
15000US060750256004,1629,221,412,1217,18153
15000US060750257011,1928,254,310,1618,18154
15000US060750257012,1997,272,556,1441,18155
15000US060750257013,1191,62,290,901,18156
15000US060750257021,1553,86,617,936,18157
15000US060750257022,1627,120,227,1400,18158
15000US060750257023,1559,66,428,1131,18159
15000US060750258001,1103,124,340,763,18160
15000US060750258002,958,167,418,540,18161
15000US060750259001,1905,428,525,1380,18162
15000US060750259002,1951,414,456,1495,18163
15000US060750259003,642,82,123,519,18164
15000US060750260011,2720,337,1099,1621,18165
15000US060750260012,3181,252,1464,1717,18166
15000US060750260021,1609,386,536,1073,18167
15000US060750260022,1750,445,494,1256,18168
15000US060750260031,2953,223,1598,1355,18169
15000US060750260032,2308,467,972,1336,18170
15000US060750260041,2629,312,1203,1426,18171
15000US060750260042,2295,196,491,1804,18172
15000US060750261001,1559,65,769,790,18173
15000US060750261002,2459,230,467,1992,18174
15000US060750261003,2022,206,667,1355,18175
15000US060750261004,1116,82,160,956,18176
15000US060750262001,1561,194,282,1279,18177
15000US060750262002,1920,178,431,1489,18178
15000US060750262003,1393,38,277,1116,18179
15000US060750262004,1779,170,541,1238,18180
15000US060750262005,1018,127,189,829,18181
15000US060750263011,1320,328,673,647,18182
15000US060750263012,2250,203,649,1601,18183
15000US060750263013,1260,120,68,1192,18184
15000US060750263021,1033,151,419,614,18185
15000US060750263022,1429,121,88,1341,18186
15000US060750263023,2255,374,688,1567,18187
15000US060750263031,1953,161,486,1467,18188
15000US060750263032,2891,412,906,1985,18189
15000US060750264011,1986,64,207,1779,18190
15000US060750264012,1724,93,390,1334,18191
15000US060750264021,949,197,183,766,18192
15000US060750264022,2181,96,799,1382,18193
15000US060750264023,1604,101,400,1204,18194
15000US060750264031,1539,53,290,1249,18195
15000US060750264032,2329,150,536,1793,18196
15000US060750264041,1694,44,520,1174,18197
15000US060750264042,1129,58,104,1025,18198
15000US060750301011,1419,936,183,1236,18199
15000US060750301012,1762,993,87,1675,18200
15000US060750301013,1088,625,143,945,18201
15000US060750301014,667,355,44,623,18202
15000US060750301021,2888,1738,262,2626,18203
15000US060750301022,1322,796,40,1282,18204
15000US060750301023,863,687,133,730,18205
15000US060750302011,1806,1059,90,1716,18206
15000US060750302012,1178,578,59,1119,18207
15000US060750302013,1343,681,95,1248,18208
15000US060750302021,1381,762,39,1342,18209
15000US060750302022,1676,721,482,1194,18210
15000US060750302023,1564,631,160,1404,18211
15000US060750303011,1164,521,65,1099,18212
15000US060750303012,2087,1050,69,2018,18213
15000US060750303013,1257,590,187,1070,18214
15000US060750303014,1516,504,49,1467,18215
15000US060750303021,1486,424,39,1447,18216
15000US060750303022,1272,650,102,1170,18217
15000US060750303023,1385,516,212,1173,18218
15000US060750304001,1086,737,85,1001,18219
15000US060750304002,1283,763,99,1184,18220
15000US060750304003,1482,392,0,1482,18221
15000US060750304004,796,306,0,796,18222
15000US060750304005,921,471,17,904,18223
15000US060750305001,874,534,156,718,18224
15000US060750305002,978,332,114,864,18225
15000US060750305003,1098,487,103,995,18226
15000US060750306001,789,339,154,635,18227
15000US060750306002,696,429,60,636,18228
15000US060750306003,939,488,108,831,18229
15000US060750307001,2631,1056,472,2159,18230
15000US060750307002,1610,1101,26,1584,18231
15000US060750307003,2432,1331,306,2126,18232
15000US060750308001,981,684,91,890,18233
15000US060750308002,563,400,0,563,18234
15000US060750308003,889,297,130,759,18235
15000US060750308004,2164,1139,173,1991,18236
15000US060750308005,1539,535,240,1299,18237
15000US060750309001,912,288,29,883,18238
15000US060750309002,1397,831,35,1362,18239
15000US060750309003,1269,613,48,1221,18240
15000US060750309004,1151,450,88,1063,18241
15000US060750309005,618,199,96,522,18242
15000US060750309006,796,486,202,594,18243
15000US060750309007,748,181,26,722,18244
15000US060750310001,780,544,57,723,18245
15000US060750310002,1415,614,260,1155,18246
15000US060750310003,1406,556,181,1225,18247
15000US060750311001,1387,587,128,1259,18248
15000US060750311002,1225,537,324,901,18249
15000US060750311003,947,315,149,798,18250
15000US060750311004,1363,582,164,1199,18251
15000US060750311005,1963,981,165,1798,18252
15000US060750312011,2491,442,271,2220,18253
15000US060750312012,2044,283,307,1737,18254
15000US060750312013,1038,219,85,953,18255
15000US060750312014,1758,263,220,1538,18256
15000US060750312021,1349,156,85,1264,18257
15000US060750312022,1871,188,285,1586,18258
15000US060750313011,1333,250,48,1285,18259
15000US060750313012,1722,238,169,1553,18260
15000US060750313013,1422,308,124,1298,18261
15000US060750313021,1575,240,298,1277,18262
15000US060750313022,1517,53,289,1228,18263
15000US060750313023,2897,359,532,2365,18264
15000US060750314001,747,82,94,653,18265
15000US060750314002,1672,183,222,1450,18266
15000US060750314003,1878,181,711,1167,18267
15000US060750314004,1341,82,144,1197,18268
15000US060750314005,1352,157,441,911,18269
15000US060750326011,1694,591,77,1617,18270
15000US060750326012,1837,611,202,1635,18271
15000US060750326013,1377,506,61,1316,18272
15000US060750326021,1928,514,115,1813,18273
15000US060750326022,1442,517,66,1376,18274
15000US060750326023,1292,388,86,1206,18275
15000US060750327001,1277,623,14,1263,18276
15000US060750327002,1281,347,103,1178,18277
15000US060750327003,1210,268,106,1104,18278
15000US060750327004,848,244,55,793,18279
15000US060750327005,929,229,0,929,18280
15000US060750327006,867,323,62,805,18281
15000US060750327007,701,312,0,701,18282
15000US060750328011,1291,398,87,1204,18283
15000US060750328012,1517,482,147,1370,18284
15000US060750328013,1399,418,76,1323,18285
15000US060750328021,1300,329,40,1260,18286
15000US060750328022,1698,287,73,1625,18287
15000US060750328023,1385,333,29,1356,18288
15000US060750329011,1340,313,51,1289,18289
15000US060750329012,1416,487,141,1275,18290
15000US060750329013,1569,387,70,1499,18291
15000US060750329014,1432,376,147,1285,18292
15000US060750329021,1353,338,50,1303,18293
15000US060750329022,1607,401,78,1529,18294
15000US060750329023,1503,346,80,1423,18295
15000US060750330001,1310,740,91,1219,18296
15000US060750330002,1061,371,115,946,18297
15000US060750330003,1057,377,66,991,18298
15000US060750330004,1761,378,165,1596,18299
15000US060750330005,1555,713,145,1410,18300
15000US060750330006,1421,355,79,1342,18301
15000US060750331001,629,347,15,614,18302
15000US060750331002,958,345,18,940,18303
15000US060750331003,829,259,78,751,18304
15000US060750331004,1626,630,56,1570,18305
15000US060750332011,4165,1486,1274,2891,18306
15000US060750332031,2521,1014,219,2302,18307
15000US060750332032,1691,677,453,1238,18308
15000US060750332041,834,354,241,593,18309
15000US060750332042,1889,623,352,1537,18310
15000US060750332043,1539,367,78,1461,18311
15000US060750351001,1409,507,0,1409,18312
15000US060750351002,907,224,198,709,18313
15000US060750351003,1178,865,54,1124,18314
15000US060750351004,1017,483,65,952,18315
15000US060750351005,1638,385,329,1309,18316
15000US060750351006,1179,293,40,1139,18317
15000US060750351007,1540,307,4,1536,18318
15000US060750352011,1071,346,29,1042,18319
15000US060750352012,1106,472,46,1060,18320
15000US060750352013,1393,356,40,1353,18321
15000US060750352014,1354,745,57,1297,18322
15000US060750352015,917,237,149,768,18323
15000US060750352021,1848,713,172,1676,18324
15000US060750352022,1575,584,97,1478,18325
15000US060750352023,1227,638,38,1189,18326
15000US060750353001,790,150,64,726,18327
15000US060750353002,1976,574,82,1894,18328
15000US060750353003,1552,138,95,1457,18329
15000US060750353004,729,174,61,668,18330
15000US060750353005,1214,504,75,1139,18331
15000US060750353006,1253,190,133,1120,18332
15000US060750354001,1750,701,25,1725,18333
15000US060750354002,878,232,0,878,18334
15000US060750354003,1122,597,0,1122,18335
15000US060750354004,2049,163,115,1934,18336
15000US060750354005,674,406,0,674,18337
15000US060750401001,814,640,45,769,18338
15000US060750401002,1484,598,9,1475,18339
15000US060750401003,1416,660,72,1344,18340
15000US060750401004,811,632,47,764,18341
15000US060750402001,1667,1095,226,1441,18342
15000US060750402002,746,248,30,716,18343
15000US060750402003,1574,336,145,1429,18344
15000US060750402004,1576,1152,39,1537,18345
15000US060750426011,1909,728,416,1493,18346
15000US060750426012,2266,1288,24,2242,18347
15000US060750426021,827,484,20,807,18348
15000US060750426022,1105,622,94,1011,18349
15000US060750426023,1158,583,61,1097,18350
15000US060750427001,1628,700,66,1562,18351
15000US060750427002,1772,672,166,1606,18352
15000US060750427003,1497,714,19,1478,18353
15000US060750428001,1125,758,33,1092,18354
15000US060750428002,574,430,69,505,18355
15000US060750428003,757,565,29,728,18356
15000US060750451001,2217,1110,140,2077,18357
15000US060750451002,1415,908,14,1401,18358
15000US060750451003,1461,368,422,1039,18359
15000US060750452001,2283,1052,141,2142,18360
15000US060750452002,1754,803,174,1580,18361
15000US060750452003,610,375,31,579,18362
15000US060750452004,1409,381,369,1040,18363
15000US060750452005,1266,681,101,1165,18364
15000US060750476001,1876,579,118,1758,18365
15000US060750476002,1294,541,24,1270,18366
15000US060750476003,1010,395,0,1010,18367
15000US060750476004,1467,734,148,1319,18368
15000US060750477011,1653,752,108,1545,18369
15000US060750477012,1160,433,21,1139,18370
15000US060750477013,1509,473,83,1426,18371
15000US060750477021,1220,529,5,1215,18372
15000US060750477022,1276,383,99,1177,18373
15000US060750477023,1722,733,98,1624,18374
15000US060750478011,1261,274,112,1149,18375
15000US060750478012,1018,338,43,975,18376
15000US060750478013,1744,567,102,1642,18377
15000US060750478021,943,314,177,766,18378
15000US060750478022,1186,372,86,1100,18379
15000US060750478023,1808,565,122,1686,18380
15000US060750479011,908,188,28,880,18381
15000US060750479012,1670,1041,125,1545,18382
15000US060750479013,1297,754,138,1159,18383
15000US060750479014,1881,402,223,1658,18384
15000US060750479015,1104,486,39,1065,18385
15000US060750479021,1280,630,104,1176,18386
15000US060750479022,1255,578,57,1198,18387
15000US060750479023,1166,456,24,1142,18388
15000US060750601001,3828,3126,342,3486,18389
15000US060750604001,1662,943,154,1508,18390
15000US060750605021,585,41,310,275,18391
15000US060750605022,800,31,253,547,18392
15000US060750605023,2045,15,739,1306,18393
15000US060750607001,9541,3485,1160,8381,18394
15000US060750607002,120,32,0,120,18395
15000US060750607003,868,540,54,814,18396
15000US060750610001,2750,524,383,2367,18397
15000US060750610002,1980,151,268,1712,18398
15000US060750611001,727,86,6,721,18399
15000US060750611002,2773,80,14,2759,18400
15000US060750611003,1186,0,160,1026,18401
15000US060750612001,1443,142,256,1187,18402
15000US060750612002,2806,363,1437,1369,18403
15000US060750614001,2844,764,939,1905,18404
15000US060750614002,1857,1027,260,1597,18405
15000US060750614003,1334,911,41,1293,18406
15000US060750615001,1626,856,162,1464,18407
15000US060750615002,1543,649,65,1478,18408
15000US060750615003,2400,979,345,2055,18409
15000US060750615004,2307,1162,124,2183,18410
15000US060750615005,793,440,113,680,18411
15000US060750615006,4388,2600,331,4057,18412
15000US060759802001,320,179,16,304,18413
15000US060759803001,89,84,0,89,18414
15000US060759804011,0,0,0,0,18415
15000US060759805011,853,29,79,774,18416
15000US060759806001,476,75,112,364,18417
15000US060759809001,260,126,61,199,18418
15000US060759901000,0,0,0,0,18419
15000US060770001001,1518,276,645,873,18420
15000US060770001002,1101,208,427,674,18421
15000US060770001003,703,18,577,126,18422
15000US060770001004,754,41,422,332,18423
15000US060770003001,1005,199,552,453,18424
15000US060770003002,837,77,489,348,18425
15000US060770004011,804,211,357,447,18426
15000US060770004012,1086,344,166,920,18427
15000US060770004013,1343,460,742,601,18428
15000US060770004014,514,207,196,318,18429
15000US060770004021,859,240,251,608,18430
15000US060770004022,1378,168,1066,312,18431
15000US060770004023,555,100,186,369,18432
15000US060770004024,1305,329,611,694,18433
15000US060770005001,1333,286,1021,312,18434
15000US060770005002,1035,47,911,124,18435
15000US060770006001,768,5,618,150,18436
15000US060770006002,1123,86,937,186,18437
15000US060770007001,1278,9,906,372,18438
15000US060770007002,937,40,590,347,18439
15000US060770007003,959,25,750,209,18440
15000US060770007004,1284,131,950,334,18441
15000US060770008011,1561,117,1373,188,18442
15000US060770008012,3263,300,1942,1321,18443
15000US060770008013,2737,90,1936,801,18444
15000US060770009001,871,580,193,678,18445
15000US060770009002,1186,364,487,699,18446
15000US060770009003,827,422,358,469,18447
15000US060770009004,1318,188,659,659,18448
15000US060770009005,1722,207,1029,693,18449
15000US060770010001,1050,374,597,453,18450
15000US060770010002,1492,665,500,992,18451
15000US060770010003,1725,667,737,988,18452
15000US060770010004,471,375,9,462,18453
15000US060770011011,2204,847,887,1317,18454
15000US060770011012,1425,605,695,730,18455
15000US060770011013,1644,508,863,781,18456
15000US060770011021,1365,611,658,707,18457
15000US060770011022,1044,387,604,440,18458
15000US060770011023,707,361,222,485,18459
15000US060770011024,611,237,270,341,18460
15000US060770011025,915,202,605,310,18461
15000US060770012001,2136,1108,181,1955,18462
15000US060770012002,1239,570,469,770,18463
15000US060770012003,962,621,196,766,18464
15000US060770012004,1136,696,338,798,18465
15000US060770013001,1416,426,742,674,18466
15000US060770013002,1598,393,717,881,18467
15000US060770013003,1096,480,419,677,18468
15000US060770013004,1041,394,531,510,18469
15000US060770014001,1341,364,888,453,18470
15000US060770014002,1349,164,303,1046,18471
15000US060770014003,1014,314,460,554,18472
15000US060770014004,1101,553,334,767,18473
15000US060770015001,3703,703,1739,1964,18474
15000US060770015002,1981,390,1114,867,18475
15000US060770015003,1681,222,1081,600,18476
15000US060770015004,1004,327,527,477,18477
15000US060770016001,1001,329,560,441,18478
15000US060770016002,1192,212,712,480,18479
15000US060770017001,1979,247,1530,449,18480
15000US060770017002,1589,177,1398,191,18481
15000US060770017003,536,103,375,161,18482
15000US060770018001,1722,231,1330,392,18483
15000US060770018002,1940,551,1338,602,18484
15000US060770019001,1645,129,1350,295,18485
15000US060770019002,1565,54,1345,220,18486
15000US060770019003,1231,82,929,302,18487
15000US060770019004,925,39,543,382,18488
15000US060770020001,895,22,651,244,18489
15000US060770020002,1449,96,1059,390,18490
15000US060770020003,1380,128,990,390,18491
15000US060770021001,1379,0,918,461,18492
15000US060770021002,3054,182,2294,760,18493
15000US060770021003,1314,55,1092,222,18494
15000US060770022011,1180,14,863,317,18495
15000US060770022012,1564,71,938,626,18496
15000US060770022021,1668,22,1426,242,18497
15000US060770022022,2157,15,1924,233,18498
15000US060770022023,2083,106,1311,772,18499
15000US060770023001,1941,22,1672,269,18500
15000US060770023002,1914,61,1679,235,18501
15000US060770023003,1264,51,1006,258,18502
15000US060770024011,1461,47,954,507,18503
15000US060770024012,1150,26,740,410,18504
15000US060770024013,2301,122,1571,730,18505
15000US060770024021,922,81,679,243,18506
15000US060770024022,693,40,509,184,18507
15000US060770025031,1166,80,550,616,18508
15000US060770025032,1131,13,649,482,18509
15000US060770025041,2697,51,1265,1432,18510
15000US060770025042,1825,185,990,835,18511
15000US060770027011,1055,327,587,468,18512
15000US060770027012,1331,229,995,336,18513
15000US060770027013,2142,401,1674,468,18514
15000US060770027014,2052,481,1490,562,18515
15000US060770027021,1648,136,1470,178,18516
15000US060770027022,1666,138,1485,181,18517
15000US060770027023,1315,268,1047,268,18518
15000US060770028001,4881,518,3247,1634,18519
15000US060770028002,1346,0,649,697,18520
15000US060770031061,1276,832,265,1011,18521
15000US060770031062,1639,745,354,1285,18522
15000US060770031063,716,354,184,532,18523
15000US060770031081,1486,888,332,1154,18524
15000US060770031082,1677,920,182,1495,18525
15000US060770031083,1252,371,340,912,18526
15000US060770031091,1549,389,508,1041,18527
15000US060770031092,1802,803,443,1359,18528
15000US060770031093,1121,344,483,638,18529
15000US060770031094,1747,1362,328,1419,18530
15000US060770031101,1198,687,215,983,18531
15000US060770031102,828,173,447,381,18532
15000US060770031103,1735,493,695,1040,18533
15000US060770031111,1857,493,628,1229,18534
15000US060770031112,1871,662,660,1211,18535
15000US060770031121,2346,849,923,1423,18536
15000US060770031122,1049,589,258,791,18537
15000US060770031131,3285,500,1093,2192,18538
15000US060770031132,964,131,299,665,18539
15000US060770031133,1115,277,316,799,18540
15000US060770031134,645,263,53,592,18541
15000US060770031141,5280,2152,957,4323,18542
15000US060770031142,1160,561,367,793,18543
15000US060770031143,1687,1251,123,1564,18544
15000US060770031144,2065,1144,352,1713,18545
15000US060770032031,1560,965,323,1237,18546
15000US060770032032,1985,1262,415,1570,18547
15000US060770032051,650,446,170,480,18548
15000US060770032052,2795,1045,844,1951,18549
15000US060770032053,548,347,164,384,18550
15000US060770032081,4641,1195,1095,3546,18551
15000US060770032082,4146,1132,509,3637,18552
15000US060770032083,2493,628,569,1924,18553
15000US060770032084,2014,584,979,1035,18554
15000US060770032091,1184,590,270,914,18555
15000US060770032092,749,366,231,518,18556
15000US060770032093,1501,571,429,1072,18557
15000US060770032101,2023,656,547,1476,18558
15000US060770032102,955,277,470,485,18559
15000US060770032131,1373,380,367,1006,18560
15000US060770032132,1476,425,254,1222,18561
15000US060770032133,859,111,300,559,18562
15000US060770032134,1400,512,533,867,18563
15000US060770032141,1477,501,414,1063,18564
15000US060770032142,1987,754,677,1310,18565
15000US060770032151,988,470,245,743,18566
15000US060770032152,1173,519,296,877,18567
15000US060770032153,1785,626,595,1190,18568
15000US060770032161,2182,555,832,1350,18569
15000US060770032162,1339,301,485,854,18570
15000US060770032171,1827,261,645,1182,18571
15000US060770032172,1568,236,679,889,18572
15000US060770033051,1168,598,359,809,18573
15000US060770033052,1534,290,658,876,18574
15000US060770033053,1368,702,567,801,18575
15000US060770033061,3409,611,1227,2182,18576
15000US060770033062,1305,434,581,724,18577
15000US060770033071,1760,382,581,1179,18578
15000US060770033072,1690,376,1004,686,18579
15000US060770033073,1724,395,853,871,18580
15000US060770033081,1611,398,726,885,18581
15000US060770033101,1434,244,763,671,18582
15000US060770033102,2791,684,586,2205,18583
15000US060770033111,1769,447,701,1068,18584
15000US060770033112,1504,466,514,990,18585
15000US060770033121,915,73,591,324,18586
15000US060770033122,1135,60,555,580,18587
15000US060770033123,791,96,367,424,18588
15000US060770033131,1361,214,377,984,18589
15000US060770033132,1526,107,875,651,18590
15000US060770034031,1452,124,429,1023,18591
15000US060770034032,2154,281,627,1527,18592
15000US060770034033,1847,158,317,1530,18593
15000US060770034041,1042,57,0,1042,18594
15000US060770034042,2001,133,1046,955,18595
15000US060770034043,2474,123,877,1597,18596
15000US060770034044,754,416,94,660,18597
15000US060770034051,1568,140,446,1122,18598
15000US060770034052,972,116,617,355,18599
15000US060770034053,1905,325,380,1525,18600
15000US060770034061,2290,267,657,1633,18601
15000US060770034062,1589,344,761,828,18602
15000US060770034071,1206,186,444,762,18603
15000US060770034072,1680,218,660,1020,18604
15000US060770034091,1087,87,291,796,18605
15000US060770034092,2043,187,1244,799,18606
15000US060770034093,1216,160,346,870,18607
15000US060770034101,2096,276,859,1237,18608
15000US060770034102,2813,274,763,2050,18609
15000US060770034103,1000,210,346,654,18610
15000US060770035001,1867,534,239,1628,18611
15000US060770035002,1748,1551,134,1614,18612
15000US060770035003,16867,1625,6306,10561,18613
15000US060770035004,879,803,76,803,18614
15000US060770035005,549,458,32,517,18615
15000US060770036011,505,381,112,393,18616
15000US060770036012,1154,593,371,783,18617
15000US060770036013,617,518,69,548,18618
15000US060770036014,999,447,531,468,18619
15000US060770036021,569,441,109,460,18620
15000US060770036022,1908,486,1364,544,18621
15000US060770036023,1024,642,351,673,18622
15000US060770037001,1245,225,1011,234,18623
15000US060770037002,1440,445,829,611,18624
15000US060770037003,515,233,242,273,18625
15000US060770038011,7607,1167,3466,4141,18626
15000US060770038012,2103,288,617,1486,18627
15000US060770038013,2560,275,1171,1389,18628
15000US060770038021,1838,238,970,868,18629
15000US060770038022,1330,163,572,758,18630
15000US060770038023,3562,575,1155,2407,18631
15000US060770038031,905,239,498,407,18632
15000US060770038032,3770,511,2206,1564,18633
15000US060770038033,1072,288,544,528,18634
15000US060770039001,744,130,614,130,18635
15000US060770039002,721,217,485,236,18636
15000US060770040011,857,453,333,524,18637
15000US060770040012,1154,349,728,426,18638
15000US060770040021,12234,3228,3240,8994,18639
15000US060770041021,1051,671,335,716,18640
15000US060770041022,1161,654,507,654,18641
15000US060770041023,5438,953,963,4475,18642
15000US060770041041,3610,2524,597,3013,18643
15000US060770041051,1229,730,394,835,18644
15000US060770041052,2428,1430,746,1682,18645
15000US060770041053,1080,822,223,857,18646
15000US060770041061,693,434,224,469,18647
15000US060770041062,1004,609,339,665,18648
15000US060770042011,887,750,137,750,18649
15000US060770042012,1612,1209,352,1260,18650
15000US060770042013,1665,1054,448,1217,18651
15000US060770042014,1016,926,90,926,18652
15000US060770042015,990,475,480,510,18653
15000US060770042021,1592,1279,192,1400,18654
15000US060770042031,2791,1312,1066,1725,18655
15000US060770042032,1298,842,304,994,18656
15000US060770042041,859,611,167,692,18657
15000US060770042042,1228,1001,189,1039,18658
15000US060770042043,1039,778,231,808,18659
15000US060770043021,1146,739,118,1028,18660
15000US060770043022,1556,1031,459,1097,18661
15000US060770043023,2467,1203,682,1785,18662
15000US060770043024,738,510,228,510,18663
15000US060770043031,1187,948,72,1115,18664
15000US060770043032,1143,789,246,897,18665
15000US060770043033,540,278,220,320,18666
15000US060770043034,1955,1471,232,1723,18667
15000US060770043051,2172,1001,543,1629,18668
15000US060770043052,3722,2505,934,2788,18669
15000US060770043071,1476,1026,148,1328,18670
15000US060770043072,1596,871,626,970,18671
15000US060770043073,768,217,402,366,18672
15000US060770043081,1289,778,367,922,18673
15000US060770043082,2999,451,2314,685,18674
15000US060770044021,3515,1898,1137,2378,18675
15000US060770044022,1825,821,492,1333,18676
15000US060770044031,2798,327,1965,833,18677
15000US060770044032,1393,304,864,529,18678
15000US060770044041,1141,494,543,598,18679
15000US060770044042,1270,337,707,563,18680
15000US060770044043,1426,330,957,469,18681
15000US060770045011,954,797,58,896,18682
15000US060770045012,1600,323,945,655,18683
15000US060770045021,2336,322,1815,521,18684
15000US060770045022,1687,195,1399,288,18685
15000US060770046001,2158,1110,958,1200,18686
15000US060770046002,2030,1068,932,1098,18687
15000US060770046003,1074,1059,2,1072,18688
15000US060770046004,887,525,362,525,18689
15000US060770047011,977,403,508,469,18690
15000US060770047012,1905,1329,431,1474,18691
15000US060770047031,2457,1777,485,1972,18692
15000US060770047032,1159,714,388,771,18693
15000US060770047041,1667,587,1051,616,18694
15000US060770047042,1089,755,308,781,18695
15000US060770047043,1338,968,357,981,18696
15000US060770047044,891,611,208,683,18697
15000US060770048001,1012,522,467,545,18698
15000US060770048002,1698,1199,392,1306,18699
15000US060770048003,1150,263,849,301,18700
15000US060770048004,1909,855,970,939,18701
15000US060770049011,2586,1557,986,1600,18702
15000US060770049012,3122,2199,828,2294,18703
15000US060770049013,1926,1504,392,1534,18704
15000US060770049021,2284,1674,561,1723,18705
15000US060770049022,1151,862,229,922,18706
15000US060770049023,978,547,408,570,18707
15000US060770049024,1556,682,788,768,18708
15000US060770050011,2696,2092,571,2125,18709
15000US060770050012,1211,601,572,639,18710
15000US060770050013,1839,1644,104,1735,18711
15000US060770050031,830,619,206,624,18712
15000US060770050032,4852,3284,1131,3721,18713
15000US060770050041,2169,1705,351,1818,18714
15000US060770050042,1865,1212,578,1287,18715
15000US060770050043,1738,1096,579,1159,18716
15000US060770051061,1326,821,445,881,18717
15000US060770051062,4819,2184,1529,3290,18718
15000US060770051081,2029,747,948,1081,18719
15000US060770051082,491,234,252,239,18720
15000US060770051083,2220,838,1311,909,18721
15000US060770051091,1634,668,745,889,18722
15000US060770051092,1802,581,1021,781,18723
15000US060770051093,532,177,348,184,18724
15000US060770051101,472,396,76,396,18725
15000US060770051102,1622,872,642,980,18726
15000US060770051103,1032,500,524,508,18727
15000US060770051104,527,201,325,202,18728
15000US060770051105,3359,1094,1652,1707,18729
15000US060770051131,3452,2026,849,2603,18730
15000US060770051132,3145,1471,1369,1776,18731
15000US060770051141,2870,1188,889,1981,18732
15000US060770051142,7053,2508,2381,4672,18733
15000US060770051191,7285,1346,2027,5258,18734
15000US060770051192,453,95,254,199,18735
15000US060770051221,5880,2622,2093,3787,18736
15000US060770051231,3549,1398,1556,1993,18737
15000US060770051232,1120,423,293,827,18738
15000US060770051241,2411,1047,1141,1270,18739
15000US060770051242,951,391,341,610,18740
15000US060770051251,1166,538,501,665,18741
15000US060770051252,726,380,330,396,18742
15000US060770051261,1214,700,422,792,18743
15000US060770051262,3369,1104,1639,1730,18744
15000US060770051271,3779,924,1348,2431,18745
15000US060770051272,2031,275,976,1055,18746
15000US060770051291,1229,623,584,645,18747
15000US060770051292,2289,362,1431,858,18748
15000US060770051301,1023,336,513,510,18749
15000US060770051302,2395,646,1330,1065,18750
15000US060770051311,1641,245,1239,402,18751
15000US060770051312,1524,833,561,963,18752
15000US060770051313,1848,1039,753,1095,18753
15000US060770051321,967,405,482,485,18754
15000US060770051322,1096,505,535,561,18755
15000US060770051323,1120,551,360,760,18756
15000US060770051331,945,676,209,736,18757
15000US060770051332,1683,908,711,972,18758
15000US060770051333,1059,137,777,282,18759
15000US060770051334,420,164,211,209,18760
15000US060770051341,1710,829,753,957,18761
15000US060770051342,2083,927,828,1255,18762
15000US060770051343,1139,732,127,1012,18763
15000US060770051351,3458,2219,933,2525,18764
15000US060770051352,3588,1715,1198,2390,18765
15000US060770052021,2216,932,1112,1104,18766
15000US060770052022,5203,2424,1301,3902,18767
15000US060770052061,1453,280,377,1076,18768
15000US060770052062,910,783,127,783,18769
15000US060770052063,14357,4006,2566,11791,18770
15000US060770052064,2726,900,944,1782,18771
15000US060770052065,1922,865,868,1054,18772
15000US060770052071,2337,1123,601,1736,18773
15000US060770052072,12067,2814,3499,8568,18774
15000US060770052081,2859,1347,812,2047,18775
15000US060770052082,1633,865,552,1081,18776
15000US060770052083,1498,382,541,957,18777
15000US060770052091,2361,675,1141,1220,18778
15000US060770052092,2061,491,942,1119,18779
15000US060770052093,2800,884,934,1866,18780
15000US060770052101,8197,2974,2770,5427,18781
15000US060770052102,2881,1276,617,2264,18782
15000US060770052103,942,520,241,701,18783
15000US060770053021,1669,694,812,857,18784
15000US060770053022,1204,274,744,460,18785
15000US060770053023,1560,258,960,600,18786
15000US060770053024,1556,453,896,660,18787
15000US060770053025,1213,514,635,578,18788
15000US060770053031,1008,481,524,484,18789
15000US060770053032,1435,369,1004,431,18790
15000US060770053033,626,408,142,484,18791
15000US060770053034,1077,431,627,450,18792
15000US060770053035,522,115,242,280,18793
15000US060770053051,1519,376,815,704,18794
15000US060770053052,1366,388,683,683,18795
15000US060770053053,2565,855,1266,1299,18796
15000US060770053054,1467,634,543,924,18797
15000US060770053071,1506,499,606,900,18798
15000US060770053072,1708,469,814,894,18799
15000US060770053081,770,450,260,510,18800
15000US060770053082,665,375,233,432,18801
15000US060770053083,2745,791,1190,1555,18802
15000US060770054031,1230,514,451,779,18803
15000US060770054032,1385,493,661,724,18804
15000US060770054033,1858,810,731,1127,18805
15000US060770054034,1577,702,421,1156,18806
15000US060770054051,2644,853,1399,1245,18807
15000US060770054052,859,192,474,385,18808
15000US060770054061,2410,617,1352,1058,18809
15000US060770054062,927,354,525,402,18810
15000US060770055011,3571,1601,967,2604,18811
15000US060770055012,613,434,138,475,18812
15000US060770055021,1062,325,432,630,18813
15000US060770055022,891,510,243,648,18814
15000US060790100021,807,731,61,746,18815
15000US060790100022,3064,2170,474,2590,18816
15000US060790100023,612,575,37,575,18817
15000US060790100161,2734,2208,385,2349,18818
15000US060790100162,2516,905,1556,960,18819
15000US060790101011,1768,1449,263,1505,18820
15000US060790101021,1699,537,1142,557,18821
15000US060790101022,1421,146,1256,165,18822
15000US060790101023,1920,570,1132,788,18823
15000US060790101024,781,496,120,661,18824
15000US060790101025,1226,722,469,757,18825
15000US060790102011,3504,2469,1003,2501,18826
15000US060790102012,3605,3038,378,3227,18827
15000US060790102021,2027,1094,893,1134,18828
15000US060790102022,3632,2021,1305,2327,18829
15000US060790102041,2655,1721,919,1736,18830
15000US060790102042,3607,1643,1477,2130,18831
15000US060790102051,1127,564,510,617,18832
15000US060790102052,792,426,329,463,18833
15000US060790102053,2412,1464,912,1500,18834
15000US060790103001,2321,2086,185,2136,18835
15000US060790103002,2199,1753,382,1817,18836
15000US060790103003,1128,599,432,696,18837
15000US060790103004,3404,2366,924,2480,18838
15000US060790104031,1300,1105,183,1117,18839
15000US060790104032,1121,899,146,975,18840
15000US060790104033,1597,1172,356,1241,18841
15000US060790104041,1246,1022,129,1117,18842
15000US060790104042,934,435,470,464,18843
15000US060790105031,1368,1051,261,1107,18844
15000US060790105032,2287,1885,308,1979,18845
15000US060790105033,1085,882,39,1046,18846
15000US060790105034,546,524,22,524,18847
15000US060790105041,658,515,128,530,18848
15000US060790105042,1219,1012,142,1077,18849
15000US060790105043,1110,1001,39,1071,18850
15000US060790106021,987,738,160,827,18851
15000US060790106022,1598,1329,202,1396,18852
15000US060790106023,1350,1047,244,1106,18853
15000US060790106031,696,505,166,530,18854
15000US060790106032,739,582,86,653,18855
15000US060790107011,1530,1266,151,1379,18856
15000US060790107012,2457,1912,361,2096,18857
15000US060790107013,1283,964,174,1109,18858
15000US060790107031,1960,1414,355,1605,18859
15000US060790107032,1347,859,171,1176,18860
15000US060790107071,895,800,35,860,18861
15000US060790107072,2036,1651,232,1804,18862
15000US060790107073,1078,998,70,1008,18863
15000US060790107074,1041,760,193,848,18864
15000US060790107075,1235,1123,87,1148,18865
15000US060790109011,3493,2384,376,3117,18866
15000US060790109012,6961,4189,1081,5880,18867
15000US060790109021,894,747,90,804,18868
15000US060790109022,1033,775,178,855,18869
15000US060790109023,2251,1415,524,1727,18870
15000US060790110011,2215,1566,464,1751,18871
15000US060790110012,1202,959,44,1158,18872
15000US060790110013,2117,1766,158,1959,18873
15000US060790110021,1848,1550,273,1575,18874
15000US060790110022,1344,929,228,1116,18875
15000US060790111011,1070,791,177,893,18876
15000US060790111012,1312,870,273,1039,18877
15000US060790111013,1139,719,185,954,18878
15000US060790111021,1020,838,110,910,18879
15000US060790111022,1054,805,233,821,18880
15000US060790111023,1263,1024,170,1093,18881
15000US060790111024,1956,1495,287,1669,18882
15000US060790111031,1366,869,397,969,18883
15000US060790111032,1314,842,386,928,18884
15000US060790112001,2254,1707,178,2076,18885
15000US060790112002,951,898,0,951,18886
15000US060790112003,898,821,47,851,18887
15000US060790112004,1612,1345,79,1533,18888
15000US060790112005,1874,1466,263,1611,18889
15000US060790113001,3566,1966,1215,2351,18890
15000US060790113002,2395,1645,515,1880,18891
15000US060790113003,1203,801,76,1127,18892
15000US060790113004,811,567,85,726,18893
15000US060790114001,3470,767,730,2740,18894
15000US060790115011,1683,1033,400,1283,18895
15000US060790115031,1373,1194,83,1290,18896
15000US060790115032,2215,1650,422,1793,18897
15000US060790115041,561,454,94,467,18898
15000US060790115042,1217,635,355,862,18899
15000US060790116001,1756,1547,126,1630,18900
15000US060790116002,1056,969,0,1056,18901
15000US060790116003,1188,994,172,1016,18902
15000US060790117011,309,286,23,286,18903
15000US060790117012,1732,1455,145,1587,18904
15000US060790117013,1293,1293,0,1293,18905
15000US060790117014,1143,937,74,1069,18906
15000US060790117041,783,663,53,730,18907
15000US060790117042,730,481,174,556,18908
15000US060790117043,1321,1170,53,1268,18909
15000US060790117044,626,578,26,600,18910
15000US060790118001,1378,962,235,1143,18911
15000US060790118002,1832,1786,36,1796,18912
15000US060790118003,804,717,38,766,18913
15000US060790118004,849,728,19,830,18914
15000US060790118005,2364,2051,128,2236,18915
15000US060790119011,1259,986,100,1159,18916
15000US060790119012,1740,1276,365,1375,18917
15000US060790119021,2158,1445,248,1910,18918
15000US060790119022,1671,1038,409,1262,18919
15000US060790119023,1028,616,148,880,18920
15000US060790119024,2529,1274,1180,1349,18921
15000US060790119025,1646,1201,378,1268,18922
15000US060790120001,1911,1126,439,1472,18923
15000US060790120002,879,715,52,827,18924
15000US060790120003,1872,1190,628,1244,18925
15000US060790120004,2824,1682,804,2020,18926
15000US060790121021,1352,920,303,1049,18927
15000US060790121022,1384,940,323,1061,18928
15000US060790121023,2203,650,841,1362,18929
15000US060790121024,1059,612,397,662,18930
15000US060790122001,2916,325,2472,444,18931
15000US060790122002,630,432,142,488,18932
15000US060790122003,1678,1344,260,1418,18933
15000US060790122004,2411,448,1873,538,18934
15000US060790123021,3093,2757,199,2894,18935
15000US060790123022,534,495,11,523,18936
15000US060790123023,1218,846,372,846,18937
15000US060790123041,2482,1489,605,1877,18938
15000US060790123042,2971,2428,354,2617,18939
15000US060790123043,1232,866,287,945,18940
15000US060790123044,1956,1198,712,1244,18941
15000US060790123045,1431,1248,86,1345,18942
15000US060790124011,1259,694,498,761,18943
15000US060790124012,1677,681,929,748,18944
15000US060790124013,3707,1791,1798,1909,18945
15000US060790124021,2848,2167,481,2367,18946
15000US060790124022,2637,1705,789,1848,18947
15000US060790124023,3855,1740,1817,2038,18948
15000US060790125021,1193,946,205,988,18949
15000US060790125022,1043,927,116,927,18950
15000US060790125023,2938,2137,694,2244,18951
15000US060790125031,1840,1251,249,1591,18952
15000US060790125032,3154,1948,849,2305,18953
15000US060790125033,1205,996,170,1035,18954
15000US060790125051,1714,1504,67,1647,18955
15000US060790125052,1131,827,225,906,18956
15000US060790125053,2238,1859,277,1961,18957
15000US060790126001,1578,1457,121,1457,18958
15000US060790126002,1417,1226,53,1364,18959
15000US060790126003,1317,1110,168,1149,18960
15000US060790126004,1983,1033,935,1048,18961
15000US060790126005,1903,1577,188,1715,18962
15000US060790127021,843,696,129,714,18963
15000US060790127022,1026,1009,0,1026,18964
15000US060790127023,1700,1572,128,1572,18965
15000US060790127024,701,498,123,578,18966
15000US060790127025,2686,2184,395,2291,18967
15000US060790127041,2430,1881,505,1925,18968
15000US060790127042,2365,2280,28,2337,18969
15000US060790127043,3066,2517,344,2722,18970
15000US060790127044,1267,1044,155,1112,18971
15000US060790128001,158,68,64,94,18972
15000US060790129001,2655,1886,665,1990,18973
15000US060790129002,2555,1938,500,2055,18974
15000US060790130001,1117,735,349,768,18975
15000US060790130002,1644,1467,161,1483,18976
15000US060799900000,0,0,0,0,18977
15000US060816001001,2686,537,680,2006,18978
15000US060816001002,1534,835,362,1172,18979
15000US060816001003,1009,609,103,906,18980
15000US060816002001,1857,75,364,1493,18981
15000US060816002002,2344,133,783,1561,18982
15000US060816003001,1567,337,661,906,18983
15000US060816003002,2294,283,133,2161,18984
15000US060816004011,1847,335,624,1223,18985
15000US060816004012,1568,53,270,1298,18986
15000US060816004021,1143,38,357,786,18987
15000US060816004022,2338,170,701,1637,18988
15000US060816004023,1685,90,388,1297,18989
15000US060816005001,2297,165,69,2228,18990
15000US060816005002,736,151,288,448,18991
15000US060816005003,2484,103,1333,1151,18992
15000US060816005004,1011,410,174,837,18993
15000US060816005005,1021,6,387,634,18994
15000US060816006001,2211,139,1097,1114,18995
15000US060816006002,3493,224,1437,2056,18996
15000US060816007001,2318,265,918,1400,18997
15000US060816007002,2232,55,895,1337,18998
15000US060816007003,1523,166,331,1192,18999
15000US060816007004,1210,315,132,1078,19000
15000US060816008001,2004,156,402,1602,19001
15000US060816008002,2181,187,262,1919,19002
15000US060816008003,2057,653,491,1566,19003
15000US060816008004,1133,104,270,863,19004
15000US060816009001,1989,683,280,1709,19005
15000US060816009002,2004,729,135,1869,19006
15000US060816010001,2070,375,579,1491,19007
15000US060816010002,1542,298,257,1285,19008
15000US060816010003,2303,292,308,1995,19009
15000US060816010004,578,108,0,578,19010
15000US060816011001,726,260,110,616,19011
15000US060816011002,1039,140,30,1009,19012
15000US060816011003,852,178,78,774,19013
15000US060816011004,1934,232,183,1751,19014
15000US060816011005,1670,460,433,1237,19015
15000US060816012001,2372,227,971,1401,19016
15000US060816012002,1306,225,61,1245,19017
15000US060816012003,1484,406,449,1035,19018
15000US060816012004,1657,246,364,1293,19019
15000US060816013001,1493,11,558,935,19020
15000US060816013002,2725,300,1294,1431,19021
15000US060816013003,2037,241,1196,841,19022
15000US060816013004,2510,205,481,2029,19023
15000US060816014001,1318,420,182,1136,19024
15000US060816014002,4258,276,931,3327,19025
15000US060816014003,1886,231,364,1522,19026
15000US060816015011,2328,135,157,2171,19027
15000US060816015012,1585,187,60,1525,19028
15000US060816015013,1501,300,162,1339,19029
15000US060816015021,3267,441,1074,2193,19030
15000US060816015022,2272,197,427,1845,19031
15000US060816016011,1286,214,570,716,19032
15000US060816016012,1458,325,292,1166,19033
15000US060816016031,2700,307,391,2309,19034
15000US060816016032,1775,359,163,1612,19035
15000US060816016033,1523,249,235,1288,19036
15000US060816016041,2821,1023,407,2414,19037
15000US060816016051,1213,84,263,950,19038
15000US060816016052,1208,199,235,973,19039
15000US060816016053,2406,142,245,2161,19040
15000US060816016054,1704,60,82,1622,19041
15000US060816017001,1400,313,788,612,19042
15000US060816017002,1698,452,397,1301,19043
15000US060816017003,1456,495,394,1062,19044
15000US060816018001,3986,1105,1286,2700,19045
15000US060816018002,3199,882,1105,2094,19046
15000US060816019011,1255,396,330,925,19047
15000US060816019012,2385,307,953,1432,19048
15000US060816019013,862,249,405,457,19049
15000US060816019021,1515,462,278,1237,19050
15000US060816019022,688,298,140,548,19051
15000US060816019023,3349,357,1111,2238,19052
15000US060816020001,3483,606,945,2538,19053
15000US060816020002,976,317,290,686,19054
15000US060816020003,704,239,286,418,19055
15000US060816020004,1469,366,129,1340,19056
15000US060816020005,1468,327,932,536,19057
15000US060816021001,860,122,364,496,19058
15000US060816021002,1226,151,819,407,19059
15000US060816021003,1260,35,1001,259,19060
15000US060816022001,1749,541,1016,733,19061
15000US060816022002,1018,14,842,176,19062
15000US060816022003,3175,163,2315,860,19063
15000US060816022004,1980,269,1025,955,19064
15000US060816023001,3990,516,2037,1953,19065
15000US060816024001,1253,419,558,695,19066
15000US060816024002,2213,788,129,2084,19067
15000US060816024003,1620,756,502,1118,19068
15000US060816024004,2176,846,526,1650,19069
15000US060816025001,2361,262,287,2074,19070
15000US060816025002,1797,344,234,1563,19071
15000US060816025003,1557,279,162,1395,19072
15000US060816026001,972,91,9,963,19073
15000US060816026002,2960,400,356,2604,19074
15000US060816026003,2092,194,235,1857,19075
15000US060816026004,1927,110,184,1743,19076
15000US060816027001,1033,244,155,878,19077
15000US060816027002,1505,250,350,1155,19078
15000US060816027003,1900,423,402,1498,19079
15000US060816027004,1624,565,434,1190,19080
15000US060816028001,756,301,87,669,19081
15000US060816028002,3077,725,560,2517,19082
15000US060816028003,828,412,227,601,19083
15000US060816029001,2144,1092,334,1810,19084
15000US060816029002,1720,1113,368,1352,19085
15000US060816030001,1525,956,283,1242,19086
15000US060816030002,842,542,50,792,19087
15000US060816030003,517,336,86,431,19088
15000US060816030004,1469,1020,274,1195,19089
15000US060816031001,2239,1486,430,1809,19090
15000US060816031002,1282,803,202,1080,19091
15000US060816032001,1295,851,226,1069,19092
15000US060816032002,670,498,85,585,19093
15000US060816032003,1078,683,260,818,19094
15000US060816032004,603,460,26,577,19095
15000US060816033001,2154,1609,207,1947,19096
15000US060816033002,2463,1609,414,2049,19097
15000US060816033003,2128,1252,355,1773,19098
15000US060816034001,1955,1136,692,1263,19099
15000US060816034002,997,682,108,889,19100
15000US060816034003,1453,784,352,1101,19101
15000US060816034004,1587,959,155,1432,19102
15000US060816037001,2796,844,260,2536,19103
15000US060816037002,2976,1053,893,2083,19104
15000US060816038011,2339,896,414,1925,19105
15000US060816038021,3066,1357,847,2219,19106
15000US060816038022,1934,1172,224,1710,19107
15000US060816039001,763,472,141,622,19108
15000US060816039002,1841,789,571,1270,19109
15000US060816039003,821,496,304,517,19110
15000US060816039004,548,313,80,468,19111
15000US060816039005,847,455,299,548,19112
15000US060816039006,791,243,118,673,19113
15000US060816040001,796,420,97,699,19114
15000US060816040002,1078,624,176,902,19115
15000US060816040003,1355,580,357,998,19116
15000US060816041011,1984,202,967,1017,19117
15000US060816041012,2533,833,939,1594,19118
15000US060816041013,3726,678,1875,1851,19119
15000US060816041021,2923,894,404,2519,19120
15000US060816042001,1109,291,379,730,19121
15000US060816042002,704,154,388,316,19122
15000US060816042003,2268,811,1142,1126,19123
15000US060816044001,1824,234,524,1300,19124
15000US060816044002,1447,339,234,1213,19125
15000US060816044003,1750,344,489,1261,19126
15000US060816045001,714,284,66,648,19127
15000US060816045002,877,372,144,733,19128
15000US060816045003,2158,1027,149,2009,19129
15000US060816046001,1597,556,106,1491,19130
15000US060816046002,1300,547,84,1216,19131
15000US060816047001,1642,648,95,1547,19132
15000US060816047002,1044,446,107,937,19133
15000US060816048001,2109,326,520,1589,19134
15000US060816048002,1460,602,268,1192,19135
15000US060816048003,1401,603,86,1315,19136
15000US060816049001,2036,576,175,1861,19137
15000US060816049002,1163,542,137,1026,19138
15000US060816050001,2475,707,418,2057,19139
15000US060816050002,1149,643,287,862,19140
15000US060816050003,2928,1934,0,2928,19141
15000US060816050004,1029,427,36,993,19142
15000US060816050005,943,254,75,868,19143
15000US060816051001,918,557,29,889,19144
15000US060816051002,2248,1246,343,1905,19145
15000US060816052001,1093,585,121,972,19146
15000US060816052002,1080,649,120,960,19147
15000US060816052003,772,589,0,772,19148
15000US060816052004,800,635,79,721,19149
15000US060816053001,1273,746,182,1091,19150
15000US060816053002,1453,1048,179,1274,19151
15000US060816053003,1153,834,41,1112,19152
15000US060816053004,836,398,14,822,19153
15000US060816054001,784,532,62,722,19154
15000US060816054002,960,764,36,924,19155
15000US060816054003,1317,870,209,1108,19156
15000US060816054004,1113,651,331,782,19157
15000US060816054005,1639,758,156,1483,19158
15000US060816055001,2963,1896,422,2541,19159
15000US060816055002,790,373,126,664,19160
15000US060816055003,1541,773,230,1311,19161
15000US060816056001,965,716,40,925,19162
15000US060816056002,1098,940,68,1030,19163
15000US060816056003,1150,490,56,1094,19164
15000US060816056004,2768,1656,59,2709,19165
15000US060816057001,947,738,6,941,19166
15000US060816057002,1286,687,71,1215,19167
15000US060816057003,1711,739,141,1570,19168
15000US060816057004,1387,929,74,1313,19169
15000US060816058001,559,369,41,518,19170
15000US060816058002,1179,810,99,1080,19171
15000US060816058003,880,678,49,831,19172
15000US060816059001,2178,1088,381,1797,19173
15000US060816059002,2056,674,687,1369,19174
15000US060816059003,1720,671,533,1187,19175
15000US060816060001,2541,1139,821,1720,19176
15000US060816060002,3325,473,2329,996,19177
15000US060816061001,1543,697,447,1096,19178
15000US060816061002,1279,506,391,888,19179
15000US060816061003,1849,141,1035,814,19180
15000US060816062001,1985,194,1375,610,19181
15000US060816062002,2933,117,2072,861,19182
15000US060816062003,1864,204,887,977,19183
15000US060816062004,1298,452,553,745,19184
15000US060816063001,1937,1057,296,1641,19185
15000US060816063002,1113,511,327,786,19186
15000US060816063003,1441,537,583,858,19187
15000US060816064001,1088,546,316,772,19188
15000US060816064002,720,490,20,700,19189
15000US060816064003,1291,918,69,1222,19190
15000US060816064004,2081,1077,359,1722,19191
15000US060816065001,590,412,26,564,19192
15000US060816065002,886,644,45,841,19193
15000US060816065003,901,557,67,834,19194
15000US060816065004,970,751,59,911,19195
15000US060816066001,1393,782,390,1003,19196
15000US060816066002,1087,538,246,841,19197
15000US060816066003,1208,690,152,1056,19198
15000US060816067001,835,528,51,784,19199
15000US060816067002,1548,931,110,1438,19200
15000US060816068001,1313,695,6,1307,19201
15000US060816068002,2121,1313,27,2094,19202
15000US060816069001,871,493,82,789,19203
15000US060816069002,1680,870,142,1538,19204
15000US060816070001,604,266,126,478,19205
15000US060816070002,2837,1698,153,2684,19206
15000US060816071001,637,485,31,606,19207
15000US060816071002,1193,769,66,1127,19208
15000US060816071003,1343,860,121,1222,19209
15000US060816072001,2483,814,790,1693,19210
15000US060816072002,1685,894,312,1373,19211
15000US060816073001,1247,782,113,1134,19212
15000US060816073002,1758,1182,255,1503,19213
15000US060816073003,568,382,10,558,19214
15000US060816074001,1992,910,204,1788,19215
15000US060816074002,931,379,403,528,19216
15000US060816074003,1935,931,486,1449,19217
15000US060816075001,4227,1707,1048,3179,19218
15000US060816076001,932,477,337,595,19219
15000US060816076002,612,206,200,412,19220
15000US060816076003,1112,202,627,485,19221
15000US060816076004,812,627,70,742,19222
15000US060816077011,1574,359,689,885,19223
15000US060816077012,832,257,296,536,19224
15000US060816077013,1757,450,715,1042,19225
15000US060816077021,1548,469,566,982,19226
15000US060816077022,1220,507,412,808,19227
15000US060816078001,1482,697,159,1323,19228
15000US060816078002,1977,716,732,1245,19229
15000US060816079001,1151,818,49,1102,19230
15000US060816079002,770,279,57,713,19231
15000US060816079003,1198,557,16,1182,19232
15000US060816080011,2113,956,178,1935,19233
15000US060816080012,1603,416,109,1494,19234
15000US060816080021,1950,940,96,1854,19235
15000US060816080022,854,388,27,827,19236
15000US060816080023,796,512,46,750,19237
15000US060816080041,1465,597,0,1465,19238
15000US060816080042,1538,707,49,1489,19239
15000US060816080043,2109,482,102,2007,19240
15000US060816080044,1831,871,62,1769,19241
15000US060816080131,2369,867,70,2299,19242
15000US060816080132,1046,333,142,904,19243
15000US060816080133,1140,806,20,1120,19244
15000US060816080231,784,346,22,762,19245
15000US060816080232,1934,679,52,1882,19246
15000US060816081001,3822,1480,221,3601,19247
15000US060816082001,3877,1894,162,3715,19248
15000US060816083001,2008,908,64,1944,19249
15000US060816083002,1728,530,65,1663,19250
15000US060816084001,2601,780,911,1690,19251
15000US060816084002,2000,849,132,1868,19252
15000US060816084003,1671,711,743,928,19253
15000US060816085011,1024,507,245,779,19254
15000US060816085012,1796,976,438,1358,19255
15000US060816085013,1159,685,258,901,19256
15000US060816085014,927,523,148,779,19257
15000US060816085021,2627,1187,599,2028,19258
15000US060816086001,820,432,74,746,19259
15000US060816086002,1144,645,260,884,19260
15000US060816086003,2552,570,670,1882,19261
15000US060816087001,1671,1183,64,1607,19262
15000US060816087002,1526,645,193,1333,19263
15000US060816087003,743,561,48,695,19264
15000US060816087004,1451,1017,152,1299,19265
15000US060816087005,1916,1084,319,1597,19266
15000US060816088001,1395,986,0,1395,19267
15000US060816088002,1378,1020,71,1307,19268
15000US060816088003,715,622,18,697,19269
15000US060816088004,906,485,52,854,19270
15000US060816088005,1630,826,357,1273,19271
15000US060816089001,1055,595,90,965,19272
15000US060816089002,1766,1062,189,1577,19273
15000US060816089003,3180,1556,569,2611,19274
15000US060816089004,854,493,94,760,19275
15000US060816090001,1106,662,87,1019,19276
15000US060816090002,1396,866,177,1219,19277
15000US060816091001,734,354,242,492,19278
15000US060816091002,883,390,239,644,19279
15000US060816092011,1181,766,177,1004,19280
15000US060816092012,1040,730,88,952,19281
15000US060816092013,1487,1261,104,1383,19282
15000US060816092021,1615,964,172,1443,19283
15000US060816092022,2646,1503,626,2020,19284
15000US060816093001,1526,1109,225,1301,19285
15000US060816093002,2049,1579,133,1916,19286
15000US060816094001,3584,2929,303,3281,19287
15000US060816095001,1925,1573,196,1729,19288
15000US060816095002,3074,2087,258,2816,19289
15000US060816096011,2923,2019,159,2764,19290
15000US060816096021,1715,1223,84,1631,19291
15000US060816096031,1635,1091,150,1485,19292
15000US060816096032,1350,997,55,1295,19293
15000US060816096033,1540,1228,126,1414,19294
15000US060816096034,610,422,142,468,19295
15000US060816097001,2033,1636,210,1823,19296
15000US060816097002,2627,2238,196,2431,19297
15000US060816098001,843,460,278,565,19298
15000US060816098002,1572,1045,203,1369,19299
15000US060816098003,870,535,241,629,19300
15000US060816098004,1392,993,166,1226,19301
15000US060816099001,1049,847,113,936,19302
15000US060816099002,2107,1411,483,1624,19303
15000US060816100001,2131,1498,302,1829,19304
15000US060816100002,1116,833,226,890,19305
15000US060816100003,1551,586,614,937,19306
15000US060816101001,2434,1086,1146,1288,19307
15000US060816102011,1232,168,811,421,19308
15000US060816102012,1685,172,1443,242,19309
15000US060816102013,1175,92,1003,172,19310
15000US060816102014,1941,321,1266,675,19311
15000US060816102021,2468,845,1026,1442,19312
15000US060816102031,1739,131,1468,271,19313
15000US060816102032,2247,237,1760,487,19314
15000US060816103021,2756,1002,1301,1455,19315
15000US060816103031,1565,522,111,1454,19316
15000US060816103032,1449,637,67,1382,19317
15000US060816103033,2445,1188,354,2091,19318
15000US060816103034,2635,1142,33,2602,19319
15000US060816103041,2041,1134,80,1961,19320
15000US060816103042,1501,786,185,1316,19321
15000US060816103043,990,140,197,793,19322
15000US060816104001,3393,543,2336,1057,19323
15000US060816104002,2859,460,2108,751,19324
15000US060816105001,1101,114,826,275,19325
15000US060816105002,1735,121,988,747,19326
15000US060816105003,797,81,707,90,19327
15000US060816105004,1628,469,1069,559,19328
15000US060816106011,2445,122,2268,177,19329
15000US060816106012,1505,434,789,716,19330
15000US060816106013,2163,32,2056,107,19331
15000US060816106021,838,600,100,738,19332
15000US060816106022,848,640,159,689,19333
15000US060816106023,2084,478,1452,632,19334
15000US060816107001,2687,1005,1173,1514,19335
15000US060816107002,2518,1481,568,1950,19336
15000US060816108001,2491,440,1874,617,19337
15000US060816108002,2695,650,1617,1078,19338
15000US060816109001,2746,1085,1325,1421,19339
15000US060816109002,2319,537,1581,738,19340
15000US060816109003,872,227,398,474,19341
15000US060816109004,1042,477,394,648,19342
15000US060816110001,1634,680,835,799,19343
15000US060816110002,1402,790,527,875,19344
15000US060816110003,1015,564,219,796,19345
15000US060816110004,2417,1173,779,1638,19346
15000US060816111001,2802,2284,104,2698,19347
15000US060816111002,1886,1482,246,1640,19348
15000US060816111003,1652,1179,240,1412,19349
15000US060816112001,2901,2140,558,2343,19350
15000US060816113001,1719,875,425,1294,19351
15000US060816113002,1957,1614,200,1757,19352
15000US060816113003,568,416,75,493,19353
15000US060816113004,1214,758,309,905,19354
15000US060816114001,1084,666,116,968,19355
15000US060816114002,781,642,20,761,19356
15000US060816114003,1260,1003,29,1231,19357
15000US060816114004,1287,1092,59,1228,19358
15000US060816115001,645,450,42,603,19359
15000US060816115002,1068,793,46,1022,19360
15000US060816115003,1002,693,53,949,19361
15000US060816116001,1080,852,37,1043,19362
15000US060816116002,1236,851,117,1119,19363
15000US060816117001,2085,215,1153,932,19364
15000US060816117002,1854,154,961,893,19365
15000US060816117003,1410,13,842,568,19366
15000US060816117004,0,0,0,0,19367
15000US060816118001,1875,54,1041,834,19368
15000US060816118002,2090,99,1370,720,19369
15000US060816119001,1209,127,880,329,19370
15000US060816119002,1667,100,1011,656,19371
15000US060816119003,1244,82,901,343,19372
15000US060816119004,1399,61,809,590,19373
15000US060816119005,2435,507,1092,1343,19374
15000US060816119006,2326,396,1248,1078,19375
15000US060816120001,1347,34,1064,283,19376
15000US060816120002,3142,45,2397,745,19377
15000US060816120003,1043,10,681,362,19378
15000US060816120004,1876,34,764,1112,19379
15000US060816121001,1117,801,55,1062,19380
15000US060816121002,2537,150,2215,322,19381
15000US060816121003,1459,198,834,625,19382
15000US060816121004,1073,154,793,280,19383
15000US060816121005,2631,184,1547,1084,19384
15000US060816125001,1148,865,168,980,19385
15000US060816125002,825,640,130,695,19386
15000US060816125003,2181,1591,116,2065,19387
15000US060816126001,1028,790,0,1028,19388
15000US060816126002,1519,1040,103,1416,19389
15000US060816126003,1122,878,29,1093,19390
15000US060816126004,1069,788,13,1056,19391
15000US060816127001,953,777,14,939,19392
15000US060816127002,1161,984,107,1054,19393
15000US060816128001,1806,1383,177,1629,19394
15000US060816128002,1490,1201,55,1435,19395
15000US060816129001,1778,1376,122,1656,19396
15000US060816129002,780,523,17,763,19397
15000US060816129003,861,569,43,818,19398
15000US060816129004,1187,776,33,1154,19399
15000US060816130001,1880,1206,33,1847,19400
15000US060816130002,1604,1396,41,1563,19401
15000US060816132001,1692,1288,119,1573,19402
15000US060816132002,1635,1316,111,1524,19403
15000US060816132003,1064,894,13,1051,19404
15000US060816132004,1766,1400,61,1705,19405
15000US060816132005,615,558,18,597,19406
15000US060816133001,1506,1330,89,1417,19407
15000US060816133002,1216,1002,94,1122,19408
15000US060816134001,1162,1100,32,1130,19409
15000US060816134002,637,532,36,601,19410
15000US060816134003,1358,1056,235,1123,19411
15000US060816135011,2568,1472,908,1660,19412
15000US060816135012,2284,1258,792,1492,19413
15000US060816135021,1840,1367,314,1526,19414
15000US060816135022,995,817,83,912,19415
15000US060816135023,1610,1199,90,1520,19416
15000US060816135024,2065,1200,826,1239,19417
15000US060816136001,2798,2593,150,2648,19418
15000US060816136002,2040,1395,469,1571,19419
15000US060816136003,785,682,55,730,19420
15000US060816136004,978,271,692,286,19421
15000US060816137001,2492,1363,828,1664,19422
15000US060816137002,545,513,0,545,19423
15000US060816137003,1538,244,1224,314,19424
15000US060816137004,2120,1504,492,1628,19425
15000US060816137005,2227,1800,104,2123,19426
15000US060816138001,949,657,202,747,19427
15000US060816138002,641,555,30,611,19428
15000US060816138003,662,583,7,655,19429
15000US060816138004,1479,850,567,912,19430
15000US060816139001,658,257,174,484,19431
15000US060816139002,1089,713,38,1051,19432
15000US060816139003,1529,992,319,1210,19433
15000US060816139004,1232,737,180,1052,19434
15000US060816139005,2268,1222,405,1863,19435
15000US060816140001,3100,670,617,2483,19436
15000US060816140002,1414,452,238,1176,19437
15000US060816140003,1042,296,206,836,19438
15000US060819843001,0,0,0,0,19439
15000US060819901000,0,0,0,0,19440
15000US060830001011,2600,1480,858,1742,19441
15000US060830001012,1934,973,674,1260,19442
15000US060830001013,1307,1040,267,1040,19443
15000US060830001014,795,366,336,459,19444
15000US060830001021,1588,1344,70,1518,19445
15000US060830001022,603,344,136,467,19446
15000US060830001023,1177,651,374,803,19447
15000US060830001024,1967,1126,747,1220,19448
15000US060830001031,1028,979,32,996,19449
15000US060830001032,1319,1119,112,1207,19450
15000US060830001033,736,683,46,690,19451
15000US060830002001,1210,751,423,787,19452
15000US060830002002,1100,969,49,1051,19453
15000US060830002003,1865,1149,577,1288,19454
15000US060830003011,961,412,349,612,19455
15000US060830003012,924,484,387,537,19456
15000US060830003013,973,605,221,752,19457
15000US060830003021,739,458,229,510,19458
15000US060830003022,657,392,244,413,19459
15000US060830003023,994,566,306,688,19460
15000US060830003024,960,374,455,505,19461
15000US060830003025,678,265,372,306,19462
15000US060830004001,959,859,0,959,19463
15000US060830004002,628,550,78,550,19464
15000US060830004003,1051,850,70,981,19465
15000US060830004004,660,613,21,639,19466
15000US060830004005,1354,810,426,928,19467
15000US060830005011,965,955,10,955,19468
15000US060830005012,1317,1136,109,1208,19469
15000US060830005013,1296,1168,41,1255,19470
15000US060830005021,757,661,79,678,19471
15000US060830005022,885,822,52,833,19472
15000US060830005023,928,889,25,903,19473
15000US060830005024,1269,1046,203,1066,19474
15000US060830005025,655,632,23,632,19475
15000US060830005026,2037,1511,291,1746,19476
15000US060830006001,549,516,0,549,19477
15000US060830006002,1295,1031,120,1175,19478
15000US060830006003,532,478,21,511,19479
15000US060830006004,749,505,176,573,19480
15000US060830006005,1360,952,308,1052,19481
15000US060830006006,486,387,74,412,19482
15000US060830007001,1232,998,219,1013,19483
15000US060830007002,2348,1672,252,2096,19484
15000US060830007003,863,812,36,827,19485
15000US060830007004,2487,1206,1119,1368,19486
15000US060830008011,636,90,546,90,19487
15000US060830008012,2017,215,1768,249,19488
15000US060830008013,1251,379,790,461,19489
15000US060830008041,748,592,80,668,19490
15000US060830008042,2062,117,1698,364,19491
15000US060830008043,1686,374,1273,413,19492
15000US060830008044,1289,311,967,322,19493
15000US060830008045,1345,226,1015,330,19494
15000US060830009001,2093,811,1088,1005,19495
15000US060830009002,1377,940,401,976,19496
15000US060830010001,736,403,320,416,19497
15000US060830010002,642,410,121,521,19498
15000US060830010003,1522,642,863,659,19499
15000US060830010004,1219,606,427,792,19500
15000US060830010005,1372,907,329,1043,19501
15000US060830011011,1900,976,831,1069,19502
15000US060830011012,1775,212,1335,440,19503
15000US060830011013,1045,182,839,206,19504
15000US060830011014,624,422,187,437,19505
15000US060830011021,1954,624,1167,787,19506
15000US060830011022,2289,212,1935,354,19507
15000US060830011023,822,203,541,281,19508
15000US060830012031,756,346,372,384,19509
15000US060830012032,2122,1499,408,1714,19510
15000US060830012061,1073,656,303,770,19511
15000US060830012062,2407,282,2102,305,19512
15000US060830012063,1641,433,1028,613,19513
15000US060830012081,1303,771,374,929,19514
15000US060830012082,931,807,36,895,19515
15000US060830012083,821,716,66,755,19516
15000US060830012084,623,338,217,406,19517
15000US060830012085,885,754,95,790,19518
15000US060830013041,961,287,646,315,19519
15000US060830013042,694,447,178,516,19520
15000US060830013043,837,738,52,785,19521
15000US060830013044,977,683,62,915,19522
15000US060830013045,602,247,254,348,19523
15000US060830013046,730,552,165,565,19524
15000US060830013047,727,439,212,515,19525
15000US060830013048,953,685,193,760,19526
15000US060830013049,932,439,455,477,19527
15000US060830013061,1348,972,274,1074,19528
15000US060830013062,919,746,73,846,19529
15000US060830013063,1167,891,253,914,19530
15000US060830014021,1027,908,112,915,19531
15000US060830014022,892,836,54,838,19532
15000US060830014023,712,703,9,703,19533
15000US060830014024,685,650,29,656,19534
15000US060830015001,1212,1122,63,1149,19535
15000US060830015002,825,690,109,716,19536
15000US060830015003,1025,911,40,985,19537
15000US060830016011,1056,459,569,487,19538
15000US060830016012,2516,1350,1052,1464,19539
15000US060830016013,1944,1559,194,1750,19540
15000US060830016041,1217,499,702,515,19541
15000US060830016042,672,434,161,511,19542
15000US060830016043,994,412,553,441,19543
15000US060830016044,2118,1344,480,1638,19544
15000US060830017041,1788,727,974,814,19545
15000US060830017042,1347,334,979,368,19546
15000US060830017061,1420,843,534,886,19547
15000US060830017062,896,677,187,709,19548
15000US060830017063,740,455,279,461,19549
15000US060830017064,495,418,15,480,19550
15000US060830017065,651,522,67,584,19551
15000US060830018001,1030,476,519,511,19552
15000US060830019011,1554,1121,337,1217,19553
15000US060830019012,527,350,165,362,19554
15000US060830019013,2355,1037,1063,1292,19555
15000US060830019014,2025,1460,500,1525,19556
15000US060830019015,641,566,50,591,19557
15000US060830019031,867,746,114,753,19558
15000US060830019032,833,771,62,771,19559
15000US060830019033,1097,723,362,735,19560
15000US060830019034,2282,1177,944,1338,19561
15000US060830019035,1159,721,351,808,19562
15000US060830019051,1018,772,183,835,19563
15000US060830019052,661,584,56,605,19564
15000US060830019053,785,640,104,681,19565
15000US060830019061,1592,1289,107,1485,19566
15000US060830019062,957,774,183,774,19567
15000US060830019063,933,787,101,832,19568
15000US060830019064,930,631,250,680,19569
15000US060830019065,1479,620,170,1309,19570
15000US060830020051,504,413,56,448,19571
15000US060830020052,1381,901,249,1132,19572
15000US060830020053,1740,1288,377,1363,19573
15000US060830020054,1706,1166,398,1308,19574
15000US060830020061,1545,945,490,1055,19575
15000US060830020062,935,607,247,688,19576
15000US060830020071,1138,749,247,891,19577
15000US060830020072,1034,440,552,482,19578
15000US060830020073,1056,806,143,913,19579
15000US060830020074,3145,1064,1744,1401,19580
15000US060830020075,783,669,114,669,19581
15000US060830020076,1415,480,740,675,19582
15000US060830020077,1615,1093,318,1297,19583
15000US060830020081,1930,1172,661,1269,19584
15000US060830020082,660,425,72,588,19585
15000US060830020083,936,750,126,810,19586
15000US060830020084,1912,1078,777,1135,19587
15000US060830020085,875,625,172,703,19588
15000US060830020091,1002,680,247,755,19589
15000US060830020092,1190,836,92,1098,19590
15000US060830020093,2111,1102,979,1132,19591
15000US060830020101,2091,1417,453,1638,19592
15000US060830020102,1212,700,315,897,19593
15000US060830020103,629,428,177,452,19594
15000US060830020104,619,522,82,537,19595
15000US060830020111,2430,1246,876,1554,19596
15000US060830020112,465,262,203,262,19597
15000US060830020113,3105,219,2745,360,19598
15000US060830020121,1036,872,127,909,19599
15000US060830020122,1243,826,343,900,19600
15000US060830020123,923,664,202,721,19601
15000US060830020131,1129,1002,97,1032,19602
15000US060830020132,1589,1045,415,1174,19603
15000US060830021011,1755,581,1161,594,19604
15000US060830021012,2366,717,1564,802,19605
15000US060830021021,1290,611,640,650,19606
15000US060830021022,1150,197,897,253,19607
15000US060830021031,994,291,528,466,19608
15000US060830021032,2388,359,1773,615,19609
15000US060830021033,1169,419,677,492,19610
15000US060830022051,1460,439,740,720,19611
15000US060830022052,1369,366,861,508,19612
15000US060830022053,2542,220,2315,227,19613
15000US060830022061,1454,533,827,627,19614
15000US060830022062,1925,291,1392,533,19615
15000US060830022063,1573,108,1419,154,19616
15000US060830022091,1760,386,1303,457,19617
15000US060830022092,1812,178,1608,204,19618
15000US060830022101,2815,608,1853,962,19619
15000US060830022102,1880,631,998,882,19620
15000US060830022103,1458,217,1116,342,19621
15000US060830022111,946,580,124,822,19622
15000US060830022112,1486,774,477,1009,19623
15000US060830022113,2263,519,1633,630,19624
15000US060830022114,970,384,473,497,19625
15000US060830023031,1325,99,1205,120,19626
15000US060830023032,1242,85,1124,118,19627
15000US060830023033,1681,352,1262,419,19628
15000US060830023034,1396,65,1296,100,19629
15000US060830023035,559,14,416,143,19630
15000US060830023041,1013,23,978,35,19631
15000US060830023042,1448,30,1358,90,19632
15000US060830023043,1861,101,1545,316,19633
15000US060830023044,2065,70,1949,116,19634
15000US060830023051,1389,3,1268,121,19635
15000US060830023052,1591,108,1420,171,19636
15000US060830023053,1818,198,1549,269,19637
15000US060830023054,2419,148,2130,289,19638
15000US060830023061,1440,67,1243,197,19639
15000US060830023062,1222,337,756,466,19640
15000US060830023063,1146,741,319,827,19641
15000US060830023064,5301,806,3877,1424,19642
15000US060830024021,1167,312,855,312,19643
15000US060830024022,6517,1521,4171,2346,19644
15000US060830024023,1817,0,1817,0,19645
15000US060830024024,3047,276,2704,343,19646
15000US060830024031,1977,49,1885,92,19647
15000US060830024032,2305,153,2097,208,19648
15000US060830024033,2621,106,2506,115,19649
15000US060830024041,2690,150,2423,267,19650
15000US060830024042,2591,53,2504,87,19651
15000US060830024043,1015,18,952,63,19652
15000US060830024044,2379,49,2166,213,19653
15000US060830025021,1017,55,800,217,19654
15000US060830025022,3224,214,2931,293,19655
15000US060830025023,1472,238,1207,265,19656
15000US060830025024,1791,174,1564,227,19657
15000US060830026041,3138,883,1429,1709,19658
15000US060830026061,3518,1857,779,2739,19659
15000US060830027021,801,73,718,83,19660
15000US060830027022,1481,160,1321,160,19661
15000US060830027023,1974,368,1518,456,19662
15000US060830027024,2461,612,1534,927,19663
15000US060830027025,1142,334,596,546,19664
15000US060830027031,2512,551,1759,753,19665
15000US060830027032,1858,648,1016,842,19666
15000US060830027051,1448,654,652,796,19667
15000US060830027052,2153,396,1638,515,19668
15000US060830027053,564,317,235,329,19669
15000US060830027061,1296,518,702,594,19670
15000US060830027062,1534,420,989,545,19671
15000US060830027063,2136,333,1533,603,19672
15000US060830027064,761,358,359,402,19673
15000US060830027065,975,91,765,210,19674
15000US060830027071,616,372,195,421,19675
15000US060830027072,480,310,141,339,19676
15000US060830027073,1096,452,453,643,19677
15000US060830027081,642,172,309,333,19678
15000US060830027082,1048,724,288,760,19679
15000US060830027083,879,694,141,738,19680
15000US060830028021,2187,604,1199,988,19681
15000US060830028022,837,427,291,546,19682
15000US060830028023,2265,1147,717,1548,19683
15000US060830028024,2145,890,523,1622,19684
15000US060830028061,1407,869,413,994,19685
15000US060830028062,1017,373,578,439,19686
15000US060830028081,518,422,0,518,19687
15000US060830028082,391,322,69,322,19688
15000US060830028083,1449,850,410,1039,19689
15000US060830028084,1102,861,112,990,19690
15000US060830028085,1079,876,63,1016,19691
15000US060830028086,2607,1399,1099,1508,19692
15000US060830028091,751,535,204,547,19693
15000US060830028092,1445,543,734,711,19694
15000US060830028093,925,366,506,419,19695
15000US060830028094,1847,1116,160,1687,19696
15000US060830029061,1082,480,363,719,19697
15000US060830029062,1615,969,462,1153,19698
15000US060830029063,1552,1149,240,1312,19699
15000US060830029071,1751,1328,285,1466,19700
15000US060830029072,1250,974,105,1145,19701
15000US060830029073,1191,569,506,685,19702
15000US060830029091,2352,919,1247,1105,19703
15000US060830029092,2054,985,899,1155,19704
15000US060830029093,1629,738,730,899,19705
15000US060830029131,1735,1279,185,1550,19706
15000US060830029132,2155,1751,345,1810,19707
15000US060830029141,575,459,44,531,19708
15000US060830029142,1101,542,239,862,19709
15000US060830029143,1517,991,357,1160,19710
15000US060830029151,525,301,126,399,19711
15000US060830029221,5893,2023,1444,4449,19712
15000US060830029222,1752,635,559,1193,19713
15000US060830029223,0,0,0,0,19714
15000US060830029224,1433,555,384,1049,19715
15000US060830029225,1720,723,425,1295,19716
15000US060830029241,2075,1567,255,1820,19717
15000US060830029242,1510,809,341,1169,19718
15000US060830029243,637,358,79,558,19719
15000US060830029244,2233,1126,609,1624,19720
15000US060830029261,2187,1069,711,1476,19721
15000US060830029262,2101,1630,269,1832,19722
15000US060830029263,1714,879,557,1157,19723
15000US060830029281,3347,2416,517,2830,19724
15000US060830029282,1557,614,560,997,19725
15000US060830029301,1996,762,888,1108,19726
15000US060830029302,851,753,91,760,19727
15000US060830029303,798,484,170,628,19728
15000US060830029304,466,306,121,345,19729
15000US060830029305,1880,755,880,1000,19730
15000US060830029306,1466,733,594,872,19731
15000US060830029321,478,206,238,240,19732
15000US060830029322,1773,990,467,1306,19733
15000US060830030011,506,193,227,279,19734
15000US060830030012,1820,761,816,1004,19735
15000US060830030013,908,262,535,373,19736
15000US060830030014,1895,271,1444,451,19737
15000US060830030015,833,153,574,259,19738
15000US060830030041,1506,935,328,1178,19739
15000US060830030042,2021,1076,776,1245,19740
15000US060830030043,1676,881,580,1096,19741
15000US060830030051,1157,465,598,559,19742
15000US060830030052,1791,1145,465,1326,19743
15000US060830030053,2213,774,1047,1166,19744
15000US060830030071,1151,1060,17,1134,19745
15000US060830030072,1129,791,231,898,19746
15000US060830030073,1146,981,91,1055,19747
15000US060830031021,796,609,185,611,19748
15000US060830031022,1126,586,479,647,19749
15000US060830031023,1272,376,554,718,19750
15000US060839800001,8,8,0,8,19751
15000US060839801001,3,0,3,0,19752
15000US060839900000,0,0,0,0,19753
15000US060855001001,932,177,633,299,19754
15000US060855001002,1936,256,920,1016,19755
15000US060855001003,2620,108,2041,579,19756
15000US060855001004,2336,481,1056,1280,19757
15000US060855002001,1568,537,553,1015,19758
15000US060855002002,694,149,373,321,19759
15000US060855002003,1711,304,931,780,19760
15000US060855002004,2296,822,688,1608,19761
15000US060855003001,553,153,194,359,19762
15000US060855003002,3237,1491,672,2565,19763
15000US060855004001,1450,448,801,649,19764
15000US060855004002,967,653,134,833,19765
15000US060855005001,1141,807,192,949,19766
15000US060855005002,2011,1054,435,1576,19767
15000US060855005003,678,355,172,506,19768
15000US060855005004,897,598,108,789,19769
15000US060855005005,889,467,217,672,19770
15000US060855006001,2999,1162,825,2174,19771
15000US060855006002,1328,799,153,1175,19772
15000US060855006003,838,570,211,627,19773
15000US060855008001,1408,644,219,1189,19774
15000US060855008002,2275,741,1084,1191,19775
15000US060855009011,820,154,310,510,19776
15000US060855009012,3244,956,435,2809,19777
15000US060855009021,943,121,333,610,19778
15000US060855009022,5208,1625,1243,3965,19779
15000US060855010001,1296,146,908,388,19780
15000US060855010002,626,343,130,496,19781
15000US060855010003,781,163,307,474,19782
15000US060855010004,1080,227,641,439,19783
15000US060855010005,864,253,289,575,19784
15000US060855011011,2455,573,1015,1440,19785
15000US060855011012,2112,593,828,1284,19786
15000US060855011021,1053,351,427,626,19787
15000US060855011022,2138,315,1630,508,19788
15000US060855011023,1756,429,1011,745,19789
15000US060855012001,998,167,622,376,19790
15000US060855012002,1633,464,803,830,19791
15000US060855012003,987,181,536,451,19792
15000US060855012004,868,129,524,344,19793
15000US060855013001,622,441,99,523,19794
15000US060855013002,542,284,197,345,19795
15000US060855013003,1998,642,683,1315,19796
15000US060855013004,1413,817,252,1161,19797
15000US060855014011,2799,249,2122,677,19798
15000US060855014012,727,170,406,321,19799
15000US060855014021,1253,284,798,455,19800
15000US060855014022,2032,136,1636,396,19801
15000US060855015011,2409,107,1365,1044,19802
15000US060855015012,2461,173,1902,559,19803
15000US060855015021,1898,235,1607,291,19804
15000US060855015022,2711,312,1516,1195,19805
15000US060855016001,864,51,475,389,19806
15000US060855016002,734,323,347,387,19807
15000US060855016003,1847,243,996,851,19808
15000US060855016004,1965,1259,92,1873,19809
15000US060855016005,1681,310,980,701,19810
15000US060855017001,495,291,123,372,19811
15000US060855017002,612,89,523,89,19812
15000US060855017003,2399,18,2321,78,19813
15000US060855017004,1470,308,1097,373,19814
15000US060855018001,1433,429,607,826,19815
15000US060855018002,1477,275,1165,312,19816
15000US060855018003,1242,596,400,842,19817
15000US060855018004,1169,652,432,737,19818
15000US060855019001,3459,1522,543,2916,19819
15000US060855019002,1924,615,1092,832,19820
15000US060855020011,1548,222,1211,337,19821
15000US060855020012,927,277,163,764,19822
15000US060855020013,1328,450,737,591,19823
15000US060855020014,1759,570,806,953,19824
15000US060855020021,737,152,480,257,19825
15000US060855020022,1665,197,1265,400,19826
15000US060855020023,2743,506,1680,1063,19827
15000US060855021011,1090,526,172,918,19828
15000US060855021012,979,591,82,897,19829
15000US060855021013,3021,1724,721,2300,19830
15000US060855021021,2210,319,1377,833,19831
15000US060855021022,2484,390,1429,1055,19832
15000US060855021023,1381,639,296,1085,19833
15000US060855021024,1528,353,987,541,19834
15000US060855022011,3790,1961,899,2891,19835
15000US060855022012,3151,743,1312,1839,19836
15000US060855022021,1430,917,257,1173,19837
15000US060855022022,1086,683,116,970,19838
15000US060855022023,748,396,232,516,19839
15000US060855023011,1593,895,259,1334,19840
15000US060855023012,1931,1467,294,1637,19841
15000US060855023021,1382,958,322,1060,19842
15000US060855023022,1431,793,367,1064,19843
15000US060855024001,529,398,57,472,19844
15000US060855024002,644,613,18,626,19845
15000US060855024003,630,426,204,426,19846
15000US060855024004,1064,877,125,939,19847
15000US060855024005,2153,1059,471,1682,19848
15000US060855024006,1349,730,272,1077,19849
15000US060855024007,668,558,94,574,19850
15000US060855025001,1075,836,151,924,19851
15000US060855025002,1121,675,103,1018,19852
15000US060855025003,1018,860,133,885,19853
15000US060855025004,1098,920,99,999,19854
15000US060855025005,742,469,112,630,19855
15000US060855025006,1358,827,368,990,19856
15000US060855026011,637,421,67,570,19857
15000US060855026012,895,565,201,694,19858
15000US060855026013,1215,881,108,1107,19859
15000US060855026031,660,426,208,452,19860
15000US060855026032,815,440,87,728,19861
15000US060855026033,1052,782,123,929,19862
15000US060855026041,2110,965,223,1887,19863
15000US060855026042,1241,694,273,968,19864
15000US060855026043,909,718,137,772,19865
15000US060855027011,1664,979,336,1328,19866
15000US060855027012,1481,978,235,1246,19867
15000US060855027013,1773,728,503,1270,19868
15000US060855027021,2224,1520,340,1884,19869
15000US060855027022,1706,817,304,1402,19870
15000US060855027023,1170,770,251,919,19871
15000US060855027024,1636,1006,157,1479,19872
15000US060855027025,897,490,112,785,19873
15000US060855028001,1582,850,528,1054,19874
15000US060855028002,1877,1044,337,1540,19875
15000US060855028003,912,726,69,843,19876
15000US060855029011,1866,831,666,1200,19877
15000US060855029012,1750,925,504,1246,19878
15000US060855029013,1111,642,159,952,19879
15000US060855029014,1620,834,426,1194,19880
15000US060855029021,2255,1538,228,2027,19881
15000US060855029022,2542,1683,538,2004,19882
15000US060855029023,2647,1104,830,1817,19883
15000US060855029031,2347,1484,515,1832,19884
15000US060855029032,1420,821,262,1158,19885
15000US060855029033,1551,882,345,1206,19886
15000US060855029061,1477,611,251,1226,19887
15000US060855029062,1745,1062,274,1471,19888
15000US060855029063,1116,748,193,923,19889
15000US060855029071,2213,1334,427,1786,19890
15000US060855029072,1584,1047,174,1410,19891
15000US060855029081,2126,1333,340,1786,19892
15000US060855029082,2805,1485,668,2137,19893
15000US060855029083,1947,1263,311,1636,19894
15000US060855029091,1118,690,117,1001,19895
15000US060855029092,891,625,144,747,19896
15000US060855029093,1670,653,673,997,19897
15000US060855029094,1727,564,684,1043,19898
15000US060855029101,832,524,141,691,19899
15000US060855029102,827,356,268,559,19900
15000US060855029103,407,177,58,349,19901
15000US060855029104,1324,645,385,939,19902
15000US060855030011,1227,907,152,1075,19903
15000US060855030012,1007,921,53,954,19904
15000US060855030013,1982,1518,254,1728,19905
15000US060855030021,1693,860,434,1259,19906
15000US060855030022,1875,1106,482,1393,19907
15000US060855030031,1069,716,146,923,19908
15000US060855030032,2181,1317,418,1763,19909
15000US060855030033,1545,950,237,1308,19910
15000US060855030034,776,277,224,552,19911
15000US060855031051,2345,171,516,1829,19912
15000US060855031081,1994,617,959,1035,19913
15000US060855031082,3216,1154,431,2785,19914
15000US060855031083,1674,19,1101,573,19915
15000US060855031084,1210,113,552,658,19916
15000US060855031101,2854,18,1996,858,19917
15000US060855031102,1374,43,583,791,19918
15000US060855031103,1230,30,1085,145,19919
15000US060855031111,1366,36,694,672,19920
15000US060855031112,1812,127,1080,732,19921
15000US060855031113,2079,50,576,1503,19922
15000US060855031121,2697,537,1474,1223,19923
15000US060855031122,1188,118,471,717,19924
15000US060855031131,1902,204,1453,449,19925
15000US060855031132,3115,218,2647,468,19926
15000US060855031151,6331,2694,1227,5104,19927
15000US060855031161,2949,1061,299,2650,19928
15000US060855031162,2387,706,347,2040,19929
15000US060855031171,1723,25,904,819,19930
15000US060855031172,1395,46,773,622,19931
15000US060855031181,937,25,217,720,19932
15000US060855031182,2117,109,862,1255,19933
15000US060855031183,2435,156,1493,942,19934
15000US060855031211,3878,540,2421,1457,19935
15000US060855031212,662,213,244,418,19936
15000US060855031221,2028,238,735,1293,19937
15000US060855031222,995,50,220,775,19938
15000US060855031231,1983,637,906,1077,19939
15000US060855031232,1894,496,731,1163,19940
15000US060855032041,3640,197,1182,2458,19941
15000US060855032042,1231,331,518,713,19942
15000US060855032043,1264,67,746,518,19943
15000US060855032044,440,44,285,155,19944
15000US060855032045,2774,51,1647,1127,19945
15000US060855032071,2622,150,439,2183,19946
15000US060855032072,1680,134,210,1470,19947
15000US060855032081,3109,149,2491,618,19948
15000US060855032082,1529,158,461,1068,19949
15000US060855032101,2589,137,1311,1278,19950
15000US060855032102,1824,130,443,1381,19951
15000US060855032111,2366,128,706,1660,19952
15000US060855032112,2330,137,498,1832,19953
15000US060855032121,901,131,165,736,19954
15000US060855032122,2185,195,931,1254,19955
15000US060855032123,1184,51,98,1086,19956
15000US060855032131,1766,143,953,813,19957
15000US060855032132,2731,164,527,2204,19958
15000US060855032141,6078,166,3102,2976,19959
15000US060855032142,2574,23,987,1587,19960
15000US060855032171,2024,67,1152,872,19961
15000US060855032172,1566,10,1164,402,19962
15000US060855032173,1303,48,1075,228,19963
15000US060855032181,3400,93,2755,645,19964
15000US060855032182,1516,76,1191,325,19965
15000US060855033041,2348,122,1270,1078,19966
15000US060855033042,2364,84,1316,1048,19967
15000US060855033043,1594,21,304,1290,19968
15000US060855033044,821,112,143,678,19969
15000US060855033051,1294,42,377,917,19970
15000US060855033052,3254,92,2371,883,19971
15000US060855033053,1830,48,256,1574,19972
15000US060855033061,963,90,289,674,19973
15000US060855033062,1932,39,1477,455,19974
15000US060855033063,1381,44,844,537,19975
15000US060855033121,562,244,100,462,19976
15000US060855033122,1888,706,526,1362,19977
15000US060855033123,1319,61,1011,308,19978
15000US060855033131,1698,246,277,1421,19979
15000US060855033132,1416,261,319,1097,19980
15000US060855033133,1365,248,412,953,19981
15000US060855033151,2408,123,759,1649,19982
15000US060855033152,1119,52,631,488,19983
15000US060855033153,4753,293,1431,3322,19984
15000US060855033211,2084,146,421,1663,19985
15000US060855033212,2858,37,331,2527,19986
15000US060855033221,1592,231,921,671,19987
15000US060855033222,1678,120,450,1228,19988
15000US060855033223,1234,198,448,786,19989
15000US060855033231,2155,322,497,1658,19990
15000US060855033232,2496,238,1084,1412,19991
15000US060855033241,2066,175,231,1835,19992
15000US060855033242,1526,154,295,1231,19993
15000US060855033251,2308,525,698,1610,19994
15000US060855033252,2591,79,329,2262,19995
15000US060855033261,5074,215,312,4762,19996
15000US060855033262,2201,224,555,1646,19997
15000US060855033271,1893,203,555,1338,19998
15000US060855033272,1908,131,505,1403,19999
15000US060855033273,1229,531,366,863,20000
15000US060855033291,1811,176,82,1729,20001
15000US060855033292,1869,254,392,1477,20002
15000US060855033301,2139,460,206,1933,20003
15000US060855033302,2082,68,175,1907,20004
15000US060855033303,4467,355,566,3901,20005
15000US060855033311,2164,961,526,1638,20006
15000US060855033312,1328,315,259,1069,20007
15000US060855033321,1482,1179,103,1379,20008
15000US060855033322,647,578,18,629,20009
15000US060855033323,1023,256,185,838,20010
15000US060855033324,2346,1222,305,2041,20011
15000US060855033331,1714,380,158,1556,20012
15000US060855033332,2714,701,774,1940,20013
15000US060855033341,4548,906,504,4044,20014
15000US060855033342,1717,244,146,1571,20015
15000US060855033343,2342,705,67,2275,20016
15000US060855033361,1619,55,554,1065,20017
15000US060855033362,2136,111,956,1180,20018
15000US060855033371,2244,123,658,1586,20019
15000US060855033372,1504,273,256,1248,20020
15000US060855034011,1078,0,881,197,20021
15000US060855034012,1785,44,1088,697,20022
15000US060855034013,1785,53,1436,349,20023
15000US060855034021,0,0,0,0,20024
15000US060855034022,2252,19,1352,900,20025
15000US060855034023,3838,23,2660,1178,20026
15000US060855035041,1940,0,1475,465,20027
15000US060855035042,2016,0,1517,499,20028
15000US060855035043,1431,0,1112,319,20029
15000US060855035044,484,0,298,186,20030
15000US060855035045,578,16,323,255,20031
15000US060855035061,2654,48,1889,765,20032
15000US060855035062,2391,107,1295,1096,20033
15000US060855035063,1145,47,618,527,20034
15000US060855035071,1926,31,1460,466,20035
15000US060855035072,616,21,515,101,20036
15000US060855035081,4100,149,2858,1242,20037
15000US060855035082,2996,222,2196,800,20038
15000US060855035091,1893,106,1234,659,20039
15000US060855035092,933,27,558,375,20040
15000US060855035093,1044,62,476,568,20041
15000US060855035101,3235,310,2306,929,20042
15000US060855035102,1229,40,858,371,20043
15000US060855035103,1615,80,1179,436,20044
15000US060855035111,1845,128,501,1344,20045
15000US060855035112,1965,196,1098,867,20046
15000US060855036011,961,116,364,597,20047
15000US060855036012,1985,592,1234,751,20048
15000US060855036021,2118,219,1578,540,20049
15000US060855036022,2236,38,1197,1039,20050
15000US060855036023,894,14,524,370,20051
15000US060855037031,925,40,700,225,20052
15000US060855037032,1201,51,791,410,20053
15000US060855037033,2282,0,1605,677,20054
15000US060855037071,2807,44,1732,1075,20055
15000US060855037072,2595,144,943,1652,20056
15000US060855037073,820,60,659,161,20057
15000US060855037081,1887,87,395,1492,20058
15000US060855037082,738,66,185,553,20059
15000US060855037091,2616,68,1267,1349,20060
15000US060855037092,1541,14,586,955,20061
15000US060855037093,1720,9,429,1291,20062
15000US060855037101,1656,19,1154,502,20063
15000US060855037102,2199,154,1267,932,20064
15000US060855037111,1039,92,761,278,20065
15000US060855037112,2248,78,1793,455,20066
15000US060855037113,1855,25,1616,239,20067
15000US060855037121,989,106,465,524,20068
15000US060855037122,3079,199,1438,1641,20069
15000US060855037131,2331,67,1244,1087,20070
15000US060855037132,819,98,590,229,20071
15000US060855038021,3980,628,1694,2286,20072
15000US060855038022,942,159,304,638,20073
15000US060855038023,1310,208,609,701,20074
15000US060855038024,2096,524,672,1424,20075
15000US060855038031,3196,367,546,2650,20076
15000US060855038032,1571,360,126,1445,20077
15000US060855038041,2417,260,201,2216,20078
15000US060855038042,1252,29,780,472,20079
15000US060855038043,1840,299,611,1229,20080
15000US060855039021,1787,149,1129,658,20081
15000US060855039022,775,175,417,358,20082
15000US060855039023,1147,128,865,282,20083
15000US060855039024,1929,164,1454,475,20084
15000US060855039031,2380,139,981,1399,20085
15000US060855039032,1219,117,896,323,20086
15000US060855040011,1667,94,1171,496,20087
15000US060855040012,2500,89,2110,390,20088
15000US060855040013,2135,104,1423,712,20089
15000US060855040021,2474,238,907,1567,20090
15000US060855040022,4054,42,3363,691,20091
15000US060855041011,1575,228,1147,428,20092
15000US060855041012,3389,383,2281,1108,20093
15000US060855041021,2863,315,1780,1083,20094
15000US060855041022,1572,44,1296,276,20095
15000US060855041023,1665,20,1544,121,20096
15000US060855042011,2734,1179,721,2013,20097
15000US060855042012,982,481,325,657,20098
15000US060855042013,1632,391,712,920,20099
15000US060855042021,1031,423,287,744,20100
15000US060855042022,1799,786,546,1253,20101
15000US060855042023,2069,485,1113,956,20102
15000US060855043071,2539,323,313,2226,20103
15000US060855043072,3036,622,467,2569,20104
15000US060855043081,1793,384,273,1520,20105
15000US060855043082,1239,403,165,1074,20106
15000US060855043083,1366,470,225,1141,20107
15000US060855043111,2608,577,40,2568,20108
15000US060855043112,2808,196,240,2568,20109
15000US060855043113,1804,111,136,1668,20110
15000US060855043141,1117,143,195,922,20111
15000US060855043142,1142,90,131,1011,20112
15000US060855043143,1086,115,419,667,20113
15000US060855043144,1492,160,443,1049,20114
15000US060855043151,1726,181,210,1516,20115
15000US060855043152,968,208,71,897,20116
15000US060855043153,1255,174,39,1216,20117
15000US060855043154,983,114,142,841,20118
15000US060855043155,1787,219,551,1236,20119
15000US060855043161,2714,191,307,2407,20120
15000US060855043162,1762,244,514,1248,20121
15000US060855043163,925,138,304,621,20122
15000US060855043171,2325,154,329,1996,20123
15000US060855043172,2561,340,95,2466,20124
15000US060855043181,3285,413,1521,1764,20125
15000US060855043182,164,0,76,88,20126
15000US060855043183,1817,145,391,1426,20127
15000US060855043191,2588,395,575,2013,20128
15000US060855043192,2453,345,182,2271,20129
15000US060855043193,2302,362,290,2012,20130
15000US060855043201,1799,274,160,1639,20131
15000US060855043202,1050,138,10,1040,20132
15000US060855043211,2280,287,225,2055,20133
15000US060855043212,1733,90,444,1289,20134
15000US060855043213,1402,328,273,1129,20135
15000US060855043221,1539,228,474,1065,20136
15000US060855043222,1500,135,46,1454,20137
15000US060855043223,1984,286,45,1939,20138
15000US060855043231,1334,71,96,1238,20139
15000US060855043232,3852,339,423,3429,20140
15000US060855043233,869,38,160,709,20141
15000US060855044101,2183,317,392,1791,20142
15000US060855044102,2487,438,164,2323,20143
15000US060855044111,3171,450,657,2514,20144
15000US060855044112,2355,519,403,1952,20145
15000US060855044121,1208,140,47,1161,20146
15000US060855044122,1308,165,403,905,20147
15000US060855044123,1590,44,636,954,20148
15000US060855044124,1111,67,171,940,20149
15000US060855044131,1779,267,45,1734,20150
15000US060855044141,3128,345,309,2819,20151
15000US060855044142,1319,130,0,1319,20152
15000US060855044143,1343,64,0,1343,20153
15000US060855044151,1912,102,0,1912,20154
15000US060855044152,1903,309,392,1511,20155
15000US060855044153,1778,547,292,1486,20156
15000US060855044161,1836,202,123,1713,20157
15000US060855044162,1819,240,460,1359,20158
15000US060855044171,410,146,133,277,20159
15000US060855044181,2478,73,524,1954,20160
15000US060855044182,2195,402,823,1372,20161
15000US060855044183,704,155,21,683,20162
15000US060855044201,2221,425,383,1838,20163
15000US060855044202,1719,377,7,1712,20164
15000US060855044203,727,92,49,678,20165
15000US060855044211,1661,132,297,1364,20166
15000US060855044212,1629,206,150,1479,20167
15000US060855044213,1714,271,120,1594,20168
15000US060855044221,1747,120,496,1251,20169
15000US060855044222,2176,185,324,1852,20170
15000US060855044231,2591,709,460,2131,20171
15000US060855045041,817,176,105,712,20172
15000US060855045042,0,0,0,0,20173
15000US060855045043,2845,447,1116,1729,20174
15000US060855045044,5761,340,213,5548,20175
15000US060855045051,837,132,196,641,20176
15000US060855045052,2781,238,250,2531,20177
15000US060855045053,3407,304,477,2930,20178
15000US060855045061,1452,196,105,1347,20179
15000US060855045062,2971,247,253,2718,20180
15000US060855045063,2162,139,368,1794,20181
15000US060855045071,1229,257,416,813,20182
15000US060855045072,1694,203,434,1260,20183
15000US060855045073,1580,50,209,1371,20184
15000US060855045074,1752,341,445,1307,20185
15000US060855046011,869,452,243,626,20186
15000US060855046021,1957,393,980,977,20187
15000US060855047001,753,379,122,631,20188
15000US060855048021,1990,835,476,1514,20189
15000US060855048022,841,308,158,683,20190
15000US060855048023,2542,335,799,1743,20191
15000US060855048031,1546,279,871,675,20192
15000US060855048032,4657,1058,162,4495,20193
15000US060855048051,4458,2565,583,3875,20194
15000US060855048052,2297,1101,290,2007,20195
15000US060855048061,1384,304,472,912,20196
15000US060855048062,1551,314,395,1156,20197
15000US060855049011,10593,2649,333,10260,20198
15000US060855050011,3522,794,418,3104,20199
15000US060855050012,2264,590,369,1895,20200
15000US060855050013,2537,813,503,2034,20201
15000US060855050014,579,176,155,424,20202
15000US060855050015,912,222,17,895,20203
15000US060855050061,1965,663,161,1804,20204
15000US060855050062,4666,1290,205,4461,20205
15000US060855050071,979,315,42,937,20206
15000US060855050072,3332,824,889,2443,20207
15000US060855050081,5364,1333,542,4822,20208
15000US060855050082,81,0,0,81,20209
15000US060855050091,4881,894,2218,2663,20210
15000US060855050092,947,425,300,647,20211
15000US060855050093,3462,918,472,2990,20212
15000US060855051001,3304,706,1129,2175,20213
15000US060855051002,130,13,117,13,20214
15000US060855052021,1750,476,601,1149,20215
15000US060855052022,2586,925,555,2031,20216
15000US060855052023,1963,354,1086,877,20217
15000US060855052031,4572,2311,521,4051,20218
15000US060855052032,1093,249,487,606,20219
15000US060855053011,1062,277,255,807,20220
15000US060855053012,829,190,222,607,20221
15000US060855053013,793,214,105,688,20222
15000US060855053014,1749,220,582,1167,20223
15000US060855053021,2578,939,436,2142,20224
15000US060855053022,1230,460,361,869,20225
15000US060855053031,1499,630,352,1147,20226
15000US060855053032,1895,797,432,1463,20227
15000US060855053033,534,326,21,513,20228
15000US060855053034,2265,194,1053,1212,20229
15000US060855053041,987,327,343,644,20230
15000US060855053042,966,342,250,716,20231
15000US060855053043,517,289,11,506,20232
15000US060855053044,1022,271,249,773,20233
15000US060855053051,1286,935,27,1259,20234
15000US060855053052,1026,298,0,1026,20235
15000US060855053053,2142,505,335,1807,20236
15000US060855053054,1337,493,71,1266,20237
15000US060855054011,763,351,55,708,20238
15000US060855054012,2015,474,30,1985,20239
15000US060855054013,2109,264,45,2064,20240
15000US060855054014,791,443,154,637,20241
15000US060855054015,804,93,296,508,20242
15000US060855054021,1105,434,276,829,20243
15000US060855054022,2072,721,492,1580,20244
15000US060855054031,1642,407,131,1511,20245
15000US060855054032,2263,747,735,1528,20246
15000US060855054033,2818,738,833,1985,20247
15000US060855055001,1032,477,368,664,20248
15000US060855055002,2027,722,543,1484,20249
15000US060855055003,1174,666,167,1007,20250
15000US060855056001,1353,664,211,1142,20251
15000US060855056002,529,276,180,349,20252
15000US060855056003,2374,1292,500,1874,20253
15000US060855057001,902,251,128,774,20254
15000US060855057002,1178,621,372,806,20255
15000US060855057003,2230,1440,422,1808,20256
15000US060855057004,2701,806,923,1778,20257
15000US060855058001,939,433,247,692,20258
15000US060855058002,712,332,267,445,20259
15000US060855058003,1008,531,234,774,20260
15000US060855058004,1195,812,236,959,20261
15000US060855059001,2740,1143,663,2077,20262
15000US060855059002,853,455,182,671,20263
15000US060855059003,800,610,23,777,20264
15000US060855059004,1530,438,160,1370,20265
15000US060855059005,1351,896,199,1152,20266
15000US060855060001,1253,623,327,926,20267
15000US060855060002,723,542,149,574,20268
15000US060855060003,1841,996,188,1653,20269
15000US060855060004,772,263,111,661,20270
15000US060855061011,1312,654,98,1214,20271
15000US060855061012,1842,669,380,1462,20272
15000US060855061013,1499,574,334,1165,20273
15000US060855061021,1383,832,145,1238,20274
15000US060855061022,2294,854,241,2053,20275
15000US060855061031,2080,521,149,1931,20276
15000US060855061032,804,355,26,778,20277
15000US060855061033,934,376,12,922,20278
15000US060855061034,1144,350,324,820,20279
15000US060855062021,1974,816,175,1799,20280
15000US060855062022,2587,760,276,2311,20281
15000US060855062023,2663,1409,74,2589,20282
15000US060855062031,1652,254,523,1129,20283
15000US060855062032,2554,533,162,2392,20284
15000US060855062033,2471,180,269,2202,20285
15000US060855062041,2224,549,339,1885,20286
15000US060855062042,1279,648,141,1138,20287
15000US060855062043,931,369,0,931,20288
15000US060855062044,1372,307,56,1316,20289
15000US060855063011,1367,343,173,1194,20290
15000US060855063012,2036,942,281,1755,20291
15000US060855063013,1225,634,108,1117,20292
15000US060855063014,944,429,272,672,20293
15000US060855063021,2619,911,863,1756,20294
15000US060855063022,2032,1094,133,1899,20295
15000US060855063023,2400,1374,448,1952,20296
15000US060855063041,2574,907,990,1584,20297
15000US060855063042,657,142,258,399,20298
15000US060855063043,2616,572,606,2010,20299
15000US060855063051,1485,181,849,636,20300
15000US060855063052,2460,888,953,1507,20301
15000US060855063053,1333,477,39,1294,20302
15000US060855063054,1534,412,588,946,20303
15000US060855064011,2995,1028,1113,1882,20304
15000US060855064012,2226,713,280,1946,20305
15000US060855064021,2105,624,1058,1047,20306
15000US060855064022,722,451,70,652,20307
15000US060855064023,2313,946,753,1560,20308
15000US060855064024,996,718,165,831,20309
15000US060855065011,2431,532,1321,1110,20310
15000US060855065012,3547,808,1277,2270,20311
15000US060855065013,1809,328,1020,789,20312
15000US060855065021,1940,1092,335,1605,20313
15000US060855065022,689,480,122,567,20314
15000US060855065023,1583,1080,249,1334,20315
15000US060855065031,2129,1050,389,1740,20316
15000US060855065032,1766,1121,223,1543,20317
15000US060855065033,2444,1278,785,1659,20318
15000US060855066011,2150,841,446,1704,20319
15000US060855066012,951,395,97,854,20320
15000US060855066013,1739,695,512,1227,20321
15000US060855066031,607,323,98,509,20322
15000US060855066032,2025,946,214,1811,20323
15000US060855066033,1526,589,255,1271,20324
15000US060855066041,781,314,57,724,20325
15000US060855066042,1671,1020,11,1660,20326
15000US060855066043,1679,1266,124,1555,20327
15000US060855066044,1509,853,171,1338,20328
15000US060855066045,1596,657,226,1370,20329
15000US060855066051,2292,910,655,1637,20330
15000US060855066052,1834,575,471,1363,20331
15000US060855066061,738,358,89,649,20332
15000US060855066062,2290,1118,467,1823,20333
15000US060855066063,1445,692,392,1053,20334
15000US060855067011,723,444,73,650,20335
15000US060855067012,1505,724,292,1213,20336
15000US060855067013,1436,963,174,1262,20337
15000US060855067021,2644,903,842,1802,20338
15000US060855067022,2310,1684,163,2147,20339
15000US060855067023,1145,822,156,989,20340
15000US060855067031,1725,1122,228,1497,20341
15000US060855067032,1153,602,143,1010,20342
15000US060855067033,767,449,84,683,20343
15000US060855068011,1962,1516,103,1859,20344
15000US060855068012,1526,977,109,1417,20345
15000US060855068013,1602,1287,139,1463,20346
15000US060855068014,931,576,148,783,20347
15000US060855068021,1432,1007,140,1292,20348
15000US060855068022,1638,1227,121,1517,20349
15000US060855068023,1113,655,254,859,20350
15000US060855068024,634,488,99,535,20351
15000US060855068025,943,495,107,836,20352
15000US060855068031,1860,1210,330,1530,20353
15000US060855068032,1454,782,263,1191,20354
15000US060855068033,2976,1799,471,2505,20355
15000US060855068034,923,559,31,892,20356
15000US060855068041,670,543,58,612,20357
15000US060855068042,1203,690,160,1043,20358
15000US060855068043,1132,749,70,1062,20359
15000US060855068044,565,398,0,565,20360
15000US060855069001,1281,950,120,1161,20361
15000US060855069002,1926,1403,137,1789,20362
15000US060855069003,1994,1567,44,1950,20363
15000US060855069004,2512,1954,100,2412,20364
15000US060855070011,2243,1872,260,1983,20365
15000US060855070012,2614,2248,115,2499,20366
15000US060855070013,1507,1272,28,1479,20367
15000US060855070014,437,410,0,437,20368
15000US060855070021,1822,1297,77,1745,20369
15000US060855070022,1096,937,42,1054,20370
15000US060855071001,1018,756,136,882,20371
15000US060855071002,1793,1353,181,1612,20372
15000US060855072031,1509,940,88,1421,20373
15000US060855072032,1471,1154,104,1367,20374
15000US060855072051,816,638,66,750,20375
15000US060855072052,1527,1300,33,1494,20376
15000US060855072053,1482,1021,49,1433,20377
15000US060855072054,717,641,0,717,20378
15000US060855072061,1562,1208,38,1524,20379
15000US060855072062,1280,979,60,1220,20380
15000US060855073011,844,221,0,844,20381
15000US060855073012,1235,617,70,1165,20382
15000US060855073013,1051,361,120,931,20383
15000US060855073014,1088,438,80,1008,20384
15000US060855073015,1177,708,47,1130,20385
15000US060855073016,1434,954,58,1376,20386
15000US060855073021,1921,1121,97,1824,20387
15000US060855073022,1179,870,11,1168,20388
15000US060855074011,1262,423,0,1262,20389
15000US060855074012,1216,296,9,1207,20390
15000US060855074013,1441,464,63,1378,20391
15000US060855074014,1021,560,23,998,20392
15000US060855074015,655,280,0,655,20393
15000US060855074021,1684,785,211,1473,20394
15000US060855074022,1220,955,63,1157,20395
15000US060855074023,1207,592,67,1140,20396
15000US060855075001,1946,791,0,1946,20397
15000US060855075002,1381,399,29,1352,20398
15000US060855075003,1306,351,7,1299,20399
15000US060855075004,1167,439,10,1157,20400
15000US060855076001,609,490,19,590,20401
15000US060855076002,1146,517,39,1107,20402
15000US060855076003,1799,774,19,1780,20403
15000US060855076004,2039,1040,76,1963,20404
15000US060855077011,1018,316,101,917,20405
15000US060855077012,1700,451,43,1657,20406
15000US060855077013,1147,345,49,1098,20407
15000US060855077021,1907,374,0,1907,20408
15000US060855077022,1694,538,21,1673,20409
15000US060855077023,2808,980,54,2754,20410
15000US060855077031,1205,313,22,1183,20411
15000US060855077032,2126,1020,20,2106,20412
15000US060855077033,1998,878,24,1974,20413
15000US060855077034,1371,554,57,1314,20414
15000US060855077035,1322,303,67,1255,20415
15000US060855078051,3426,993,235,3191,20416
15000US060855078052,1253,467,0,1253,20417
15000US060855078053,1294,317,102,1192,20418
15000US060855078061,906,202,73,833,20419
15000US060855078062,1843,295,16,1827,20420
15000US060855078063,2812,289,91,2721,20421
15000US060855078071,1425,319,53,1372,20422
15000US060855078072,1895,266,35,1860,20423
15000US060855078081,876,159,0,876,20424
15000US060855078082,1186,307,24,1162,20425
15000US060855078083,1394,274,23,1371,20426
15000US060855078084,1990,484,0,1990,20427
15000US060855079031,1805,335,95,1710,20428
15000US060855079032,3170,871,128,3042,20429
15000US060855079041,1869,318,64,1805,20430
15000US060855079042,1371,408,20,1351,20431
15000US060855079051,1866,181,136,1730,20432
15000US060855079052,2288,744,105,2183,20433
15000US060855079053,2069,329,25,2044,20434
15000US060855079061,1354,334,15,1339,20435
15000US060855079062,1370,302,8,1362,20436
15000US060855079063,929,183,24,905,20437
15000US060855079064,897,214,17,880,20438
15000US060855080011,2548,361,69,2479,20439
15000US060855080012,1069,358,18,1051,20440
15000US060855080013,3517,694,509,3008,20441
15000US060855080014,832,204,36,796,20442
15000US060855080031,1676,530,46,1630,20443
15000US060855080032,722,353,19,703,20444
15000US060855080041,3004,651,268,2736,20445
15000US060855080042,1346,433,69,1277,20446
15000US060855080043,2588,782,224,2364,20447
15000US060855081011,1993,594,110,1883,20448
15000US060855081012,2345,569,93,2252,20449
15000US060855081013,2590,583,18,2572,20450
15000US060855081021,3135,728,108,3027,20451
15000US060855082021,1265,529,178,1087,20452
15000US060855082022,2470,657,212,2258,20453
15000US060855082023,904,239,92,812,20454
15000US060855082024,1634,849,140,1494,20455
15000US060855082025,1333,713,151,1182,20456
15000US060855082031,1215,674,33,1182,20457
15000US060855082032,1766,451,46,1720,20458
15000US060855082033,2282,471,220,2062,20459
15000US060855082041,1907,463,195,1712,20460
15000US060855082042,874,385,51,823,20461
15000US060855082043,1361,495,38,1323,20462
15000US060855083011,1292,684,67,1225,20463
15000US060855083012,1392,618,44,1348,20464
15000US060855083013,1946,948,0,1946,20465
15000US060855083031,1382,732,21,1361,20466
15000US060855083032,1188,744,36,1152,20467
15000US060855083041,1548,776,63,1485,20468
15000US060855083042,872,254,80,792,20469
15000US060855083043,897,418,140,757,20470
15000US060855083044,1910,305,167,1743,20471
15000US060855083045,3158,685,361,2797,20472
15000US060855084011,640,298,67,573,20473
15000US060855084012,1236,731,92,1144,20474
15000US060855084013,1292,467,117,1175,20475
15000US060855084014,905,475,175,730,20476
15000US060855084015,1460,745,89,1371,20477
15000US060855084016,1281,558,19,1262,20478
15000US060855084031,941,483,96,845,20479
15000US060855084032,1189,711,39,1150,20480
15000US060855084033,1107,467,23,1084,20481
15000US060855084041,3593,1376,598,2995,20482
15000US060855084042,1419,898,54,1365,20483
15000US060855084043,1372,655,49,1323,20484
15000US060855085031,1811,548,309,1502,20485
15000US060855085032,1754,500,32,1722,20486
15000US060855085033,3385,719,212,3173,20487
15000US060855085041,2445,192,42,2403,20488
15000US060855085042,2091,525,386,1705,20489
15000US060855085043,1676,268,901,775,20490
15000US060855085044,2641,450,1013,1628,20491
15000US060855085051,1349,630,99,1250,20492
15000US060855085052,1237,456,139,1098,20493
15000US060855085053,2117,865,148,1969,20494
15000US060855085071,1417,479,60,1357,20495
15000US060855085072,1754,224,248,1506,20496
15000US060855085081,855,407,94,761,20497
15000US060855085082,1197,320,49,1148,20498
15000US060855085083,2517,836,702,1815,20499
15000US060855085084,926,80,276,650,20500
15000US060855086011,720,245,187,533,20501
15000US060855086012,1482,627,127,1355,20502
15000US060855086013,1619,617,428,1191,20503
15000US060855086021,2814,995,610,2204,20504
15000US060855086022,1056,664,153,903,20505
15000US060855086023,867,342,165,702,20506
15000US060855087031,849,405,47,802,20507
15000US060855087032,1754,261,112,1642,20508
15000US060855087033,1648,474,145,1503,20509
15000US060855087034,994,524,130,864,20510
15000US060855087035,2567,512,585,1982,20511
15000US060855087041,2541,473,834,1707,20512
15000US060855087042,2790,793,547,2243,20513
15000US060855087043,1182,338,82,1100,20514
15000US060855088001,2371,550,561,1810,20515
15000US060855088002,1412,426,738,674,20516
15000US060855089001,2885,416,1521,1364,20517
15000US060855089002,1532,523,311,1221,20518
15000US060855089003,758,216,196,562,20519
15000US060855090001,2783,360,2003,780,20520
15000US060855090002,1843,541,751,1092,20521
15000US060855090003,2421,817,862,1559,20522
15000US060855090004,1590,276,855,735,20523
15000US060855091021,2212,796,208,2004,20524
15000US060855091022,2639,456,184,2455,20525
15000US060855091051,2616,882,795,1821,20526
15000US060855091052,1707,701,567,1140,20527
15000US060855091053,1327,520,189,1138,20528
15000US060855091054,1557,256,62,1495,20529
15000US060855091061,1435,594,337,1098,20530
15000US060855091062,907,440,181,726,20531
15000US060855091063,1947,443,523,1424,20532
15000US060855091071,2031,1061,281,1750,20533
15000US060855091072,2837,411,766,2071,20534
15000US060855091081,1033,414,204,829,20535
15000US060855091082,816,236,136,680,20536
15000US060855091083,1249,503,319,930,20537
15000US060855091084,1340,558,382,958,20538
15000US060855091091,3090,1482,554,2536,20539
15000US060855091092,1513,626,89,1424,20540
15000US060855092011,1448,718,299,1149,20541
15000US060855092012,934,537,130,804,20542
15000US060855092013,1148,652,90,1058,20543
15000US060855092014,1250,539,236,1014,20544
15000US060855092021,1944,795,455,1489,20545
15000US060855092022,854,458,72,782,20546
15000US060855092023,1193,403,320,873,20547
15000US060855092024,644,372,87,557,20548
15000US060855093021,3192,1984,377,2815,20549
15000US060855093031,1053,463,178,875,20550
15000US060855093032,1034,424,309,725,20551
15000US060855093033,703,258,191,512,20552
15000US060855093034,654,434,93,561,20553
15000US060855093041,1602,375,715,887,20554
15000US060855093042,1771,873,256,1515,20555
15000US060855094011,1508,571,64,1444,20556
15000US060855094012,785,565,35,750,20557
15000US060855094013,1445,502,156,1289,20558
15000US060855094031,2529,581,1401,1128,20559
15000US060855094032,2480,1228,462,2018,20560
15000US060855094041,2102,662,27,2075,20561
15000US060855094042,1535,483,776,759,20562
15000US060855094043,2362,700,1092,1270,20563
15000US060855094044,1092,434,432,660,20564
15000US060855095001,2785,792,1167,1618,20565
15000US060855095002,1154,683,138,1016,20566
15000US060855095003,1432,431,538,894,20567
15000US060855096001,2143,1205,228,1915,20568
15000US060855096002,1260,766,53,1207,20569
15000US060855097001,821,619,112,709,20570
15000US060855097002,1144,487,315,829,20571
15000US060855097003,1100,595,204,896,20572
15000US060855098011,1471,529,419,1052,20573
15000US060855098012,888,659,71,817,20574
15000US060855098013,1703,992,121,1582,20575
15000US060855098014,1617,998,30,1587,20576
15000US060855098021,1678,724,240,1438,20577
15000US060855098022,1343,706,86,1257,20578
15000US060855099011,940,631,37,903,20579
15000US060855099012,939,629,24,915,20580
15000US060855099021,2397,1256,395,2002,20581
15000US060855099022,1015,577,76,939,20582
15000US060855099023,1421,1049,16,1405,20583
15000US060855100011,952,493,32,920,20584
15000US060855100012,1621,941,83,1538,20585
15000US060855100013,1112,660,43,1069,20586
15000US060855100014,798,416,58,740,20587
15000US060855100015,977,783,0,977,20588
15000US060855100016,738,351,0,738,20589
15000US060855100021,1558,866,109,1449,20590
15000US060855100022,1087,762,18,1069,20591
15000US060855100023,1195,646,57,1138,20592
15000US060855101001,1654,955,121,1533,20593
15000US060855101002,356,306,0,356,20594
15000US060855101003,960,769,16,944,20595
15000US060855102001,1781,1205,69,1712,20596
15000US060855102002,897,717,11,886,20597
15000US060855102003,1668,1036,53,1615,20598
15000US060855103001,1552,1030,6,1546,20599
15000US060855103002,1642,1048,96,1546,20600
15000US060855103003,1084,956,0,1084,20601
15000US060855104001,1477,706,52,1425,20602
15000US060855104002,783,556,22,761,20603
15000US060855104003,1029,698,18,1011,20604
15000US060855105001,1158,590,0,1158,20605
15000US060855105002,1867,1372,51,1816,20606
15000US060855105003,1971,1260,76,1895,20607
15000US060855106001,583,532,0,583,20608
15000US060855106002,3124,1093,998,2126,20609
15000US060855106003,1905,1017,178,1727,20610
15000US060855106004,952,407,26,926,20611
15000US060855107001,749,385,59,690,20612
15000US060855107002,1874,859,242,1632,20613
15000US060855107003,2510,1138,19,2491,20614
15000US060855108011,1223,723,26,1197,20615
15000US060855108012,2131,929,180,1951,20616
15000US060855108013,2443,1307,119,2324,20617
15000US060855108021,975,611,47,928,20618
15000US060855108022,889,479,70,819,20619
15000US060855108031,1292,614,216,1076,20620
15000US060855108032,1110,516,27,1083,20621
15000US060855109001,1429,921,38,1391,20622
15000US060855109002,2255,1210,56,2199,20623
15000US060855109003,1879,914,128,1751,20624
15000US060855110001,1765,675,210,1555,20625
15000US060855110002,1659,976,96,1563,20626
15000US060855110003,494,225,0,494,20627
15000US060855110004,1564,675,38,1526,20628
15000US060855110005,1331,806,18,1313,20629
15000US060855111001,1409,824,51,1358,20630
15000US060855111002,1685,844,218,1467,20631
15000US060855111003,1330,668,50,1280,20632
15000US060855111004,1147,747,39,1108,20633
15000US060855112001,1740,1266,77,1663,20634
15000US060855112002,1368,1084,25,1343,20635
15000US060855112003,756,425,56,700,20636
15000US060855112004,1194,727,42,1152,20637
15000US060855113011,2671,1779,207,2464,20638
15000US060855113012,1217,990,22,1195,20639
15000US060855113021,1511,818,59,1452,20640
15000US060855113022,590,331,0,590,20641
15000US060855113023,2056,1380,286,1770,20642
15000US060855114001,880,505,0,880,20643
15000US060855114002,1024,434,234,790,20644
15000US060855114003,603,430,10,593,20645
15000US060855114004,1066,785,17,1049,20646
15000US060855115001,1037,768,38,999,20647
15000US060855115002,1583,865,125,1458,20648
15000US060855115003,1948,1139,12,1936,20649
15000US060855115004,821,749,0,821,20650
15000US060855115005,2722,1551,470,2252,20651
15000US060855116081,16,16,0,16,20652
15000US060855116082,3113,1307,607,2506,20653
15000US060855116091,3206,2163,225,2981,20654
15000US060855117011,1236,851,72,1164,20655
15000US060855117012,2055,1405,199,1856,20656
15000US060855117013,1058,463,13,1045,20657
15000US060855117021,1857,1323,125,1732,20658
15000US060855117022,955,639,0,955,20659
15000US060855117041,2167,1343,57,2110,20660
15000US060855117042,744,369,30,714,20661
15000US060855117043,1724,1121,19,1705,20662
15000US060855117051,1113,650,47,1066,20663
15000US060855117071,2771,1766,226,2545,20664
15000US060855118001,1971,1764,70,1901,20665
15000US060855118002,1258,971,65,1193,20666
15000US060855118003,1482,1317,85,1397,20667
15000US060855119051,3182,1581,312,2870,20668
15000US060855119071,1552,856,266,1286,20669
15000US060855119072,2509,1014,144,2365,20670
15000US060855119091,3313,1600,68,3245,20671
15000US060855119092,2271,1207,42,2229,20672
15000US060855119093,2449,1036,124,2325,20673
15000US060855119101,1056,707,10,1046,20674
15000US060855119102,668,283,23,645,20675
15000US060855119103,1511,1260,19,1492,20676
15000US060855119111,2265,1076,89,2176,20677
15000US060855119112,1097,869,40,1057,20678
15000US060855119113,1595,966,111,1484,20679
15000US060855119121,2001,961,87,1914,20680
15000US060855119122,2172,929,130,2042,20681
15000US060855119123,1194,393,76,1118,20682
15000US060855119131,1349,779,220,1129,20683
15000US060855119132,1746,1194,146,1600,20684
15000US060855119133,1248,786,283,965,20685
15000US060855119141,1419,912,155,1264,20686
15000US060855119142,2880,1938,150,2730,20687
15000US060855119143,1455,833,135,1320,20688
15000US060855119151,1158,732,101,1057,20689
15000US060855119152,2520,591,1273,1247,20690
15000US060855119161,2159,1148,453,1706,20691
15000US060855119162,2615,1489,223,2392,20692
15000US060855120011,3312,895,731,2581,20693
15000US060855120012,1719,210,154,1565,20694
15000US060855120013,1689,550,486,1203,20695
15000US060855120051,1888,1084,475,1413,20696
15000US060855120052,625,502,64,561,20697
15000US060855120053,748,401,130,618,20698
15000US060855120054,1255,836,146,1109,20699
15000US060855120055,2167,676,900,1267,20700
15000US060855120171,2485,349,648,1837,20701
15000US060855120172,3437,262,1883,1554,20702
15000US060855120173,3197,487,1879,1318,20703
15000US060855120191,992,537,158,834,20704
15000US060855120192,1979,641,463,1516,20705
15000US060855120193,1933,536,624,1309,20706
15000US060855120201,847,241,363,484,20707
15000US060855120202,2683,673,643,2040,20708
15000US060855120203,3848,922,1508,2340,20709
15000US060855120211,1234,678,142,1092,20710
15000US060855120212,1627,575,199,1428,20711
15000US060855120213,1670,717,460,1210,20712
15000US060855120214,1630,398,742,888,20713
15000US060855120221,1134,385,373,761,20714
15000US060855120222,2200,654,644,1556,20715
15000US060855120223,2487,402,1331,1156,20716
15000US060855120231,2100,564,718,1382,20717
15000US060855120232,1939,319,1029,910,20718
15000US060855120233,2120,520,1124,996,20719
15000US060855120241,3702,1258,1076,2626,20720
15000US060855120242,1038,532,210,828,20721
15000US060855120251,2102,1221,225,1877,20722
15000US060855120252,1099,394,367,732,20723
15000US060855120261,1901,532,857,1044,20724
15000US060855120262,2085,471,779,1306,20725
15000US060855120271,1906,929,684,1222,20726
15000US060855120272,2829,958,640,2189,20727
15000US060855120291,1508,547,420,1088,20728
15000US060855120292,2632,1334,540,2092,20729
15000US060855120293,579,388,76,503,20730
15000US060855120294,2628,1311,795,1833,20731
15000US060855120301,1859,944,312,1547,20732
15000US060855120302,1159,546,360,799,20733
15000US060855120311,856,305,228,628,20734
15000US060855120312,1155,758,194,961,20735
15000US060855120313,1318,678,342,976,20736
15000US060855120314,1034,590,313,721,20737
15000US060855120321,1510,461,775,735,20738
15000US060855120322,886,503,146,740,20739
15000US060855120323,797,371,231,566,20740
15000US060855120331,1173,757,226,947,20741
15000US060855120332,2638,696,1053,1585,20742
15000US060855120333,1520,629,163,1357,20743
15000US060855120334,1455,484,779,676,20744
15000US060855120341,2659,1198,778,1881,20745
15000US060855120342,553,238,288,265,20746
15000US060855120351,2106,891,579,1527,20747
15000US060855120352,2445,1028,932,1513,20748
15000US060855120361,5450,1801,1333,4117,20749
15000US060855120371,2029,1002,374,1655,20750
15000US060855120372,1251,598,409,842,20751
15000US060855120381,3132,1073,1099,2033,20752
15000US060855120391,1755,235,794,961,20753
15000US060855120392,1277,400,154,1123,20754
15000US060855120393,1813,286,460,1353,20755
15000US060855120421,1478,162,492,986,20756
15000US060855120422,1331,151,686,645,20757
15000US060855120431,4390,265,3013,1377,20758
15000US060855120432,2510,433,1282,1228,20759
15000US060855120451,2213,1025,577,1636,20760
15000US060855120452,763,342,218,545,20761
15000US060855120453,789,527,146,643,20762
15000US060855120454,2040,888,620,1420,20763
15000US060855120471,2707,1134,812,1895,20764
15000US060855120472,1561,809,334,1227,20765
15000US060855120473,1197,752,309,888,20766
15000US060855120521,1058,694,177,881,20767
15000US060855120522,2359,1091,697,1662,20768
15000US060855120523,1284,619,245,1039,20769
15000US060855120531,2578,404,1202,1376,20770
15000US060855120532,1085,576,235,850,20771
15000US060855120533,908,613,138,770,20772
15000US060855121001,1495,626,702,793,20773
15000US060855122001,1416,1134,127,1289,20774
15000US060855122002,3115,1987,735,2380,20775
15000US060855123051,3088,1582,580,2508,20776
15000US060855123052,1324,858,336,988,20777
15000US060855123071,1138,586,407,731,20778
15000US060855123072,2869,1611,866,2003,20779
15000US060855123073,2478,1694,542,1936,20780
15000US060855123081,3125,1576,779,2346,20781
15000US060855123082,2390,1102,812,1578,20782
15000US060855123083,2603,1753,400,2203,20783
15000US060855123091,3068,1685,994,2074,20784
15000US060855123092,2067,1437,393,1674,20785
15000US060855123101,2926,845,1401,1525,20786
15000US060855123102,1296,359,745,551,20787
15000US060855123111,3557,1779,1075,2482,20788
15000US060855123121,3135,1522,1088,2047,20789
15000US060855123131,2485,1068,1266,1219,20790
15000US060855123132,1549,444,926,623,20791
15000US060855123141,1781,921,475,1306,20792
15000US060855123142,713,300,387,326,20793
15000US060855123143,2687,765,1719,968,20794
15000US060855123144,1157,587,344,813,20795
15000US060855124011,3395,1478,1622,1773,20796
15000US060855124012,1683,729,900,783,20797
15000US060855124021,3065,1443,1031,2034,20798
15000US060855124022,1022,277,532,490,20799
15000US060855124023,901,369,428,473,20800
15000US060855125031,5212,3137,971,4241,20801
15000US060855125032,3356,1565,1573,1783,20802
15000US060855125051,5152,1279,3098,2054,20803
15000US060855125052,2728,951,1700,1028,20804
15000US060855125061,2951,415,2263,688,20805
15000US060855125062,1844,111,1469,375,20806
15000US060855125063,2434,655,1498,936,20807
15000US060855125081,1719,678,1020,699,20808
15000US060855125082,3510,671,2813,697,20809
15000US060855125083,1391,988,359,1032,20810
15000US060855125084,1895,247,1471,424,20811
15000US060855125091,2845,650,1926,919,20812
15000US060855125092,1382,696,557,825,20813
15000US060855125101,2403,1395,640,1763,20814
15000US060855125102,978,575,337,641,20815
15000US060855125103,2975,676,2011,964,20816
15000US060855126021,1148,265,762,386,20817
15000US060855126022,1525,741,583,942,20818
15000US060855126031,1373,90,1238,135,20819
15000US060855126032,619,196,366,253,20820
15000US060855126033,2429,107,2203,226,20821
15000US060855126041,2040,153,1800,240,20822
15000US060855126042,2255,178,1963,292,20823
15000US060855126043,592,88,504,88,20824
15000US060855130001,4932,2044,684,4248,20825
15000US060855130002,1678,469,63,1615,20826
15000US060855130003,1644,875,196,1448,20827
15000US060855135001,854,481,181,673,20828
15000US060871001001,858,639,147,711,20829
15000US060871001002,1457,943,402,1055,20830
15000US060871002001,645,433,212,433,20831
15000US060871002002,518,481,26,492,20832
15000US060871002003,1613,1322,157,1456,20833
15000US060871002004,597,391,206,391,20834
15000US060871002005,895,482,310,585,20835
15000US060871002006,1618,834,622,996,20836
15000US060871002007,483,291,158,325,20837
15000US060871003001,1639,1092,290,1349,20838
15000US060871003002,1704,1473,45,1659,20839
15000US060871004001,2409,911,604,1805,20840
15000US060871004002,1605,701,426,1179,20841
15000US060871004003,5678,1806,1687,3991,20842
15000US060871005001,1278,1100,28,1250,20843
15000US060871005002,2810,1829,307,2503,20844
15000US060871005003,2687,2177,304,2383,20845
15000US060871006001,1596,880,439,1157,20846
15000US060871006002,1264,808,296,968,20847
15000US060871006003,846,761,25,821,20848
15000US060871007001,1060,791,129,931,20849
15000US060871007002,907,636,162,745,20850
15000US060871008001,1233,886,195,1038,20851
15000US060871008002,1095,600,476,619,20852
15000US060871008003,982,694,208,774,20853
15000US060871008004,2351,1119,970,1381,20854
15000US060871008005,974,781,95,879,20855
15000US060871008006,468,337,42,426,20856
15000US060871009001,1544,1110,293,1251,20857
15000US060871009002,1409,1173,141,1268,20858
15000US060871009003,638,469,169,469,20859
15000US060871009004,332,307,25,307,20860
15000US060871009005,482,412,70,412,20861
15000US060871010001,1720,666,875,845,20862
15000US060871010002,593,416,62,531,20863
15000US060871010003,544,320,117,427,20864
15000US060871010004,486,176,268,218,20865
15000US060871010005,534,409,125,409,20866
15000US060871010006,2215,1447,610,1605,20867
15000US060871010007,1769,1003,289,1480,20868
15000US060871011001,1373,930,158,1215,20869
15000US060871011002,1057,972,30,1027,20870
15000US060871011003,714,582,67,647,20871
15000US060871011004,1492,1249,134,1358,20872
15000US060871011005,1153,840,198,955,20873
15000US060871012001,761,583,85,676,20874
15000US060871012002,1185,987,87,1098,20875
15000US060871012003,1241,905,270,971,20876
15000US060871101001,1859,333,1443,416,20877
15000US060871101002,1792,89,1703,89,20878
15000US060871101003,1316,401,846,470,20879
15000US060871101004,3255,842,2291,964,20880
15000US060871102001,1734,255,1346,388,20881
15000US060871102002,1876,278,1598,278,20882
15000US060871102003,1126,73,1040,86,20883
15000US060871102004,1832,246,1461,371,20884
15000US060871102005,1688,649,954,734,20885
15000US060871103001,979,59,860,119,20886
15000US060871103002,1334,66,1204,130,20887
15000US060871103003,1894,80,1802,92,20888
15000US060871103004,3187,11,3143,44,20889
15000US060871104001,1934,34,1900,34,20890
15000US060871104002,1255,4,1226,29,20891
15000US060871104003,1120,53,1013,107,20892
15000US060871104004,3449,859,2116,1333,20893
15000US060871105011,3075,392,2416,659,20894
15000US060871105012,2483,306,2177,306,20895
15000US060871105013,1103,479,561,542,20896
15000US060871105014,1189,508,681,508,20897
15000US060871105021,1788,253,1476,312,20898
15000US060871105022,2326,172,2047,279,20899
15000US060871105023,1613,188,1412,201,20900
15000US060871106001,2264,132,2119,145,20901
15000US060871106002,1130,171,925,205,20902
15000US060871106003,1555,239,1206,349,20903
15000US060871106004,1790,129,1603,187,20904
15000US060871106005,779,139,509,270,20905
15000US060871107001,1170,180,953,217,20906
15000US060871107002,1268,231,959,309,20907
15000US060871107003,703,208,451,252,20908
15000US060871202001,2822,2126,444,2378,20909
15000US060871202002,1364,1161,110,1254,20910
15000US060871203011,2666,2194,129,2537,20911
15000US060871203012,1432,1284,89,1343,20912
15000US060871203013,1389,1132,214,1175,20913
15000US060871203021,674,505,117,557,20914
15000US060871203022,1050,808,129,921,20915
15000US060871203023,1168,928,179,989,20916
15000US060871204001,1153,973,90,1063,20917
15000US060871204002,921,835,39,882,20918
15000US060871204003,1666,1454,111,1555,20919
15000US060871204004,1054,829,101,953,20920
15000US060871205001,635,504,21,614,20921
15000US060871205002,1605,1416,52,1553,20922
15000US060871205003,1513,1242,157,1356,20923
15000US060871205004,1231,967,82,1149,20924
15000US060871205005,551,546,5,546,20925
15000US060871206001,525,423,34,491,20926
15000US060871206002,1180,1001,54,1126,20927
15000US060871206003,678,459,147,531,20928
15000US060871206004,1518,1409,81,1437,20929
15000US060871206005,902,702,151,751,20930
15000US060871207001,993,758,235,758,20931
15000US060871207002,1414,1245,62,1352,20932
15000US060871207003,1526,1283,67,1459,20933
15000US060871208001,2234,1944,125,2109,20934
15000US060871208002,2230,1887,136,2094,20935
15000US060871208003,1552,1016,333,1219,20936
15000US060871209001,3263,2307,426,2837,20937
15000US060871209002,1125,1010,56,1069,20938
15000US060871209003,2394,1719,360,2034,20939
15000US060871209004,1794,1552,104,1690,20940
15000US060871210001,1896,1599,87,1809,20941
15000US060871210002,819,733,21,798,20942
15000US060871210003,976,862,10,966,20943
15000US060871211001,856,696,62,794,20944
15000US060871211002,2593,1586,878,1715,20945
15000US060871212001,1151,937,182,969,20946
15000US060871212002,1648,1438,65,1583,20947
15000US060871212003,1612,1218,275,1337,20948
15000US060871212004,905,856,34,871,20949
15000US060871212005,871,842,14,857,20950
15000US060871213001,1861,1445,312,1549,20951
15000US060871213002,379,332,24,355,20952
15000US060871213003,1080,704,263,817,20953
15000US060871213004,1087,67,1020,67,20954
15000US060871214011,1026,599,336,690,20955
15000US060871214012,1786,1175,467,1319,20956
15000US060871214021,1751,813,831,920,20957
15000US060871214022,1985,1008,904,1081,20958
15000US060871214023,852,653,78,774,20959
15000US060871214031,2067,1254,733,1334,20960
15000US060871214032,888,679,150,738,20961
15000US060871214033,627,430,129,498,20962
15000US060871215001,405,382,23,382,20963
15000US060871215002,1362,971,389,973,20964
15000US060871215003,1258,1161,60,1198,20965
15000US060871215004,789,573,164,625,20966
15000US060871215005,1564,628,867,697,20967
15000US060871216001,1026,667,305,721,20968
15000US060871216002,881,787,27,854,20969
15000US060871216003,1688,1345,213,1475,20970
15000US060871216004,1697,1417,205,1492,20971
15000US060871216005,1334,403,648,686,20972
15000US060871217001,2882,1586,1072,1810,20973
15000US060871217002,574,540,34,540,20974
15000US060871217003,733,491,232,501,20975
15000US060871217004,1706,1335,201,1505,20976
15000US060871217005,894,399,230,664,20977
15000US060871217006,627,272,277,350,20978
15000US060871218001,992,663,141,851,20979
15000US060871218002,1933,1246,577,1356,20980
15000US060871218003,1097,872,115,982,20981
15000US060871218004,560,296,0,560,20982
15000US060871220011,1443,1186,121,1322,20983
15000US060871220012,709,557,81,628,20984
15000US060871220013,1170,873,254,916,20985
15000US060871220014,323,261,48,275,20986
15000US060871220015,1907,1601,226,1681,20987
15000US060871220021,2231,1994,99,2132,20988
15000US060871220022,1250,1068,108,1142,20989
15000US060871220031,1487,1096,345,1142,20990
15000US060871220032,909,744,37,872,20991
15000US060871220033,3095,2308,666,2429,20992
15000US060871220034,807,664,108,699,20993
15000US060871220035,473,252,143,330,20994
15000US060871221001,899,697,150,749,20995
15000US060871221002,1432,1081,243,1189,20996
15000US060871221003,1033,699,232,801,20997
15000US060871222011,1137,1019,57,1080,20998
15000US060871222012,929,708,25,904,20999
15000US060871222013,1154,1113,23,1131,21000
15000US060871222014,1226,649,503,723,21001
15000US060871222015,693,585,75,618,21002
15000US060871222016,1235,955,165,1070,21003
15000US060871222017,524,375,27,497,21004
15000US060871222021,2331,1666,441,1890,21005
15000US060871222031,2306,2067,90,2216,21006
15000US060871222032,1350,1140,130,1220,21007
15000US060871223001,977,309,612,365,21008
15000US060871223002,730,636,33,697,21009
15000US060871223003,2011,1631,227,1784,21010
15000US060871224001,2497,1758,507,1990,21011
15000US060871224002,1043,777,266,777,21012
15000US060871224003,1367,1003,267,1100,21013
15000US060871224004,727,647,0,727,21014
15000US060871224005,458,443,15,443,21015
15000US060871224006,1034,732,246,788,21016
15000US060871225001,1388,326,848,540,21017
15000US060871225002,2019,347,1507,512,21018
15000US060871225003,1056,222,781,275,21019
15000US060871225004,1820,95,1631,189,21020
15000US060871231001,1521,532,870,651,21021
15000US060871231002,1191,352,799,392,21022
15000US060871233001,1721,692,1004,717,21023
15000US060879901000,0,0,0,0,21024
15000US060890101001,850,662,99,751,21025
15000US060890101002,635,538,64,571,21026
15000US060890102001,2191,1927,153,2038,21027
15000US060890103001,1831,1263,198,1633,21028
15000US060890103002,2529,2109,178,2351,21029
15000US060890104001,856,763,27,829,21030
15000US060890104002,1232,1096,72,1160,21031
15000US060890104003,707,547,49,658,21032
15000US060890104004,1216,1050,68,1148,21033
15000US060890105001,1883,1268,269,1614,21034
15000US060890105002,1845,1286,192,1653,21035
15000US060890105003,1967,1412,265,1702,21036
15000US060890106011,1268,1010,81,1187,21037
15000US060890106012,1260,1036,57,1203,21038
15000US060890106021,1025,857,121,904,21039
15000US060890106022,640,548,0,640,21040
15000US060890106023,1606,1276,193,1413,21041
15000US060890106024,2193,2164,17,2176,21042
15000US060890106031,719,518,17,702,21043
15000US060890106032,884,712,14,870,21044
15000US060890107021,1855,1567,176,1679,21045
15000US060890107022,2034,1702,69,1965,21046
15000US060890107031,1203,1068,58,1145,21047
15000US060890107032,1969,1789,123,1846,21048
15000US060890107041,970,638,170,800,21049
15000US060890107042,1283,911,160,1123,21050
15000US060890107043,2079,1672,259,1820,21051
15000US060890108031,2036,1327,272,1764,21052
15000US060890108032,1126,649,164,962,21053
15000US060890108033,2479,1747,126,2353,21054
15000US060890108041,1446,1006,173,1273,21055
15000US060890108042,1356,1252,47,1309,21056
15000US060890108051,1026,1001,0,1026,21057
15000US060890108052,4090,3392,340,3750,21058
15000US060890108061,2088,1636,165,1923,21059
15000US060890108062,1040,902,101,939,21060
15000US060890108071,2083,1830,103,1980,21061
15000US060890108072,2390,1935,196,2194,21062
15000US060890109001,2345,1524,273,2072,21063
15000US060890109002,1633,1239,134,1499,21064
15000US060890110011,748,674,40,708,21065
15000US060890110012,935,784,96,839,21066
15000US060890110021,1255,1180,0,1255,21067
15000US060890110022,1000,893,107,893,21068
15000US060890110023,1570,991,564,1006,21069
15000US060890110024,1500,1300,32,1468,21070
15000US060890111001,1875,1452,114,1761,21071
15000US060890111002,1236,1179,10,1226,21072
15000US060890112091,1367,1169,79,1288,21073
15000US060890112092,1567,1049,355,1212,21074
15000US060890112093,1206,920,35,1171,21075
15000US060890112094,1917,1042,363,1554,21076
15000US060890113001,1272,737,127,1145,21077
15000US060890113002,1170,780,25,1145,21078
15000US060890113003,945,887,0,945,21079
15000US060890113004,1664,912,657,1007,21080
15000US060890114011,1392,1212,118,1274,21081
15000US060890114012,1202,971,62,1140,21082
15000US060890114013,973,853,39,934,21083
15000US060890114021,1398,889,360,1038,21084
15000US060890114022,1726,1473,170,1556,21085
15000US060890114031,1461,1368,34,1427,21086
15000US060890114032,1368,1127,53,1315,21087
15000US060890115001,656,569,57,599,21088
15000US060890115002,1481,1313,90,1391,21089
15000US060890115003,2178,1879,58,2120,21090
15000US060890115004,1158,1056,12,1146,21091
15000US060890116001,636,628,0,636,21092
15000US060890116002,1832,1519,84,1748,21093
15000US060890116003,1204,907,107,1097,21094
15000US060890117011,566,454,15,551,21095
15000US060890117012,1924,1415,170,1754,21096
15000US060890117021,1152,810,223,929,21097
15000US060890117022,1326,1019,172,1154,21098
15000US060890117023,1031,671,285,746,21099
15000US060890117031,803,678,54,749,21100
15000US060890117032,1050,787,216,834,21101
15000US060890117033,1455,1239,138,1317,21102
15000US060890118011,1361,1195,35,1326,21103
15000US060890118012,1046,793,204,842,21104
15000US060890118021,1145,948,77,1068,21105
15000US060890118022,1510,1237,153,1357,21106
15000US060890118031,909,817,24,885,21107
15000US060890118032,719,577,130,589,21108
15000US060890118033,961,862,99,862,21109
15000US060890119001,1367,1076,23,1344,21110
15000US060890119002,1109,963,57,1052,21111
15000US060890119003,1025,941,41,984,21112
15000US060890119004,1093,1034,19,1074,21113
15000US060890120001,646,585,49,597,21114
15000US060890120002,1214,826,224,990,21115
15000US060890120003,1228,736,251,977,21116
15000US060890120004,1512,1230,263,1249,21117
15000US060890121011,1140,947,124,1016,21118
15000US060890121012,1479,1251,125,1354,21119
15000US060890121013,1824,1531,249,1575,21120
15000US060890121021,867,768,26,841,21121
15000US060890121022,1213,779,140,1073,21122
15000US060890122001,1776,1553,221,1555,21123
15000US060890122002,1054,1011,0,1054,21124
15000US060890122003,1335,1228,45,1290,21125
15000US060890122004,2066,1446,486,1580,21126
15000US060890123011,1566,1153,348,1218,21127
15000US060890123012,1494,886,552,942,21128
15000US060890123021,901,744,37,864,21129
15000US060890123022,480,343,137,343,21130
15000US060890123023,1393,1266,52,1341,21131
15000US060890123024,2604,2361,121,2483,21132
15000US060890123031,1865,1746,62,1803,21133
15000US060890123032,1905,1723,70,1835,21134
15000US060890124001,1028,916,30,998,21135
15000US060890124002,1090,985,39,1051,21136
15000US060890124003,1675,1446,109,1566,21137
15000US060890125001,574,479,44,530,21138
15000US060890125002,969,801,29,940,21139
15000US060890126011,1985,1669,176,1809,21140
15000US060890126012,1131,956,55,1076,21141
15000US060890126013,1793,1641,85,1708,21142
15000US060890126031,660,607,53,607,21143
15000US060890126032,1439,1218,79,1360,21144
15000US060890126033,928,837,48,880,21145
15000US060890126034,900,793,95,805,21146
15000US060890126041,776,643,36,740,21147
15000US060890126042,1538,1325,104,1434,21148
15000US060890127011,2006,1807,160,1846,21149
15000US060890127012,860,734,38,822,21150
15000US060890127013,1210,974,142,1068,21151
15000US060890127014,580,473,107,473,21152
15000US060890127021,567,414,87,480,21153
15000US060890127022,1476,1129,311,1165,21154
15000US060890127023,1169,1076,68,1101,21155
15000US060910100001,680,578,101,579,21156
15000US060910100002,687,534,148,539,21157
15000US060910100003,413,366,0,413,21158
15000US060910100004,701,631,54,647,21159
15000US060910100005,450,410,2,448,21160
15000US060930001001,1368,555,796,572,21161
15000US060930002001,1814,960,691,1123,21162
15000US060930003001,1826,1377,291,1535,21163
15000US060930003002,1205,1061,63,1142,21164
15000US060930003003,1212,1041,44,1168,21165
15000US060930004001,595,543,33,562,21166
15000US060930005001,888,591,115,773,21167
15000US060930005002,521,312,28,493,21168
15000US060930005003,481,289,63,418,21169
15000US060930006001,1875,1499,168,1707,21170
15000US060930007011,753,579,38,715,21171
15000US060930007012,1128,917,84,1044,21172
15000US060930007013,1044,916,95,949,21173
15000US060930007014,785,727,30,755,21174
15000US060930007021,2042,1568,341,1701,21175
15000US060930007022,2284,1640,102,2182,21176
15000US060930007031,695,621,43,652,21177
15000US060930007032,1236,912,159,1077,21178
15000US060930007033,1346,1282,41,1305,21179
15000US060930008001,1952,1572,67,1885,21180
15000US060930008002,543,470,23,520,21181
15000US060930008003,910,689,47,863,21182
15000US060930009001,537,248,91,446,21183
15000US060930009002,1349,1266,41,1308,21184
15000US060930009003,654,455,99,555,21185
15000US060930009004,3103,2421,257,2846,21186
15000US060930009005,879,550,70,809,21187
15000US060930009006,688,397,219,469,21188
15000US060930010001,333,309,24,309,21189
15000US060930010002,1145,826,319,826,21190
15000US060930010003,1895,1612,83,1812,21191
15000US060930010004,1560,1395,155,1405,21192
15000US060930010005,1654,1611,0,1654,21193
15000US060930011001,411,321,39,372,21194
15000US060930011002,671,570,29,642,21195
15000US060930011003,920,629,187,733,21196
15000US060930012001,1366,1165,125,1241,21197
15000US060952501031,1455,273,376,1079,21198
15000US060952501032,2024,352,264,1760,21199
15000US060952501033,1081,383,142,939,21200
15000US060952501041,920,312,47,873,21201
15000US060952501042,1230,345,104,1126,21202
15000US060952501051,2047,338,275,1772,21203
15000US060952501052,2891,393,363,2528,21204
15000US060952501053,2226,210,339,1887,21205
15000US060952501061,1919,582,200,1719,21206
15000US060952501062,3118,457,300,2818,21207
15000US060952502001,1474,343,292,1182,21208
15000US060952502002,968,642,90,878,21209
15000US060952502003,1545,507,525,1020,21210
15000US060952503001,1333,461,157,1176,21211
15000US060952503002,1343,314,538,805,21212
15000US060952503003,730,322,281,449,21213
15000US060952504001,718,331,128,590,21214
15000US060952504002,1083,518,259,824,21215
15000US060952504003,772,211,281,491,21216
15000US060952505011,1155,340,554,601,21217
15000US060952505012,1092,522,206,886,21218
15000US060952505021,1576,558,417,1159,21219
15000US060952505022,1580,382,476,1104,21220
15000US060952506011,2333,500,875,1458,21221
15000US060952506012,2088,468,650,1438,21222
15000US060952506013,711,295,114,597,21223
15000US060952506041,1542,538,235,1307,21224
15000US060952506042,851,248,110,741,21225
15000US060952506043,1206,496,81,1125,21226
15000US060952506051,1165,138,533,632,21227
15000US060952506052,1006,349,45,961,21228
15000US060952506053,2059,594,142,1917,21229
15000US060952507011,1866,377,689,1177,21230
15000US060952507012,1591,225,755,836,21231
15000US060952508011,1891,742,355,1536,21232
15000US060952508012,872,322,161,711,21233
15000US060952508013,1103,326,199,904,21234
15000US060952509001,906,82,104,802,21235
15000US060952509002,1562,392,362,1200,21236
15000US060952510001,1163,299,148,1015,21237
15000US060952510002,732,350,141,591,21238
15000US060952510003,779,250,318,461,21239
15000US060952511001,1843,435,871,972,21240
15000US060952511002,1262,241,715,547,21241
15000US060952512001,1138,344,346,792,21242
15000US060952512002,1359,135,804,555,21243
15000US060952512003,1006,168,596,410,21244
15000US060952513001,772,374,50,722,21245
15000US060952513002,760,463,133,627,21246
15000US060952513003,1094,536,329,765,21247
15000US060952514001,1925,683,212,1713,21248
15000US060952514002,1440,762,353,1087,21249
15000US060952514003,1838,780,373,1465,21250
15000US060952515001,902,143,286,616,21251
15000US060952515002,1298,316,353,945,21252
15000US060952515003,2053,381,1000,1053,21253
15000US060952516001,719,225,268,451,21254
15000US060952516002,1884,703,163,1721,21255
15000US060952517011,1754,367,542,1212,21256
15000US060952517012,1903,845,299,1604,21257
15000US060952517021,820,306,153,667,21258
15000US060952517022,1935,279,218,1717,21259
15000US060952518021,2478,486,732,1746,21260
15000US060952518031,783,222,77,706,21261
15000US060952518032,993,156,431,562,21262
15000US060952518033,1151,285,363,788,21263
15000US060952518034,1998,146,930,1068,21264
15000US060952518041,1068,144,229,839,21265
15000US060952518042,1244,26,392,852,21266
15000US060952518043,1199,192,385,814,21267
15000US060952519011,2204,285,690,1514,21268
15000US060952519012,1275,567,165,1110,21269
15000US060952519013,1874,359,533,1341,21270
15000US060952519021,983,351,252,731,21271
15000US060952519022,1900,277,632,1268,21272
15000US060952519023,1089,65,406,683,21273
15000US060952519024,2108,176,934,1174,21274
15000US060952519031,1365,82,73,1292,21275
15000US060952519032,2330,164,860,1470,21276
15000US060952519033,2061,165,784,1277,21277
15000US060952520001,1270,1025,87,1183,21278
15000US060952520002,819,512,264,555,21279
15000US060952520003,1063,691,105,958,21280
15000US060952520004,1127,677,175,952,21281
15000US060952521021,1755,1130,392,1363,21282
15000US060952521022,2018,1114,236,1782,21283
15000US060952521031,919,229,109,810,21284
15000US060952521032,2133,682,225,1908,21285
15000US060952521033,2208,338,543,1665,21286
15000US060952521041,2588,1373,172,2416,21287
15000US060952521042,1534,1009,246,1288,21288
15000US060952521043,1595,681,275,1320,21289
15000US060952521051,1964,1096,283,1681,21290
15000US060952521052,1223,739,191,1032,21291
15000US060952521061,1755,981,372,1383,21292
15000US060952521062,1305,949,140,1165,21293
15000US060952521063,1396,601,469,927,21294
15000US060952521071,2247,1384,438,1809,21295
15000US060952521072,1348,904,67,1281,21296
15000US060952521081,1459,1070,227,1232,21297
15000US060952521082,1818,1076,199,1619,21298
15000US060952522011,4194,1616,577,3617,21299
15000US060952522012,548,325,11,537,21300
15000US060952522013,482,442,29,453,21301
15000US060952522014,3839,1861,661,3178,21302
15000US060952522021,1494,422,105,1389,21303
15000US060952522022,2461,865,393,2068,21304
15000US060952522023,2125,760,350,1775,21305
15000US060952522024,4524,1635,1048,3476,21306
15000US060952523051,2303,1021,344,1959,21307
15000US060952523052,723,510,170,553,21308
15000US060952523053,2009,1044,496,1513,21309
15000US060952523061,1360,791,174,1186,21310
15000US060952523062,2044,1059,602,1442,21311
15000US060952523101,2322,1445,200,2122,21312
15000US060952523102,904,437,52,852,21313
15000US060952523111,1196,583,170,1026,21314
15000US060952523112,2098,849,361,1737,21315
15000US060952523113,1110,311,209,901,21316
15000US060952523121,1660,851,407,1253,21317
15000US060952523122,1709,687,239,1470,21318
15000US060952523131,1122,394,194,928,21319
15000US060952523132,1924,468,983,941,21320
15000US060952523133,2868,1285,271,2597,21321
15000US060952523141,1079,456,259,820,21322
15000US060952523142,875,501,192,683,21323
15000US060952523143,1867,698,356,1511,21324
15000US060952523151,1110,565,130,980,21325
15000US060952523152,1437,420,175,1262,21326
15000US060952523153,1879,658,388,1491,21327
15000US060952523161,1909,660,322,1587,21328
15000US060952523162,1789,373,742,1047,21329
15000US060952523171,2348,900,205,2143,21330
15000US060952523172,5301,1334,1266,4035,21331
15000US060952524011,1142,131,834,308,21332
15000US060952524012,909,238,334,575,21333
15000US060952524013,1144,467,340,804,21334
15000US060952524014,1321,204,697,624,21335
15000US060952524021,1176,513,344,832,21336
15000US060952524022,1794,632,499,1295,21337
15000US060952524023,2277,125,1599,678,21338
15000US060952525011,613,199,278,335,21339
15000US060952525012,2224,502,1129,1095,21340
15000US060952525021,755,455,142,613,21341
15000US060952525022,1621,425,593,1028,21342
15000US060952526041,575,145,200,375,21343
15000US060952526042,1457,413,507,950,21344
15000US060952526043,1209,268,436,773,21345
15000US060952526051,3270,327,1587,1683,21346
15000US060952526052,1221,367,365,856,21347
15000US060952526053,1359,162,1008,351,21348
15000US060952526061,2386,537,821,1565,21349
15000US060952526062,1122,156,578,544,21350
15000US060952526063,2095,438,1279,816,21351
15000US060952526071,1207,266,744,463,21352
15000US060952526072,3148,399,1962,1186,21353
15000US060952526081,936,159,474,462,21354
15000US060952526082,3346,540,1622,1724,21355
15000US060952526101,1897,583,488,1409,21356
15000US060952526102,1107,341,409,698,21357
15000US060952526111,1416,411,590,826,21358
15000US060952526112,730,75,409,321,21359
15000US060952526113,1101,103,435,666,21360
15000US060952527021,1799,633,768,1031,21361
15000US060952527022,629,302,0,629,21362
15000US060952527023,871,147,66,805,21363
15000US060952527024,1303,350,282,1021,21364
15000US060952527025,1261,91,75,1186,21365
15000US060952527026,1103,134,212,891,21366
15000US060952527031,890,372,141,749,21367
15000US060952527032,1673,252,784,889,21368
15000US060952527033,1462,267,427,1035,21369
15000US060952527041,1142,236,487,655,21370
15000US060952527042,707,339,144,563,21371
15000US060952527043,1073,331,151,922,21372
15000US060952527044,367,196,78,289,21373
15000US060952527045,1464,505,108,1356,21374
15000US060952527051,1463,653,282,1181,21375
15000US060952527052,1025,193,342,683,21376
15000US060952527053,793,224,120,673,21377
15000US060952527054,1870,369,692,1178,21378
15000US060952527055,1108,307,88,1020,21379
15000US060952527061,3911,1721,791,3120,21380
15000US060952527071,3095,340,1079,2016,21381
15000US060952527072,1728,805,407,1321,21382
15000US060952527073,492,365,75,417,21383
15000US060952528011,71,71,0,71,21384
15000US060952528012,0,0,0,0,21385
15000US060952528013,1061,496,227,834,21386
15000US060952528014,1303,617,240,1063,21387
15000US060952528015,680,522,25,655,21388
15000US060952528021,804,581,39,765,21389
15000US060952528022,486,265,117,369,21390
15000US060952529031,1032,822,172,860,21391
15000US060952529032,988,787,103,885,21392
15000US060952529033,1516,1061,147,1369,21393
15000US060952529034,908,769,45,863,21394
15000US060952529041,1747,1195,225,1522,21395
15000US060952529042,3468,1197,1221,2247,21396
15000US060952529043,928,577,344,584,21397
15000US060952529081,1177,760,194,983,21398
15000US060952529082,1838,1021,387,1451,21399
15000US060952529083,881,634,81,800,21400
15000US060952529091,1470,981,323,1147,21401
15000US060952529092,1544,1032,318,1226,21402
15000US060952529101,1347,825,271,1076,21403
15000US060952529102,1246,853,163,1083,21404
15000US060952529103,2300,1190,441,1859,21405
15000US060952529104,1338,569,448,890,21406
15000US060952529111,2113,1458,332,1781,21407
15000US060952529112,1013,998,15,998,21408
15000US060952529113,564,453,80,484,21409
15000US060952529114,1236,931,33,1203,21410
15000US060952529121,1405,1035,240,1165,21411
15000US060952529122,717,360,107,610,21412
15000US060952529123,896,277,125,771,21413
15000US060952529124,1315,894,251,1064,21414
15000US060952529125,1200,1013,25,1175,21415
15000US060952529131,1227,854,108,1119,21416
15000US060952529132,1438,722,432,1006,21417
15000US060952529133,978,327,308,670,21418
15000US060952529134,1462,922,227,1235,21419
15000US060952529141,3240,1592,502,2738,21420
15000US060952529142,1075,559,182,893,21421
15000US060952529143,1217,732,260,957,21422
15000US060952529151,1425,702,261,1164,21423
15000US060952529152,2748,1052,508,2240,21424
15000US060952530001,6528,1609,1488,5040,21425
15000US060952531011,793,145,565,228,21426
15000US060952531012,455,367,70,385,21427
15000US060952531013,1166,508,567,599,21428
15000US060952531014,795,612,132,663,21429
15000US060952531015,999,603,149,850,21430
15000US060952531016,1283,1035,173,1110,21431
15000US060952531051,1093,332,320,773,21432
15000US060952531052,1918,841,413,1505,21433
15000US060952531053,1309,472,628,681,21434
15000US060952531054,1056,581,217,839,21435
15000US060952531055,479,310,111,368,21436
15000US060952531061,907,591,137,770,21437
15000US060952531062,881,600,238,643,21438
15000US060952531063,1676,807,395,1281,21439
15000US060952531071,856,441,113,743,21440
15000US060952531072,2730,1224,1217,1513,21441
15000US060952531073,1985,919,754,1231,21442
15000US060952531074,751,261,97,654,21443
15000US060952531081,2101,1232,421,1680,21444
15000US060952531082,1284,764,247,1037,21445
15000US060952531083,1276,454,351,925,21446
15000US060952532011,1391,1092,142,1249,21447
15000US060952532012,1155,857,193,962,21448
15000US060952532013,1145,873,137,1008,21449
15000US060952532014,1217,962,167,1050,21450
15000US060952532031,1336,738,466,870,21451
15000US060952532032,1734,1175,399,1335,21452
15000US060952532033,871,623,141,730,21453
15000US060952532041,1412,1065,16,1396,21454
15000US060952532042,913,477,152,761,21455
15000US060952532043,1571,1133,297,1274,21456
15000US060952532044,1204,215,762,442,21457
15000US060952532045,2031,470,1229,802,21458
15000US060952532051,1211,841,107,1104,21459
15000US060952532052,542,348,96,446,21460
15000US060952532053,1688,267,857,831,21461
15000US060952532061,1518,955,197,1321,21462
15000US060952532062,1533,1055,226,1307,21463
15000US060952533001,2078,1326,579,1499,21464
15000US060952533002,962,607,355,607,21465
15000US060952534021,1190,553,603,587,21466
15000US060952534022,559,316,228,331,21467
15000US060952534023,1071,461,533,538,21468
15000US060952534024,3087,1528,976,2111,21469
15000US060952534025,1544,285,1153,391,21470
15000US060952534031,1398,779,558,840,21471
15000US060952534032,1265,814,407,858,21472
15000US060952534033,2498,1310,882,1616,21473
15000US060952534041,2184,1004,958,1226,21474
15000US060952534042,1714,777,887,827,21475
15000US060952534043,905,559,169,736,21476
15000US060952534044,1972,999,473,1499,21477
15000US060952535001,4850,3151,569,4281,21478
15000US060952535002,2080,1639,340,1740,21479
15000US060952535003,1095,738,176,919,21480
15000US060952535004,1491,1074,366,1125,21481
15000US060959800001,0,0,0,0,21482
15000US060971501001,1201,1142,59,1142,21483
15000US060971501002,958,824,113,845,21484
15000US060971501003,349,309,35,314,21485
15000US060971502021,795,685,28,767,21486
15000US060971502022,653,553,74,579,21487
15000US060971502023,565,480,57,508,21488
15000US060971502024,1797,944,839,958,21489
15000US060971502025,1257,911,120,1137,21490
15000US060971502031,1623,1208,372,1251,21491
15000US060971502032,1614,1369,150,1464,21492
15000US060971502033,1744,1487,238,1506,21493
15000US060971502041,954,821,109,845,21494
15000US060971502042,1686,1410,215,1471,21495
15000US060971502043,1201,1051,143,1058,21496
15000US060971503031,830,792,21,809,21497
15000US060971503032,1180,971,168,1012,21498
15000US060971503033,1053,758,77,976,21499
15000US060971503034,1586,1381,178,1408,21500
15000US060971503041,1255,949,262,993,21501
15000US060971503042,1738,914,782,956,21502
15000US060971503043,2104,992,1112,992,21503
15000US060971503044,1004,603,374,630,21504
15000US060971503051,1056,315,741,315,21505
15000US060971503052,1743,436,1169,574,21506
15000US060971503053,2314,638,1591,723,21507
15000US060971503054,1101,265,731,370,21508
15000US060971503061,962,694,256,706,21509
15000US060971503062,1210,712,422,788,21510
15000US060971503063,1827,1069,431,1396,21511
15000US060971505001,578,503,3,575,21512
15000US060971505002,965,948,0,965,21513
15000US060971505003,1346,1167,54,1292,21514
15000US060971505004,645,574,0,645,21515
15000US060971505005,931,598,234,697,21516
15000US060971505006,726,712,14,712,21517
15000US060971506011,1012,852,127,885,21518
15000US060971506012,951,596,189,762,21519
15000US060971506013,1723,570,1077,646,21520
15000US060971506014,872,632,169,703,21521
15000US060971506021,1197,884,109,1088,21522
15000US060971506022,592,437,105,487,21523
15000US060971506023,1162,893,164,998,21524
15000US060971506024,1015,640,308,707,21525
15000US060971506031,1617,1168,362,1255,21526
15000US060971506032,1240,656,403,837,21527
15000US060971506033,428,367,30,398,21528
15000US060971506034,1309,1063,169,1140,21529
15000US060971506035,1120,474,503,617,21530
15000US060971506036,1101,856,245,856,21531
15000US060971506071,1235,981,198,1037,21532
15000US060971506072,727,562,154,573,21533
15000US060971506073,3509,2516,360,3149,21534
15000US060971506091,1806,1376,313,1493,21535
15000US060971506092,1079,480,521,558,21536
15000US060971506093,828,594,94,734,21537
15000US060971506094,958,754,140,818,21538
15000US060971506101,1152,814,156,996,21539
15000US060971506102,2135,1365,453,1682,21540
15000US060971506103,756,654,63,693,21541
15000US060971506111,3103,1610,1057,2046,21542
15000US060971506112,799,619,128,671,21543
15000US060971506113,642,443,150,492,21544
15000US060971506121,2842,2131,418,2424,21545
15000US060971506122,1501,1293,121,1380,21546
15000US060971507011,2006,858,1001,1005,21547
15000US060971507012,1200,906,78,1122,21548
15000US060971507013,904,793,69,835,21549
15000US060971507014,707,580,115,592,21550
15000US060971507021,1414,1229,44,1370,21551
15000US060971507022,716,619,70,646,21552
15000US060971507023,1652,1313,225,1427,21553
15000US060971507024,1220,832,356,864,21554
15000US060971508001,795,711,52,743,21555
15000US060971508002,1333,634,674,659,21556
15000US060971508003,960,725,174,786,21557
15000US060971508004,2311,1896,129,2182,21558
15000US060971509011,1141,578,480,661,21559
15000US060971509012,706,486,128,578,21560
15000US060971509013,1126,605,305,821,21561
15000US060971509014,1042,531,392,650,21562
15000US060971509015,939,691,192,747,21563
15000US060971509021,1032,777,157,875,21564
15000US060971509022,781,704,36,745,21565
15000US060971509023,866,806,60,806,21566
15000US060971509024,603,533,17,586,21567
15000US060971510001,1035,805,194,841,21568
15000US060971510002,1260,971,150,1110,21569
15000US060971510003,1645,1347,298,1347,21570
15000US060971511001,2278,1697,321,1957,21571
15000US060971511002,2216,1773,368,1848,21572
15000US060971511003,1140,921,188,952,21573
15000US060971512011,1243,638,397,846,21574
15000US060971512012,893,771,107,786,21575
15000US060971512013,1090,602,431,659,21576
15000US060971512014,1681,1309,154,1527,21577
15000US060971512015,2168,1036,875,1293,21578
15000US060971512031,1000,665,271,729,21579
15000US060971512032,1453,1166,156,1297,21580
15000US060971512033,806,741,33,773,21581
15000US060971512034,1413,1043,212,1201,21582
15000US060971512041,1586,999,235,1351,21583
15000US060971512042,1057,757,130,927,21584
15000US060971512043,669,338,253,416,21585
15000US060971513011,1703,1095,548,1155,21586
15000US060971513012,1060,487,246,814,21587
15000US060971513013,1952,729,981,971,21588
15000US060971513051,2065,1380,365,1700,21589
15000US060971513052,675,465,210,465,21590
15000US060971513053,1954,1062,827,1127,21591
15000US060971513054,1193,368,630,563,21592
15000US060971513061,448,406,18,430,21593
15000US060971513062,646,508,65,581,21594
15000US060971513063,1101,647,282,819,21595
15000US060971513064,1317,930,303,1014,21596
15000US060971513071,2192,1294,484,1708,21597
15000US060971513072,1163,830,254,909,21598
15000US060971513073,1152,856,176,976,21599
15000US060971513074,1221,845,306,915,21600
15000US060971513081,547,542,3,544,21601
15000US060971513082,1616,1168,150,1466,21602
15000US060971513083,362,331,31,331,21603
15000US060971513084,403,259,68,335,21604
15000US060971513085,1662,1045,250,1412,21605
15000US060971513091,869,735,85,784,21606
15000US060971513092,2609,1745,668,1941,21607
15000US060971513093,1771,1368,266,1505,21608
15000US060971513101,613,471,33,580,21609
15000US060971513102,1510,1211,114,1396,21610
15000US060971513103,1254,823,298,956,21611
15000US060971513104,2217,1107,602,1615,21612
15000US060971513111,1192,940,143,1049,21613
15000US060971513112,1239,879,172,1067,21614
15000US060971513113,1254,748,203,1051,21615
15000US060971513114,1274,917,222,1052,21616
15000US060971513115,1541,1301,142,1399,21617
15000US060971514011,4651,2426,1403,3248,21618
15000US060971514012,1646,628,978,668,21619
15000US060971514013,1186,176,698,488,21620
15000US060971514021,2158,729,991,1167,21621
15000US060971514022,2329,754,1310,1019,21622
15000US060971514023,2261,744,1300,961,21623
15000US060971514024,633,336,267,366,21624
15000US060971514025,1932,912,708,1224,21625
15000US060971515021,1834,1427,237,1597,21626
15000US060971515022,460,450,0,460,21627
15000US060971515023,589,493,0,589,21628
15000US060971515024,574,513,0,574,21629
15000US060971515025,1548,955,565,983,21630
15000US060971515026,2108,1372,394,1714,21631
15000US060971515031,1225,1111,76,1149,21632
15000US060971515032,841,771,29,812,21633
15000US060971515033,1369,1233,50,1319,21634
15000US060971515041,1126,779,321,805,21635
15000US060971515042,1066,906,81,985,21636
15000US060971515043,1265,974,132,1133,21637
15000US060971516011,628,602,0,628,21638
15000US060971516012,1153,948,125,1028,21639
15000US060971516013,1059,1017,0,1059,21640
15000US060971516021,1089,1083,6,1083,21641
15000US060971516022,901,887,7,894,21642
15000US060971516023,1277,1156,67,1210,21643
15000US060971517001,402,278,96,306,21644
15000US060971517002,689,566,78,611,21645
15000US060971517003,1591,873,534,1057,21646
15000US060971517004,1733,1162,364,1369,21647
15000US060971517005,1030,875,64,966,21648
15000US060971517006,1128,673,397,731,21649
15000US060971518001,1209,933,128,1081,21650
15000US060971518002,619,474,79,540,21651
15000US060971518003,922,660,189,733,21652
15000US060971518004,2063,1538,390,1673,21653
15000US060971518005,382,365,8,374,21654
15000US060971519001,787,454,262,525,21655
15000US060971519002,844,379,438,406,21656
15000US060971519003,641,398,197,444,21657
15000US060971519004,1010,600,221,789,21658
15000US060971520001,956,702,182,774,21659
15000US060971520002,880,608,186,694,21660
15000US060971521001,1407,867,314,1093,21661
15000US060971521002,720,525,154,566,21662
15000US060971521003,1068,604,298,770,21663
15000US060971522011,955,560,235,720,21664
15000US060971522012,825,586,191,634,21665
15000US060971522013,1203,939,162,1041,21666
15000US060971522014,721,472,124,597,21667
15000US060971522021,612,569,43,569,21668
15000US060971522022,2199,1277,525,1674,21669
15000US060971522023,1205,1032,120,1085,21670
15000US060971522024,1186,664,483,703,21671
15000US060971522025,1018,660,253,765,21672
15000US060971522031,560,520,18,542,21673
15000US060971522032,752,673,70,682,21674
15000US060971522033,1237,894,85,1152,21675
15000US060971522034,1004,680,176,828,21676
15000US060971523001,1390,1110,214,1176,21677
15000US060971523002,939,601,136,803,21678
15000US060971523003,1290,1046,136,1154,21679
15000US060971523004,736,663,16,720,21680
15000US060971524001,2023,1402,311,1712,21681
15000US060971524002,2047,1401,121,1926,21682
15000US060971524003,1660,989,62,1598,21683
15000US060971524004,2621,1895,416,2205,21684
15000US060971524005,1778,1493,102,1676,21685
15000US060971525011,1706,1314,191,1515,21686
15000US060971525012,1749,1173,438,1311,21687
15000US060971525013,1030,865,115,915,21688
15000US060971525021,1444,1026,353,1091,21689
15000US060971525022,1255,985,169,1086,21690
15000US060971525023,754,417,259,495,21691
15000US060971526001,1417,1223,176,1241,21692
15000US060971526002,2531,2083,19,2512,21693
15000US060971526003,1449,1232,147,1302,21694
15000US060971526004,1324,894,252,1072,21695
15000US060971526005,961,879,34,927,21696
15000US060971526006,439,348,46,393,21697
15000US060971527011,1133,1026,81,1052,21698
15000US060971527012,1170,839,184,986,21699
15000US060971527013,855,645,112,743,21700
15000US060971527014,1122,660,304,818,21701
15000US060971527015,1173,842,198,975,21702
15000US060971527021,940,344,440,500,21703
15000US060971527022,1193,667,283,910,21704
15000US060971527023,907,780,55,852,21705
15000US060971527024,2184,1535,453,1731,21706
15000US060971527025,686,496,85,601,21707
15000US060971528011,1245,842,379,866,21708
15000US060971528012,1274,790,294,980,21709
15000US060971528013,1244,736,270,974,21710
15000US060971528014,761,429,295,466,21711
15000US060971528015,864,658,163,701,21712
15000US060971528021,1039,517,271,768,21713
15000US060971528022,1353,923,341,1012,21714
15000US060971528023,1080,807,248,832,21715
15000US060971528024,2118,628,1384,734,21716
15000US060971528025,1532,210,1166,366,21717
15000US060971529031,694,492,124,570,21718
15000US060971529032,2213,554,1066,1147,21719
15000US060971529033,1325,86,1239,86,21720
15000US060971529034,1029,253,682,347,21721
15000US060971529041,2000,1232,461,1539,21722
15000US060971529042,846,529,188,658,21723
15000US060971529043,1234,951,191,1043,21724
15000US060971529044,1276,767,234,1042,21725
15000US060971529051,1229,573,593,636,21726
15000US060971529052,1724,864,573,1151,21727
15000US060971529053,1299,754,331,968,21728
15000US060971529061,3722,2432,642,3080,21729
15000US060971529062,2292,1687,595,1697,21730
15000US060971530011,1983,667,1161,822,21731
15000US060971530012,1714,871,675,1039,21732
15000US060971530013,3722,1879,1595,2127,21733
15000US060971530021,1709,526,1070,639,21734
15000US060971530022,2161,453,1432,729,21735
15000US060971530023,789,431,225,564,21736
15000US060971530024,1086,252,737,349,21737
15000US060971530025,728,322,249,479,21738
15000US060971530031,618,429,37,581,21739
15000US060971530032,1177,426,731,446,21740
15000US060971530033,2281,1167,1037,1244,21741
15000US060971530034,1914,998,688,1226,21742
15000US060971530051,1492,1049,281,1211,21743
15000US060971530052,546,536,0,546,21744
15000US060971530053,1298,1063,152,1146,21745
15000US060971530054,598,465,80,518,21746
15000US060971530055,1523,704,613,910,21747
15000US060971530056,1845,634,984,861,21748
15000US060971530061,466,451,15,451,21749
15000US060971530062,856,601,144,712,21750
15000US060971530063,1149,651,318,831,21751
15000US060971530064,2592,1275,913,1679,21752
15000US060971530065,1170,748,422,748,21753
15000US060971530066,1592,918,576,1016,21754
15000US060971531021,1511,380,956,555,21755
15000US060971531022,1828,343,1434,394,21756
15000US060971531023,1259,380,373,886,21757
15000US060971531024,1089,229,744,345,21758
15000US060971531031,2369,636,1546,823,21759
15000US060971531032,1367,348,854,513,21760
15000US060971531033,827,143,556,271,21761
15000US060971531041,2042,541,1369,673,21762
15000US060971531042,274,141,133,141,21763
15000US060971531043,1865,289,1085,780,21764
15000US060971532001,1021,690,280,741,21765
15000US060971532002,1176,490,492,684,21766
15000US060971532003,2091,327,1560,531,21767
15000US060971532004,3993,1351,1757,2236,21768
15000US060971533001,3995,1134,1939,2056,21769
15000US060971533002,719,455,256,463,21770
15000US060971533003,1831,1191,480,1351,21771
15000US060971533004,6107,2366,2324,3783,21772
15000US060971534011,661,522,96,565,21773
15000US060971534012,1443,1287,150,1293,21774
15000US060971534013,842,715,107,735,21775
15000US060971534014,1764,1245,338,1426,21776
15000US060971534015,967,795,98,869,21777
15000US060971534016,947,786,26,921,21778
15000US060971534031,1466,1155,200,1266,21779
15000US060971534032,939,698,186,753,21780
15000US060971534033,616,573,26,590,21781
15000US060971534034,710,647,8,702,21782
15000US060971534041,905,744,138,767,21783
15000US060971534042,1426,1234,64,1362,21784
15000US060971534043,884,844,26,858,21785
15000US060971534044,1183,957,46,1137,21786
15000US060971535011,1105,900,169,936,21787
15000US060971535012,1222,1011,190,1032,21788
15000US060971535013,1121,930,73,1048,21789
15000US060971535014,1191,1037,83,1108,21790
15000US060971535021,912,775,114,798,21791
15000US060971535022,677,587,37,640,21792
15000US060971535023,846,756,21,825,21793
15000US060971535024,1808,1263,204,1604,21794
15000US060971536001,690,453,208,482,21795
15000US060971536002,1176,824,330,846,21796
15000US060971536003,1088,738,269,819,21797
15000US060971536004,831,796,35,796,21798
15000US060971536005,1880,1721,17,1863,21799
15000US060971537031,1087,967,37,1050,21800
15000US060971537032,628,526,52,576,21801
15000US060971537033,363,321,7,356,21802
15000US060971537034,469,356,106,363,21803
15000US060971537035,492,484,0,492,21804
15000US060971537041,734,579,36,698,21805
15000US060971537042,721,495,101,620,21806
15000US060971537043,753,687,40,713,21807
15000US060971537044,1534,1205,238,1296,21808
15000US060971537051,890,710,170,720,21809
15000US060971537052,663,549,51,612,21810
15000US060971537053,1227,1081,70,1157,21811
15000US060971537054,1205,836,258,947,21812
15000US060971537061,842,696,70,772,21813
15000US060971537062,1303,1038,209,1094,21814
15000US060971537063,1478,1355,83,1395,21815
15000US060971537064,807,621,92,715,21816
15000US060971538011,1753,575,1148,605,21817
15000US060971538012,5219,3504,1244,3975,21818
15000US060971538013,1663,478,998,665,21819
15000US060971538014,2107,1011,1011,1096,21820
15000US060971538041,1628,1255,308,1320,21821
15000US060971538042,1547,942,532,1015,21822
15000US060971538061,646,546,84,562,21823
15000US060971538062,1297,711,489,808,21824
15000US060971538063,1343,1073,193,1150,21825
15000US060971538071,911,775,109,802,21826
15000US060971538072,2914,2317,471,2443,21827
15000US060971538081,1212,665,444,768,21828
15000US060971538082,1293,569,702,591,21829
15000US060971538083,1788,711,1016,772,21830
15000US060971538091,1336,1150,8,1328,21831
15000US060971538092,2149,870,1123,1026,21832
15000US060971538093,935,599,279,656,21833
15000US060971539011,1146,943,166,980,21834
15000US060971539012,928,671,113,815,21835
15000US060971539013,2186,1424,666,1520,21836
15000US060971539014,607,518,74,533,21837
15000US060971539021,1596,675,890,706,21838
15000US060971539022,691,353,287,404,21839
15000US060971539023,911,544,346,565,21840
15000US060971539024,1148,638,489,659,21841
15000US060971539031,779,684,55,724,21842
15000US060971539032,1157,569,558,599,21843
15000US060971539033,569,490,68,501,21844
15000US060971539034,1545,1291,202,1343,21845
15000US060971540001,537,426,92,445,21846
15000US060971540002,747,493,238,509,21847
15000US060971540003,1460,1143,310,1150,21848
15000US060971541001,704,403,255,449,21849
15000US060971541002,1310,769,484,826,21850
15000US060971541003,848,680,153,695,21851
15000US060971541004,1024,528,485,539,21852
15000US060971542011,1576,500,882,694,21853
15000US060971542012,527,366,113,414,21854
15000US060971542013,672,270,392,280,21855
15000US060971542014,1122,533,527,595,21856
15000US060971542021,4362,3008,1146,3216,21857
15000US060971542022,1054,745,77,977,21858
15000US060971542023,512,349,150,362,21859
15000US060971543021,820,747,0,820,21860
15000US060971543022,787,699,19,768,21861
15000US060971543023,977,950,10,967,21862
15000US060971543024,635,514,121,514,21863
15000US060971543031,601,532,24,577,21864
15000US060971543032,856,794,62,794,21865
15000US060971543041,959,607,240,719,21866
15000US060971543042,538,485,35,503,21867
15000US060971543043,686,653,17,669,21868
15000US060979901000,0,0,0,0,21869
15000US060990001011,1412,1188,193,1219,21870
15000US060990001012,896,708,155,741,21871
15000US060990001013,1366,1013,280,1086,21872
15000US060990001014,1116,837,119,997,21873
15000US060990001021,545,283,247,298,21874
15000US060990001022,2033,1440,415,1618,21875
15000US060990001023,1618,1093,514,1104,21876
15000US060990002011,1752,1257,297,1455,21877
15000US060990002012,1276,1138,45,1231,21878
15000US060990002013,727,519,207,520,21879
15000US060990002014,701,580,91,610,21880
15000US060990002015,1091,668,303,788,21881
15000US060990002021,1660,956,703,957,21882
15000US060990002022,5407,3797,1237,4170,21883
15000US060990002023,1099,656,358,741,21884
15000US060990002031,2177,1490,596,1581,21885
15000US060990002032,1003,382,590,413,21886
15000US060990002033,1320,323,997,323,21887
15000US060990002034,2889,2007,733,2156,21888
15000US060990002035,2093,1632,377,1716,21889
15000US060990003011,1389,438,933,456,21890
15000US060990003012,768,335,414,354,21891
15000US060990003021,960,140,752,208,21892
15000US060990003022,700,436,245,455,21893
15000US060990003023,1027,603,323,704,21894
15000US060990003031,2361,758,1397,964,21895
15000US060990003032,1185,572,506,679,21896
15000US060990003033,2397,533,1787,610,21897
15000US060990003041,899,327,499,400,21898
15000US060990003042,1654,567,993,661,21899
15000US060990003043,2596,250,2247,349,21900
15000US060990004021,1141,822,265,876,21901
15000US060990004022,969,270,477,492,21902
15000US060990004023,8077,3610,3372,4705,21903
15000US060990004024,559,414,63,496,21904
15000US060990004025,511,290,203,308,21905
15000US060990004031,2965,1782,669,2296,21906
15000US060990004032,1250,778,472,778,21907
15000US060990004041,1364,925,340,1024,21908
15000US060990004042,2867,1345,968,1899,21909
15000US060990004043,1125,881,66,1059,21910
15000US060990005011,1577,1216,269,1308,21911
15000US060990005012,1613,973,177,1436,21912
15000US060990005013,2540,847,1430,1110,21913
15000US060990005014,1916,681,1103,813,21914
15000US060990005031,1743,805,593,1150,21915
15000US060990005032,2099,1229,597,1502,21916
15000US060990005033,1437,693,472,965,21917
15000US060990005041,6485,1798,2599,3886,21918
15000US060990005042,1446,840,305,1141,21919
15000US060990005043,1268,879,206,1062,21920
15000US060990005051,3491,1505,1086,2405,21921
15000US060990005052,1813,792,528,1285,21922
15000US060990005061,1272,731,415,857,21923
15000US060990005062,1447,729,510,937,21924
15000US060990005063,1150,601,334,816,21925
15000US060990005064,571,505,0,571,21926
15000US060990005101,1936,1186,682,1254,21927
15000US060990005102,3138,1433,1621,1517,21928
15000US060990005103,2349,1141,895,1454,21929
15000US060990005104,1405,142,1119,286,21930
15000US060990006011,1125,473,186,939,21931
15000US060990006012,2109,852,1129,980,21932
15000US060990006013,1585,868,548,1037,21933
15000US060990006021,1082,671,373,709,21934
15000US060990006022,1810,615,906,904,21935
15000US060990008011,1581,852,504,1077,21936
15000US060990008012,1376,961,321,1055,21937
15000US060990008013,626,434,101,525,21938
15000US060990008014,1505,1106,399,1106,21939
15000US060990008015,1153,897,145,1008,21940
15000US060990008031,724,330,322,402,21941
15000US060990008032,1833,442,1129,704,21942
15000US060990008033,1850,728,809,1041,21943
15000US060990008051,2059,487,1095,964,21944
15000US060990008052,1597,643,765,832,21945
15000US060990008053,989,224,589,400,21946
15000US060990008054,2110,822,831,1279,21947
15000US060990008061,2138,1347,485,1653,21948
15000US060990008062,2118,792,884,1234,21949
15000US060990008071,1265,565,528,737,21950
15000US060990008072,2386,1249,770,1616,21951
15000US060990009051,2171,1293,572,1599,21952
15000US060990009052,1747,1010,279,1468,21953
15000US060990009053,1587,1131,323,1264,21954
15000US060990009061,2115,1486,572,1543,21955
15000US060990009062,2522,1815,335,2187,21956
15000US060990009063,1813,1060,613,1200,21957
15000US060990009071,1099,717,184,915,21958
15000US060990009072,1074,826,219,855,21959
15000US060990009073,1028,669,251,777,21960
15000US060990009081,1259,769,412,847,21961
15000US060990009082,2132,724,1099,1033,21962
15000US060990009083,1598,1111,334,1264,21963
15000US060990009091,2478,1229,713,1765,21964
15000US060990009092,1698,825,666,1032,21965
15000US060990009093,983,719,213,770,21966
15000US060990009101,1476,949,339,1137,21967
15000US060990009102,1830,907,611,1219,21968
15000US060990009103,1203,494,605,598,21969
15000US060990009104,1940,916,808,1132,21970
15000US060990009111,1733,897,627,1106,21971
15000US060990009112,2170,1052,586,1584,21972
15000US060990009113,1258,846,344,914,21973
15000US060990009121,487,427,60,427,21974
15000US060990009122,1006,839,32,974,21975
15000US060990009123,16491,6919,4564,11927,21976
15000US060990010011,1213,672,453,760,21977
15000US060990010012,1132,900,175,957,21978
15000US060990010013,980,703,199,781,21979
15000US060990010014,791,718,73,718,21980
15000US060990010015,1340,625,390,950,21981
15000US060990010021,965,720,196,769,21982
15000US060990010022,1325,618,583,742,21983
15000US060990010023,812,451,282,530,21984
15000US060990011001,1056,561,426,630,21985
15000US060990011002,1135,686,296,839,21986
15000US060990011003,792,712,45,747,21987
15000US060990011004,881,502,365,516,21988
15000US060990012001,580,360,185,395,21989
15000US060990012002,1400,812,348,1052,21990
15000US060990012003,1706,1023,466,1240,21991
15000US060990013001,950,490,445,505,21992
15000US060990013002,726,482,229,497,21993
15000US060990013003,1106,637,321,785,21994
15000US060990013004,1375,1077,298,1077,21995
15000US060990013005,907,708,184,723,21996
15000US060990013006,557,488,47,510,21997
15000US060990014001,1636,880,509,1127,21998
15000US060990014002,1657,828,679,978,21999
15000US060990014003,921,204,525,396,22000
15000US060990014004,1795,1079,589,1206,22001
15000US060990014005,407,220,0,407,22002
15000US060990015001,2320,993,798,1522,22003
15000US060990015002,1579,205,1251,328,22004
15000US060990015003,2242,307,1756,486,22005
15000US060990015004,858,625,139,719,22006
15000US060990016011,1094,191,632,462,22007
15000US060990016012,1924,449,1102,822,22008
15000US060990016013,1920,136,1554,366,22009
15000US060990016031,1344,203,957,387,22010
15000US060990016032,1905,270,1283,622,22011
15000US060990016033,787,255,414,373,22012
15000US060990016034,2193,427,1550,643,22013
15000US060990016041,1320,140,947,373,22014
15000US060990016042,1383,19,1110,273,22015
15000US060990016043,1099,72,954,145,22016
15000US060990017001,2144,362,1552,592,22017
15000US060990017002,510,188,224,286,22018
15000US060990018001,731,412,262,469,22019
15000US060990018002,1236,717,328,908,22020
15000US060990018003,354,175,121,233,22021
15000US060990019001,2208,1408,538,1670,22022
15000US060990019002,521,340,181,340,22023
15000US060990019003,955,596,303,652,22024
15000US060990019004,662,433,161,501,22025
15000US060990019005,816,731,85,731,22026
15000US060990020021,2451,803,1323,1128,22027
15000US060990020022,1149,412,668,481,22028
15000US060990020023,982,341,622,360,22029
15000US060990020041,1538,771,596,942,22030
15000US060990020042,859,499,355,504,22031
15000US060990020043,1931,933,626,1305,22032
15000US060990020044,2433,675,1209,1224,22033
15000US060990020051,2562,1078,1224,1338,22034
15000US060990020052,1266,288,702,564,22035
15000US060990020061,2437,1131,837,1600,22036
15000US060990020062,2220,882,809,1411,22037
15000US060990021001,1912,605,1273,639,22038
15000US060990021002,1744,426,1241,503,22039
15000US060990022001,1548,368,969,579,22040
15000US060990022002,2919,497,2250,669,22041
15000US060990022003,442,70,332,110,22042
15000US060990022004,1450,151,1140,310,22043
15000US060990023011,2085,242,1629,456,22044
15000US060990023012,3765,378,3089,676,22045
15000US060990023013,1010,256,708,302,22046
15000US060990023014,1766,127,1639,127,22047
15000US060990023021,2159,417,1674,485,22048
15000US060990023022,1706,241,1426,280,22049
15000US060990024011,1740,236,1385,355,22050
15000US060990024012,2062,267,1686,376,22051
15000US060990024021,3015,377,2638,377,22052
15000US060990024022,201,0,201,0,22053
15000US060990024023,2855,210,2541,314,22054
15000US060990025011,1483,257,1176,307,22055
15000US060990025012,550,275,176,374,22056
15000US060990025013,5000,741,3551,1449,22057
15000US060990025031,1319,607,682,637,22058
15000US060990025032,1544,284,1216,328,22059
15000US060990025033,1552,294,1238,314,22060
15000US060990025041,2168,485,1333,835,22061
15000US060990025042,2520,476,1785,735,22062
15000US060990026021,886,415,446,440,22063
15000US060990026022,2510,927,1277,1233,22064
15000US060990026023,1575,489,1034,541,22065
15000US060990026031,669,203,383,286,22066
15000US060990026032,2011,1114,833,1178,22067
15000US060990026041,1360,552,537,823,22068
15000US060990026042,1089,342,619,470,22069
15000US060990026043,1997,240,1617,380,22070
15000US060990026051,1791,705,951,840,22071
15000US060990026052,1913,895,804,1109,22072
15000US060990027011,1521,717,731,790,22073
15000US060990027012,2457,703,1416,1041,22074
15000US060990027021,1880,144,1421,459,22075
15000US060990027022,2009,233,1576,433,22076
15000US060990027023,1400,147,1158,242,22077
15000US060990027024,1170,540,482,688,22078
15000US060990027025,1084,402,603,481,22079
15000US060990028011,2679,1566,869,1810,22080
15000US060990028012,1678,811,692,986,22081
15000US060990028013,1070,887,144,926,22082
15000US060990028021,1066,606,431,635,22083
15000US060990028022,3387,1118,2113,1274,22084
15000US060990028023,775,658,69,706,22085
15000US060990028024,994,727,224,770,22086
15000US060990028031,1777,779,888,889,22087
15000US060990028032,1112,994,61,1051,22088
15000US060990029011,997,693,265,732,22089
15000US060990029012,750,553,172,578,22090
15000US060990029013,769,580,172,597,22091
15000US060990029014,598,247,336,262,22092
15000US060990029015,1320,1041,261,1059,22093
15000US060990029021,2022,1520,173,1849,22094
15000US060990029022,4222,2450,1247,2975,22095
15000US060990029023,900,398,461,439,22096
15000US060990029024,664,432,111,553,22097
15000US060990030011,8118,1725,4137,3981,22098
15000US060990030012,812,551,196,616,22099
15000US060990030013,950,509,439,511,22100
15000US060990030021,1171,529,527,644,22101
15000US060990030022,1128,678,426,702,22102
15000US060990030023,4394,789,3523,871,22103
15000US060990030024,1619,692,913,706,22104
15000US060990031001,972,602,361,611,22105
15000US060990031002,1056,414,574,482,22106
15000US060990031003,2207,1069,1077,1130,22107
15000US060990032011,1369,169,995,374,22108
15000US060990032012,1876,179,1667,209,22109
15000US060990032013,799,304,433,366,22110
15000US060990032014,454,185,220,234,22111
15000US060990032021,1644,1053,588,1056,22112
15000US060990032022,4838,1100,2582,2256,22113
15000US060990032023,9333,1812,5314,4019,22114
15000US060990032024,1224,173,1039,185,22115
15000US060990033001,1231,329,902,329,22116
15000US060990033002,2008,672,1108,900,22117
15000US060990033003,899,447,365,534,22118
15000US060990033004,1341,235,1015,326,22119
15000US060990034001,730,267,463,267,22120
15000US060990034002,828,218,604,224,22121
15000US060990035001,5616,1278,4063,1553,22122
15000US060990035002,805,464,234,571,22123
15000US060990035003,1958,681,1102,856,22124
15000US060990035004,2890,550,2264,626,22125
15000US060990036031,633,431,90,543,22126
15000US060990036032,573,354,219,354,22127
15000US060990036033,777,596,170,607,22128
15000US060990036034,1784,965,771,1013,22129
15000US060990036041,916,667,186,730,22130
15000US060990036042,609,532,0,609,22131
15000US060990036043,2743,1170,1241,1502,22132
15000US060990036044,933,663,227,706,22133
15000US060990036045,3667,2790,831,2836,22134
15000US060990036051,3490,2911,395,3095,22135
15000US060990036052,4607,2270,1491,3116,22136
15000US060990036053,3,2,1,2,22137
15000US060990036061,8107,4168,1911,6196,22138
15000US060990036062,3398,2136,853,2545,22139
15000US060990037001,2987,653,2016,971,22140
15000US060990037002,734,430,285,449,22141
15000US060990037003,1118,732,363,755,22142
15000US060990038021,524,115,362,162,22143
15000US060990038022,1272,199,846,426,22144
15000US060990038023,1973,387,1556,417,22145
15000US060990038024,1894,325,1406,488,22146
15000US060990038031,1590,431,1072,518,22147
15000US060990038032,1431,298,956,475,22148
15000US060990038041,1013,605,248,765,22149
15000US060990038042,1328,641,439,889,22150
15000US060990038043,2593,947,1470,1123,22151
15000US060990038044,1625,376,1216,409,22152
15000US060990038051,2724,1269,1165,1559,22153
15000US060990039041,1060,920,80,980,22154
15000US060990039042,734,312,357,377,22155
15000US060990039043,1446,667,720,726,22156
15000US060990039044,1344,425,897,447,22157
15000US060990039051,843,730,76,767,22158
15000US060990039052,1289,1126,106,1183,22159
15000US060990039053,1318,991,312,1006,22160
15000US060990039054,487,172,267,220,22161
15000US060990039061,971,618,292,679,22162
15000US060990039062,2788,1179,1050,1738,22163
15000US060990039063,1413,564,717,696,22164
15000US060990039071,1744,1290,382,1362,22165
15000US060990039072,2247,1424,745,1502,22166
15000US060990039073,1204,930,102,1102,22167
15000US060990039074,2218,1696,511,1707,22168
15000US060990039081,1304,455,787,517,22169
15000US060990039082,1084,532,363,721,22170
15000US060990039091,2118,1470,294,1824,22171
15000US060990039092,1565,718,729,836,22172
15000US060990039093,1429,799,489,940,22173
15000US060990039094,774,732,19,755,22174
15000US060990040001,912,685,218,694,22175
15000US060990040002,1085,470,399,686,22176
15000US060990040003,1613,952,561,1052,22177
15000US061010501011,2782,1458,828,1954,22178
15000US061010501012,1526,417,662,864,22179
15000US061010501013,1425,649,696,729,22180
15000US061010501014,1104,550,351,753,22181
15000US061010501021,1324,782,445,879,22182
15000US061010501022,1637,964,493,1144,22183
15000US061010501023,1336,627,488,848,22184
15000US061010502011,1580,655,711,869,22185
15000US061010502012,1498,613,455,1043,22186
15000US061010502021,816,185,484,332,22187
15000US061010502022,645,414,183,462,22188
15000US061010502023,551,194,336,215,22189
15000US061010502024,1828,945,817,1011,22190
15000US061010503011,946,609,252,694,22191
15000US061010503012,1408,917,338,1070,22192
15000US061010503021,1193,626,361,832,22193
15000US061010503022,2566,268,2213,353,22194
15000US061010503023,1317,85,1101,216,22195
15000US061010503024,1537,595,659,878,22196
15000US061010504011,1435,540,187,1248,22197
15000US061010504012,814,517,90,724,22198
15000US061010504013,1235,694,481,754,22199
15000US061010504014,1245,686,221,1024,22200
15000US061010504021,1291,1052,190,1101,22201
15000US061010504022,2930,1381,718,2212,22202
15000US061010504031,3566,1917,919,2647,22203
15000US061010505011,750,603,94,656,22204
15000US061010505012,488,350,52,436,22205
15000US061010505013,2737,398,583,2154,22206
15000US061010505014,2217,1029,744,1473,22207
15000US061010505031,646,349,200,446,22208
15000US061010505032,2109,218,370,1739,22209
15000US061010505033,2064,675,203,1861,22210
15000US061010505034,723,539,71,652,22211
15000US061010505035,1621,548,676,945,22212
15000US061010505041,1593,577,269,1324,22213
15000US061010505042,812,585,45,767,22214
15000US061010505043,3663,1947,269,3394,22215
15000US061010505044,1115,660,27,1088,22216
15000US061010506011,1222,587,528,694,22217
15000US061010506012,1488,1100,274,1214,22218
15000US061010506013,3109,1081,396,2713,22219
15000US061010506031,544,479,37,507,22220
15000US061010506032,1471,903,177,1294,22221
15000US061010506033,1554,900,69,1485,22222
15000US061010506034,1204,969,149,1055,22223
15000US061010506041,1603,997,405,1198,22224
15000US061010506042,2471,1445,421,2050,22225
15000US061010507011,2304,820,1199,1105,22226
15000US061010507012,1974,659,1107,867,22227
15000US061010507021,3129,709,2018,1111,22228
15000US061010507022,2177,822,901,1276,22229
15000US061010507023,798,598,100,698,22230
15000US061010508001,2284,1806,246,2038,22231
15000US061010508002,1340,979,217,1123,22232
15000US061010509001,789,582,146,643,22233
15000US061010509002,804,309,421,383,22234
15000US061010510001,733,441,210,523,22235
15000US061010510002,1785,830,793,992,22236
15000US061010511001,798,589,114,684,22237
15000US061010511002,724,514,147,577,22238
15000US061010511003,1028,813,128,900,22239
15000US061030001001,998,792,74,924,22240
15000US061030001002,1841,1419,336,1505,22241
15000US061030001003,953,671,230,723,22242
15000US061030001004,690,431,185,505,22243
15000US061030002001,1423,1280,117,1306,22244
15000US061030002002,3182,2502,548,2634,22245
15000US061030002003,2983,2428,379,2604,22246
15000US061030003001,1973,1642,222,1751,22247
15000US061030003002,2723,1838,716,2007,22248
15000US061030004001,1575,1223,74,1501,22249
15000US061030004002,1429,1317,69,1360,22250
15000US061030004003,2590,2181,193,2397,22251
15000US061030005001,2043,1689,212,1831,22252
15000US061030005002,625,439,59,566,22253
15000US061030005003,881,666,157,724,22254
15000US061030005004,812,705,107,705,22255
15000US061030005005,676,344,43,633,22256
15000US061030006001,2185,1634,407,1778,22257
15000US061030006002,1221,894,238,983,22258
15000US061030006003,1661,1196,446,1215,22259
15000US061030007001,2116,1983,98,2018,22260
15000US061030007002,1928,1068,641,1287,22261
15000US061030007003,558,530,12,546,22262
15000US061030007004,1929,1335,531,1398,22263
15000US061030007005,1569,1300,211,1358,22264
15000US061030008001,920,643,255,665,22265
15000US061030008002,508,401,99,409,22266
15000US061030008003,959,453,439,520,22267
15000US061030008004,1630,627,682,948,22268
15000US061030009001,952,679,250,702,22269
15000US061030009002,1487,907,559,928,22270
15000US061030009003,1397,983,357,1040,22271
15000US061030010001,567,477,75,492,22272
15000US061030010002,2934,1595,1194,1740,22273
15000US061030010003,1247,469,688,559,22274
15000US061030010004,1079,658,389,690,22275
15000US061030010005,684,524,153,531,22276
15000US061030011001,1229,591,308,921,22277
15000US061030011002,1734,479,1255,479,22278
15000US061030011003,1008,541,461,547,22279
15000US061030011004,2073,1181,767,1306,22280
15000US061030011005,331,192,139,192,22281
15000US061030011006,1712,1094,584,1128,22282
15000US061050001011,453,386,7,446,22283
15000US061050001012,1420,1301,33,1387,22284
15000US061050001013,636,456,77,559,22285
15000US061050001021,1518,1307,37,1481,22286
15000US061050001022,1810,1586,86,1724,22287
15000US061050001023,1137,903,35,1102,22288
15000US061050002001,1327,1200,47,1280,22289
15000US061050002002,856,719,35,821,22290
15000US061050003001,956,654,157,799,22291
15000US061050003002,1356,1342,0,1356,22292
15000US061050003003,915,455,404,511,22293
15000US061050004001,481,402,16,465,22294
15000US061050004002,315,225,16,299,22295
15000US061070001001,231,127,18,213,22296
15000US061070001002,382,298,56,326,22297
15000US061070001003,1681,769,882,799,22298
15000US061070001004,1181,971,139,1042,22299
15000US061070001005,1177,1021,119,1058,22300
15000US061070002011,2269,106,2125,144,22301
15000US061070002012,1654,89,1504,150,22302
15000US061070002013,1164,0,1062,102,22303
15000US061070002014,1397,80,1269,128,22304
15000US061070002015,2403,0,1853,550,22305
15000US061070002021,1161,5,1075,86,22306
15000US061070002022,775,324,434,341,22307
15000US061070002023,640,100,501,139,22308
15000US061070003011,2089,781,1246,843,22309
15000US061070003012,1763,205,1538,225,22310
15000US061070003013,996,615,356,640,22311
15000US061070003014,576,132,326,250,22312
15000US061070003015,437,101,336,101,22313
15000US061070003016,811,518,293,518,22314
15000US061070003021,592,186,406,186,22315
15000US061070003022,2084,138,1933,151,22316
15000US061070003023,818,85,664,154,22317
15000US061070004011,1102,57,1031,71,22318
15000US061070004012,2185,323,1629,556,22319
15000US061070004013,2976,292,2583,393,22320
15000US061070004021,767,397,370,397,22321
15000US061070004022,4158,599,3457,701,22322
15000US061070004023,2636,418,2214,422,22323
15000US061070005011,2279,81,2179,100,22324
15000US061070005012,1066,45,1006,60,22325
15000US061070005013,1980,63,1892,88,22326
15000US061070005014,1407,72,1322,85,22327
15000US061070005021,3977,247,3483,494,22328
15000US061070006001,1898,0,1898,0,22329
15000US061070006002,2086,82,2004,82,22330
15000US061070006003,660,8,652,8,22331
15000US061070006004,1965,463,1367,598,22332
15000US061070007011,1418,211,1199,219,22333
15000US061070007012,1154,482,612,542,22334
15000US061070007021,1816,270,1501,315,22335
15000US061070007022,953,216,737,216,22336
15000US061070007023,2224,206,2001,223,22337
15000US061070007024,810,35,775,35,22338
15000US061070008001,859,332,527,332,22339
15000US061070008002,866,443,400,466,22340
15000US061070008003,1001,584,404,597,22341
15000US061070008004,538,9,516,22,22342
15000US061070008005,1986,170,1779,207,22343
15000US061070008006,1954,674,1280,674,22344
15000US061070009001,2076,560,1236,840,22345
15000US061070009002,2082,664,1189,893,22346
15000US061070009003,789,272,494,295,22347
15000US061070009004,2893,277,2328,565,22348
15000US061070009005,1006,204,733,273,22349
15000US061070010031,9032,4141,3760,5272,22350
15000US061070010032,2920,1397,1084,1836,22351
15000US061070010033,4626,1584,2637,1989,22352
15000US061070010034,4966,1511,3354,1612,22353
15000US061070010035,1204,256,330,874,22354
15000US061070010041,2465,49,1955,510,22355
15000US061070010042,1751,132,1476,275,22356
15000US061070010043,2472,215,1683,789,22357
15000US061070010044,1014,14,925,89,22358
15000US061070010051,2816,1712,869,1947,22359
15000US061070010061,664,634,18,646,22360
15000US061070010062,1388,858,366,1022,22361
15000US061070010063,2352,1072,1146,1206,22362
15000US061070010064,849,613,221,628,22363
15000US061070010065,546,422,110,436,22364
15000US061070011001,2006,149,1755,251,22365
15000US061070011002,957,262,645,312,22366
15000US061070011003,2368,466,1746,622,22367
15000US061070011004,2053,154,1385,668,22368
15000US061070012001,993,479,369,624,22369
15000US061070013011,2572,1944,425,2147,22370
15000US061070013012,2011,792,1103,908,22371
15000US061070013013,3558,417,3040,518,22372
15000US061070013021,219,54,53,166,22373
15000US061070013022,2101,846,1141,960,22374
15000US061070013023,2627,810,1478,1149,22375
15000US061070013024,2920,1471,1273,1647,22376
15000US061070014001,2947,473,2474,473,22377
15000US061070014002,769,666,93,676,22378
15000US061070014003,631,516,67,564,22379
15000US061070014004,718,162,556,162,22380
15000US061070014005,706,263,410,296,22381
15000US061070015011,2406,1373,880,1526,22382
15000US061070015012,3002,1991,869,2133,22383
15000US061070015021,1872,955,811,1061,22384
15000US061070015022,1048,348,671,377,22385
15000US061070015023,2122,789,1288,834,22386
15000US061070015024,752,373,356,396,22387
15000US061070016011,1406,156,1003,403,22388
15000US061070016012,1267,329,938,329,22389
15000US061070016013,1117,67,1050,67,22390
15000US061070016014,1790,204,1580,210,22391
15000US061070016021,840,22,802,38,22392
15000US061070016022,1881,201,1667,214,22393
15000US061070016023,1993,510,1467,526,22394
15000US061070016024,746,458,178,568,22395
15000US061070017011,1198,330,844,354,22396
15000US061070017012,1185,236,704,481,22397
15000US061070017013,1574,280,1128,446,22398
15000US061070017014,1149,465,525,624,22399
15000US061070017015,1091,472,573,518,22400
15000US061070017031,1941,799,1131,810,22401
15000US061070017032,1311,824,339,972,22402
15000US061070017033,3717,2102,1116,2601,22403
15000US061070017041,7020,3196,3044,3976,22404
15000US061070018001,593,370,192,401,22405
15000US061070018002,1818,1221,470,1348,22406
15000US061070018003,932,556,320,612,22407
15000US061070018004,1315,410,641,674,22408
15000US061070019011,848,527,321,527,22409
15000US061070019012,2104,756,1280,824,22410
15000US061070019013,916,390,488,428,22411
15000US061070019021,714,451,263,451,22412
15000US061070019022,1314,681,588,726,22413
15000US061070019023,1244,813,220,1024,22414
15000US061070019024,956,617,298,658,22415
15000US061070020021,599,365,188,411,22416
15000US061070020022,1922,679,965,957,22417
15000US061070020023,946,539,360,586,22418
15000US061070020024,1157,444,528,629,22419
15000US061070020031,1590,813,657,933,22420
15000US061070020032,711,525,151,560,22421
15000US061070020033,378,343,35,343,22422
15000US061070020034,1634,907,708,926,22423
15000US061070020035,1981,947,992,989,22424
15000US061070020041,977,432,499,478,22425
15000US061070020042,2537,1295,1047,1490,22426
15000US061070020043,1134,664,426,708,22427
15000US061070020061,1232,1023,188,1044,22428
15000US061070020062,3157,1770,1244,1913,22429
15000US061070020071,3839,2214,1240,2599,22430
15000US061070020072,3230,1195,1550,1680,22431
15000US061070020073,1782,498,1193,589,22432
15000US061070020081,2401,676,1353,1048,22433
15000US061070020082,605,410,157,448,22434
15000US061070020091,1179,681,464,715,22435
15000US061070020092,1978,900,783,1195,22436
15000US061070020093,1043,462,541,502,22437
15000US061070021001,1102,361,682,420,22438
15000US061070021002,1346,597,690,656,22439
15000US061070022021,1721,322,1363,358,22440
15000US061070022022,669,27,499,170,22441
15000US061070022023,3832,387,2965,867,22442
15000US061070022031,3382,700,2462,920,22443
15000US061070022032,1487,349,1091,396,22444
15000US061070022041,3734,885,2722,1012,22445
15000US061070022042,1605,292,1230,375,22446
15000US061070022043,1061,106,849,212,22447
15000US061070023021,1390,715,615,775,22448
15000US061070023022,2065,980,775,1290,22449
15000US061070023023,1098,552,445,653,22450
15000US061070023031,903,643,51,852,22451
15000US061070023032,1837,1348,466,1371,22452
15000US061070023033,872,520,309,563,22453
15000US061070023034,1871,1105,418,1453,22454
15000US061070023035,794,547,247,547,22455
15000US061070023041,954,415,492,462,22456
15000US061070023042,952,411,488,464,22457
15000US061070024001,5563,2404,3091,2472,22458
15000US061070024002,1249,766,379,870,22459
15000US061070024003,1669,643,1006,663,22460
15000US061070024004,1314,723,363,951,22461
15000US061070024005,2768,1722,907,1861,22462
15000US061070025001,525,339,179,346,22463
15000US061070025002,892,461,418,474,22464
15000US061070025003,1269,29,1217,52,22465
15000US061070025004,1768,315,1453,315,22466
15000US061070026011,1672,17,1635,37,22467
15000US061070026012,898,33,865,33,22468
15000US061070026013,2125,206,1809,316,22469
15000US061070026021,922,74,707,215,22470
15000US061070026022,1390,156,1234,156,22471
15000US061070026023,857,282,555,302,22472
15000US061070026024,1540,115,1425,115,22473
15000US061070026025,861,123,728,133,22474
15000US061070027001,476,401,63,413,22475
15000US061070027002,1003,673,310,693,22476
15000US061070027003,564,398,113,451,22477
15000US061070027004,2996,1612,296,2700,22478
15000US061070027005,560,375,18,542,22479
15000US061070028001,2235,266,1741,494,22480
15000US061070028002,1414,157,1248,166,22481
15000US061070029011,1800,455,1117,683,22482
15000US061070029012,1460,15,1336,124,22483
15000US061070029013,367,111,256,111,22484
15000US061070029031,2161,1459,587,1574,22485
15000US061070029032,1131,380,741,390,22486
15000US061070029033,949,285,602,347,22487
15000US061070029034,978,363,467,511,22488
15000US061070029041,3115,1177,1862,1253,22489
15000US061070029042,2068,677,1252,816,22490
15000US061070030011,1020,133,686,334,22491
15000US061070030012,1954,334,1487,467,22492
15000US061070030013,1676,230,1253,423,22493
15000US061070030021,1513,518,816,697,22494
15000US061070030022,1951,168,1699,252,22495
15000US061070031001,693,205,488,205,22496
15000US061070031002,2088,518,1346,742,22497
15000US061070031003,817,405,402,415,22498
15000US061070032001,2993,337,2605,388,22499
15000US061070032002,455,182,273,182,22500
15000US061070032003,755,289,466,289,22501
15000US061070032004,1638,70,1554,84,22502
15000US061070032005,1176,37,1139,37,22503
15000US061070033001,1573,645,928,645,22504
15000US061070033002,1350,225,1121,229,22505
15000US061070033003,506,350,150,356,22506
15000US061070033004,927,90,837,90,22507
15000US061070033005,1226,567,618,608,22508
15000US061070033006,2286,361,1925,361,22509
15000US061070034001,2966,305,2069,897,22510
15000US061070034002,943,313,606,337,22511
15000US061070034003,859,297,527,332,22512
15000US061070034004,2096,546,1388,708,22513
15000US061070034005,580,324,248,332,22514
15000US061070035011,2833,1426,1074,1759,22515
15000US061070035021,805,516,261,544,22516
15000US061070035022,2235,707,1362,873,22517
15000US061070035023,2019,481,1426,593,22518
15000US061070035024,6572,1946,3637,2935,22519
15000US061070036011,1869,794,924,945,22520
15000US061070036012,1505,719,503,1002,22521
15000US061070036013,995,697,298,697,22522
15000US061070036014,2588,359,1770,818,22523
15000US061070036021,2317,524,1540,777,22524
15000US061070036022,820,162,600,220,22525
15000US061070036023,3847,1239,2161,1686,22526
15000US061070037001,1516,565,925,591,22527
15000US061070037002,1417,177,1197,220,22528
15000US061070037003,2014,574,1336,678,22529
15000US061070037004,1478,555,861,617,22530
15000US061070038011,1290,149,1141,149,22531
15000US061070038012,1759,686,948,811,22532
15000US061070038021,1855,479,1321,534,22533
15000US061070038022,1488,132,1317,171,22534
15000US061070038023,1248,520,710,538,22535
15000US061070039011,733,175,410,323,22536
15000US061070039012,1150,102,879,271,22537
15000US061070039013,862,212,632,230,22538
15000US061070039014,1931,129,1771,160,22539
15000US061070039015,2138,410,1726,412,22540
15000US061070039021,2377,1092,1231,1146,22541
15000US061070039022,1942,565,1306,636,22542
15000US061070039023,1510,177,1330,180,22543
15000US061070040001,618,305,184,434,22544
15000US061070041011,2876,312,2478,398,22545
15000US061070041012,2607,326,2198,409,22546
15000US061070041013,1939,125,1747,192,22547
15000US061070041014,1756,232,1524,232,22548
15000US061070041021,2204,516,1557,647,22549
15000US061070042001,1335,129,1160,175,22550
15000US061070042002,1113,128,922,191,22551
15000US061070042003,3644,254,3390,254,22552
15000US061070042004,910,142,751,159,22553
15000US061070043001,1875,279,1496,379,22554
15000US061070043002,2117,116,1872,245,22555
15000US061070043003,850,72,635,215,22556
15000US061070043004,3128,17,2961,167,22557
15000US061070044001,3887,4,3634,253,22558
15000US061070044002,1270,0,1171,99,22559
15000US061070044003,905,0,875,30,22560
15000US061070044004,1473,96,987,486,22561
15000US061070045001,3461,406,2769,692,22562
15000US061070045002,790,33,713,77,22563
15000US061070045003,1240,11,1229,11,22564
15000US061070045004,1120,467,630,490,22565
15000US061090011001,955,769,169,786,22566
15000US061090011002,866,701,121,745,22567
15000US061090011003,1319,932,97,1222,22568
15000US061090011004,517,350,113,404,22569
15000US061090012001,1008,726,139,869,22570
15000US061090012002,1107,822,182,925,22571
15000US061090012003,1333,901,204,1129,22572
15000US061090012004,426,263,132,294,22573
15000US061090021001,636,548,82,554,22574
15000US061090021002,718,645,25,693,22575
15000US061090021003,825,805,12,813,22576
15000US061090021004,586,501,27,559,22577
15000US061090021005,1269,863,316,953,22578
15000US061090021006,878,781,97,781,22579
15000US061090022001,1154,1078,54,1100,22580
15000US061090022002,414,334,59,355,22581
15000US061090022003,781,583,164,617,22582
15000US061090022004,1281,1011,219,1062,22583
15000US061090022005,1999,1723,114,1885,22584
15000US061090022006,1076,882,98,978,22585
15000US061090022007,1382,1299,83,1299,22586
15000US061090031001,1443,1325,44,1399,22587
15000US061090031002,993,915,69,924,22588
15000US061090031003,1391,1371,20,1371,22589
15000US061090031004,2122,1685,310,1812,22590
15000US061090031005,444,350,47,397,22591
15000US061090032001,1818,1525,206,1612,22592
15000US061090032002,555,548,0,555,22593
15000US061090032003,837,623,40,797,22594
15000US061090032004,665,593,72,593,22595
15000US061090032005,975,793,80,895,22596
15000US061090032006,549,425,124,425,22597
15000US061090041001,1400,1315,69,1331,22598
15000US061090041002,1104,963,63,1041,22599
15000US061090041003,1932,1581,327,1605,22600
15000US061090041004,937,891,1,936,22601
15000US061090042001,242,204,29,213,22602
15000US061090042002,2504,2181,206,2298,22603
15000US061090042003,490,388,56,434,22604
15000US061090051001,1415,1267,85,1330,22605
15000US061090051002,1247,1078,168,1079,22606
15000US061090051003,1824,1524,151,1673,22607
15000US061090051004,1379,1127,155,1224,22608
15000US061090051005,1004,846,143,861,22609
15000US061090051006,1429,1371,58,1371,22610
15000US061090052011,754,506,141,613,22611
15000US061090052012,1373,1172,121,1252,22612
15000US061099852021,2508,659,941,1567,22613
15000US061110001001,660,510,107,553,22614
15000US061110002001,1071,62,977,94,22615
15000US061110002002,1544,172,1356,188,22616
15000US061110003021,1647,580,1067,580,22617
15000US061110003022,3290,1139,2137,1153,22618
15000US061110003023,2959,297,2658,301,22619
15000US061110003031,1229,254,975,254,22620
15000US061110003032,2061,265,1754,307,22621
15000US061110003033,1561,620,888,673,22622
15000US061110003041,635,387,208,427,22623
15000US061110003042,2708,315,2376,332,22624
15000US061110003043,941,79,821,120,22625
15000US061110004001,1141,332,734,407,22626
15000US061110004002,1044,416,557,487,22627
15000US061110004003,2486,806,1680,806,22628
15000US061110004004,2283,22,2251,32,22629
15000US061110005001,1624,408,1190,434,22630
15000US061110006001,862,153,699,163,22631
15000US061110006002,1311,140,1164,147,22632
15000US061110006003,2570,81,2412,158,22633
15000US061110006004,1735,23,1629,106,22634
15000US061110007011,2392,166,2099,293,22635
15000US061110007012,2528,258,2098,430,22636
15000US061110007013,1867,211,1650,217,22637
15000US061110007021,1861,460,1312,549,22638
15000US061110007022,1621,228,1367,254,22639
15000US061110008001,759,180,563,196,22640
15000US061110008002,3497,1414,1914,1583,22641
15000US061110008003,2214,493,1674,540,22642
15000US061110008004,1472,426,947,525,22643
15000US061110009011,1793,1554,168,1625,22644
15000US061110009012,713,547,143,570,22645
15000US061110009021,630,598,23,607,22646
15000US061110009022,1418,1174,168,1250,22647
15000US061110009031,2502,1698,688,1814,22648
15000US061110009032,798,681,48,750,22649
15000US061110009033,793,494,230,563,22650
15000US061110009034,1571,1228,241,1330,22651
15000US061110010011,417,417,0,417,22652
15000US061110010012,1627,968,455,1172,22653
15000US061110010013,672,476,102,570,22654
15000US061110010021,1673,1331,326,1347,22655
15000US061110010022,1111,827,240,871,22656
15000US061110010023,2602,1580,1009,1593,22657
15000US061110010024,1019,663,291,728,22658
15000US061110011011,2996,2303,557,2439,22659
15000US061110011012,1974,1008,947,1027,22660
15000US061110011021,2123,1685,345,1778,22661
15000US061110011022,1697,1412,238,1459,22662
15000US061110012011,2430,1453,799,1631,22663
15000US061110012012,2266,1022,1065,1201,22664
15000US061110012021,1763,971,587,1176,22665
15000US061110012022,2459,1674,510,1949,22666
15000US061110012023,2385,1889,236,2149,22667
15000US061110012041,2952,1220,1520,1432,22668
15000US061110012061,829,424,252,577,22669
15000US061110013011,1508,395,875,633,22670
15000US061110013012,1591,771,784,807,22671
15000US061110013013,2989,1482,1170,1819,22672
15000US061110013014,2403,1466,720,1683,22673
15000US061110013021,2186,735,1255,931,22674
15000US061110014011,1479,911,227,1252,22675
15000US061110014012,2559,1482,870,1689,22676
15000US061110014021,1710,1255,378,1332,22677
15000US061110014022,2412,1265,1079,1333,22678
15000US061110014023,1220,798,245,975,22679
15000US061110015021,2416,1370,776,1640,22680
15000US061110015022,2314,897,1260,1054,22681
15000US061110015023,2147,894,993,1154,22682
15000US061110015024,2192,1407,579,1613,22683
15000US061110015031,2917,1299,1175,1742,22684
15000US061110015032,1772,850,788,984,22685
15000US061110015033,578,343,183,395,22686
15000US061110015061,2425,1241,940,1485,22687
15000US061110015062,1243,773,378,865,22688
15000US061110015063,1534,1084,408,1126,22689
15000US061110015071,863,545,202,661,22690
15000US061110015072,1608,885,400,1208,22691
15000US061110015073,1833,539,905,928,22692
15000US061110016011,1286,671,402,884,22693
15000US061110016021,1548,1149,315,1233,22694
15000US061110016022,743,534,109,634,22695
15000US061110017001,2436,1911,326,2110,22696
15000US061110017002,1002,712,201,801,22697
15000US061110018001,871,586,96,775,22698
15000US061110018002,2037,1389,356,1681,22699
15000US061110018003,802,756,8,794,22700
15000US061110018004,830,600,168,662,22701
15000US061110019001,718,468,191,527,22702
15000US061110019002,1360,997,213,1147,22703
15000US061110019003,317,213,63,254,22704
15000US061110019004,847,713,69,778,22705
15000US061110019005,697,471,216,481,22706
15000US061110020001,967,602,281,686,22707
15000US061110020002,893,770,16,877,22708
15000US061110020003,880,646,167,713,22709
15000US061110021021,1606,1337,198,1408,22710
15000US061110022001,2618,979,1624,994,22711
15000US061110022002,1419,126,1194,225,22712
15000US061110022003,2417,1019,1335,1082,22713
15000US061110023001,2723,695,1998,725,22714
15000US061110023002,2111,177,1916,195,22715
15000US061110023003,1375,575,784,591,22716
15000US061110023004,1238,293,921,317,22717
15000US061110024001,966,663,225,741,22718
15000US061110024002,1661,993,501,1160,22719
15000US061110025001,1364,1168,136,1228,22720
15000US061110025002,1351,879,340,1011,22721
15000US061110025003,318,289,29,289,22722
15000US061110025004,1839,1677,27,1812,22723
15000US061110026001,918,678,228,690,22724
15000US061110026002,1925,1146,652,1273,22725
15000US061110026003,583,372,211,372,22726
15000US061110027001,1184,775,332,852,22727
15000US061110027002,2928,1959,810,2118,22728
15000US061110028001,2402,1035,1173,1229,22729
15000US061110028002,1079,815,264,815,22730
15000US061110028003,1173,856,218,955,22731
15000US061110028004,1393,821,495,898,22732
15000US061110028005,558,383,158,400,22733
15000US061110029011,4053,1476,1785,2268,22734
15000US061110029012,1878,309,1124,754,22735
15000US061110029051,2538,567,1527,1011,22736
15000US061110029052,2901,529,1870,1031,22737
15000US061110030101,3298,462,2382,916,22738
15000US061110030111,2893,281,2387,506,22739
15000US061110030112,2895,262,2346,549,22740
15000US061110030121,639,11,628,11,22741
15000US061110030131,1613,519,674,939,22742
15000US061110030132,3684,636,2804,880,22743
15000US061110031001,5115,660,3639,1476,22744
15000US061110031002,10120,785,7434,2686,22745
15000US061110032011,1795,50,1731,64,22746
15000US061110032012,2526,27,2488,38,22747
15000US061110033001,2217,199,1979,238,22748
15000US061110033002,1909,454,1254,655,22749
15000US061110033003,2106,289,1516,590,22750
15000US061110033004,1337,384,802,535,22751
15000US061110033005,1403,80,1227,176,22752
15000US061110036051,3852,1068,2173,1679,22753
15000US061110036052,3768,1288,1922,1846,22754
15000US061110036053,1511,496,632,879,22755
15000US061110036081,3897,536,2761,1136,22756
15000US061110036091,2869,2423,91,2778,22757
15000US061110036092,1213,1176,37,1176,22758
15000US061110036093,1827,1320,251,1576,22759
15000US061110036121,0,0,0,0,22760
15000US061110036122,2211,1674,377,1834,22761
15000US061110036123,2389,1914,222,2167,22762
15000US061110037001,3157,108,2862,295,22763
15000US061110037002,3705,177,3301,404,22764
15000US061110038011,1443,0,1443,0,22765
15000US061110038012,3581,34,3305,276,22766
15000US061110038021,2796,117,2575,221,22767
15000US061110039001,3393,85,3136,257,22768
15000US061110039002,3981,122,3529,452,22769
15000US061110040001,1713,86,1595,118,22770
15000US061110040002,1858,109,1710,148,22771
15000US061110040003,1817,16,1486,331,22772
15000US061110040004,1607,126,1446,161,22773
15000US061110041011,3122,100,2779,343,22774
15000US061110041012,1962,311,1439,523,22775
15000US061110041013,1999,200,1561,438,22776
15000US061110042001,1961,246,1392,569,22777
15000US061110042002,2207,327,1592,615,22778
15000US061110042003,1435,216,1061,374,22779
15000US061110043041,1255,121,1050,205,22780
15000US061110043042,1444,791,379,1065,22781
15000US061110043043,2114,717,1063,1051,22782
15000US061110043044,1963,274,1508,455,22783
15000US061110043051,2071,1128,381,1690,22784
15000US061110044001,1289,570,491,798,22785
15000US061110044002,2201,265,1441,760,22786
15000US061110044003,1191,132,832,359,22787
15000US061110044004,2995,1154,1287,1708,22788
15000US061110045031,1282,23,1232,50,22789
15000US061110045032,3187,278,2248,939,22790
15000US061110045041,3190,161,2791,399,22791
15000US061110045042,2115,242,1266,849,22792
15000US061110045051,2237,167,1795,442,22793
15000US061110045061,4170,206,3471,699,22794
15000US061110045062,1802,0,1802,0,22795
15000US061110045063,1887,31,1579,308,22796
15000US061110046001,2184,1226,366,1818,22797
15000US061110047041,368,92,271,97,22798
15000US061110047042,1189,171,910,279,22799
15000US061110047101,1665,196,1419,246,22800
15000US061110047102,2567,112,2106,461,22801
15000US061110047103,529,75,364,165,22802
15000US061110047111,1756,9,1447,309,22803
15000US061110047112,1833,151,648,1185,22804
15000US061110047151,2665,469,1934,731,22805
15000US061110047152,2666,172,1884,782,22806
15000US061110047161,1800,106,1393,407,22807
15000US061110047162,3017,229,2559,458,22808
15000US061110047171,1966,104,1696,270,22809
15000US061110047172,2394,51,2205,189,22810
15000US061110049011,7205,926,4450,2755,22811
15000US061110049021,2785,152,2591,194,22812
15000US061110049022,2156,0,2156,0,22813
15000US061110050021,2994,176,2798,196,22814
15000US061110050031,3404,311,3045,359,22815
15000US061110050032,4816,561,3977,839,22816
15000US061110050041,7674,1889,4415,3259,22817
15000US061110051001,557,398,129,428,22818
15000US061110051002,1351,253,949,402,22819
15000US061110051003,1903,991,809,1094,22820
15000US061110052021,948,422,505,443,22821
15000US061110052022,1882,1330,285,1597,22822
15000US061110052031,2788,1957,494,2294,22823
15000US061110052032,2135,1241,553,1582,22824
15000US061110052033,770,665,58,712,22825
15000US061110052041,1944,1526,205,1739,22826
15000US061110052042,1562,1082,203,1359,22827
15000US061110052051,2138,1444,355,1783,22828
15000US061110052052,3757,1726,1054,2703,22829
15000US061110053031,6308,4187,920,5388,22830
15000US061110053032,3264,2111,677,2587,22831
15000US061110053041,2266,1967,129,2137,22832
15000US061110053042,1702,1087,348,1354,22833
15000US061110053043,1183,965,11,1172,22834
15000US061110053051,3152,1866,558,2594,22835
15000US061110053052,2525,2085,249,2276,22836
15000US061110053061,2046,1410,353,1693,22837
15000US061110053062,2842,2074,512,2330,22838
15000US061110054011,1817,1140,491,1326,22839
15000US061110054012,2290,1277,716,1574,22840
15000US061110054031,2609,1094,1283,1326,22841
15000US061110054041,2237,1368,817,1420,22842
15000US061110054042,1559,926,575,984,22843
15000US061110055021,1807,688,801,1006,22844
15000US061110055022,1404,776,403,1001,22845
15000US061110055023,2056,784,743,1313,22846
15000US061110055031,2854,1284,833,2021,22847
15000US061110055032,1390,735,364,1026,22848
15000US061110055041,2032,1269,551,1481,22849
15000US061110055042,2313,1609,440,1873,22850
15000US061110056001,2918,1232,1388,1530,22851
15000US061110056002,1801,1421,150,1651,22852
15000US061110056003,4972,2514,1288,3684,22853
15000US061110057001,3494,1778,1113,2381,22854
15000US061110058011,833,675,131,702,22855
15000US061110058012,2252,1893,117,2135,22856
15000US061110058013,2254,1387,280,1974,22857
15000US061110058021,2740,2103,295,2445,22858
15000US061110058022,5109,3552,417,4692,22859
15000US061110058023,1818,1358,224,1594,22860
15000US061110059011,1415,1150,180,1235,22861
15000US061110059012,2110,1288,477,1633,22862
15000US061110059013,1160,1005,108,1052,22863
15000US061110059014,314,290,0,314,22864
15000US061110059015,2060,1901,86,1974,22865
15000US061110059061,1420,1079,228,1192,22866
15000US061110059062,2985,2240,383,2602,22867
15000US061110059063,1290,1054,82,1208,22868
15000US061110059064,821,659,66,755,22869
15000US061110059071,1445,1126,178,1267,22870
15000US061110059072,879,792,80,799,22871
15000US061110059073,1342,1199,75,1267,22872
15000US061110059081,1334,779,287,1047,22873
15000US061110059082,1496,1185,56,1440,22874
15000US061110059091,2158,1265,538,1620,22875
15000US061110059092,1486,1282,177,1309,22876
15000US061110059101,1755,1486,103,1652,22877
15000US061110059111,1900,1229,448,1452,22878
15000US061110059112,589,397,80,509,22879
15000US061110059113,1328,1076,167,1161,22880
15000US061110060001,1046,719,229,817,22881
15000US061110060002,1869,1298,400,1469,22882
15000US061110060003,1738,1031,491,1247,22883
15000US061110061001,3517,2076,374,3143,22884
15000US061110061002,344,218,126,218,22885
15000US061110061003,1255,11,1169,86,22886
15000US061110061004,3522,698,1903,1619,22887
15000US061110062001,2188,1818,128,2060,22888
15000US061110062002,724,436,261,463,22889
15000US061110063011,2557,2019,319,2238,22890
15000US061110063012,2649,1828,336,2313,22891
15000US061110063013,1143,914,140,1003,22892
15000US061110063021,2700,1485,617,2083,22893
15000US061110063022,1144,1010,31,1113,22894
15000US061110064001,2317,1548,332,1985,22895
15000US061110064002,1669,1439,126,1543,22896
15000US061110064003,947,706,231,716,22897
15000US061110064004,767,415,228,539,22898
15000US061110064005,1627,936,584,1043,22899
15000US061110065001,1480,746,675,805,22900
15000US061110065002,2065,974,881,1184,22901
15000US061110066001,1865,1383,244,1621,22902
15000US061110066002,1828,1427,225,1603,22903
15000US061110066003,631,431,94,537,22904
15000US061110067001,679,531,126,553,22905
15000US061110067002,2511,1925,183,2328,22906
15000US061110068001,1357,1038,265,1092,22907
15000US061110068002,1548,959,486,1062,22908
15000US061110068003,897,483,247,650,22909
15000US061110069001,1451,1135,186,1265,22910
15000US061110069002,2526,1283,919,1607,22911
15000US061110070001,2035,891,626,1409,22912
15000US061110070002,1945,911,939,1006,22913
15000US061110071001,1621,693,928,693,22914
15000US061110071002,2951,1478,1148,1803,22915
15000US061110071003,1552,673,523,1029,22916
15000US061110072011,841,691,77,764,22917
15000US061110072012,1723,1319,194,1529,22918
15000US061110072013,1005,797,167,838,22919
15000US061110072021,2355,1958,229,2126,22920
15000US061110072022,1877,1320,146,1731,22921
15000US061110073001,1846,1604,85,1761,22922
15000US061110074021,2304,1974,133,2171,22923
15000US061110074022,2352,2018,214,2138,22924
15000US061110074023,1696,1174,162,1534,22925
15000US061110074031,1269,817,74,1195,22926
15000US061110074032,2309,1721,129,2180,22927
15000US061110074033,2536,2047,241,2295,22928
15000US061110074051,4036,2726,182,3854,22929
15000US061110074052,1181,1139,21,1160,22930
15000US061110074053,1260,933,244,1016,22931
15000US061110074061,2542,1903,148,2394,22932
15000US061110075051,1318,847,306,1012,22933
15000US061110075052,2021,1393,473,1548,22934
15000US061110075061,1249,873,72,1177,22935
15000US061110075062,1516,1347,131,1385,22936
15000US061110075063,865,595,250,615,22937
15000US061110075064,2481,2186,173,2308,22938
15000US061110075065,1258,803,333,925,22939
15000US061110075071,2037,1510,68,1969,22940
15000US061110075072,1097,1006,35,1062,22941
15000US061110075073,3904,2928,601,3303,22942
15000US061110075081,1119,951,69,1050,22943
15000US061110075082,2497,1793,575,1922,22944
15000US061110075091,1824,1299,102,1722,22945
15000US061110075092,2741,1899,436,2305,22946
15000US061110075101,2232,1735,162,2070,22947
15000US061110075102,2080,1383,207,1873,22948
15000US061110075103,1809,1149,189,1620,22949
15000US061110075111,1911,1297,180,1731,22950
15000US061110075112,493,370,75,418,22951
15000US061110075121,3335,2019,869,2466,22952
15000US061110075122,2020,1475,199,1821,22953
15000US061110075131,1626,1272,242,1384,22954
15000US061110075141,1508,1141,65,1443,22955
15000US061110075142,1673,1239,213,1460,22956
15000US061110075143,3234,2169,678,2556,22957
15000US061110076061,1644,925,299,1345,22958
15000US061110076071,2847,1949,516,2331,22959
15000US061110076072,3397,2811,239,3158,22960
15000US061110076091,2720,1986,360,2360,22961
15000US061110076101,2513,1671,473,2040,22962
15000US061110076102,2747,1994,478,2269,22963
15000US061110076111,3288,481,2657,631,22964
15000US061110076112,856,195,661,195,22965
15000US061110076121,3357,1385,1826,1531,22966
15000US061110076122,1770,1254,347,1423,22967
15000US061110076131,2281,1256,851,1430,22968
15000US061110076132,1753,1143,194,1559,22969
15000US061110076141,1740,1292,353,1387,22970
15000US061110076142,2344,1544,426,1918,22971
15000US061110076143,1057,874,41,1016,22972
15000US061110076144,2573,836,1538,1035,22973
15000US061110077001,2292,1378,681,1611,22974
15000US061110077002,2033,926,929,1104,22975
15000US061110077003,1801,802,695,1106,22976
15000US061110078001,2935,667,1674,1261,22977
15000US061110078002,1359,853,292,1067,22978
15000US061110079011,2429,1110,901,1528,22979
15000US061110079012,1257,463,657,600,22980
15000US061110079013,1740,1032,563,1177,22981
15000US061110079031,4809,2942,706,4103,22982
15000US061110079041,1524,998,268,1256,22983
15000US061110079042,1360,860,373,987,22984
15000US061110079043,1337,797,426,911,22985
15000US061110079044,734,405,292,442,22986
15000US061110079045,757,260,426,331,22987
15000US061110080011,1504,897,430,1074,22988
15000US061110080012,2025,1035,806,1219,22989
15000US061110080021,1729,1154,444,1285,22990
15000US061110080022,2557,1213,1250,1307,22991
15000US061110080023,1053,286,666,387,22992
15000US061110080041,1689,1022,447,1242,22993
15000US061110080042,1477,644,697,780,22994
15000US061110080043,857,307,458,399,22995
15000US061110080044,906,629,199,707,22996
15000US061110080051,1841,712,803,1038,22997
15000US061110080052,780,360,354,426,22998
15000US061110081011,1852,1143,565,1287,22999
15000US061110081012,1456,1086,259,1197,23000
15000US061110082011,2067,1148,731,1336,23001
15000US061110082012,2558,1443,663,1895,23002
15000US061110082021,1498,577,509,989,23003
15000US061110082022,1065,674,308,757,23004
15000US061110082023,2203,1186,623,1580,23005
15000US061110083021,2035,1276,518,1517,23006
15000US061110083022,3641,2123,946,2695,23007
15000US061110083031,760,524,70,690,23008
15000US061110083032,2938,1701,764,2174,23009
15000US061110083041,1805,1345,166,1639,23010
15000US061110083042,2361,1372,849,1512,23011
15000US061110083043,1517,683,127,1390,23012
15000US061110083051,3797,2157,646,3151,23013
15000US061110083061,593,359,24,569,23014
15000US061110083062,1497,642,723,774,23015
15000US061110083063,1878,1152,432,1446,23016
15000US061110084011,2497,1540,547,1950,23017
15000US061110084012,1169,849,214,955,23018
15000US061110084013,1730,1063,542,1188,23019
15000US061110084021,1986,1457,280,1706,23020
15000US061110084022,1682,1401,165,1517,23021
15000US061110084023,757,535,213,544,23022
15000US061110084024,973,738,121,852,23023
15000US061110085001,2841,2293,408,2433,23024
15000US061110085002,2122,1540,337,1785,23025
15000US061110085003,3494,2318,351,3143,23026
15000US061110086001,3670,603,2801,869,23027
15000US061110086002,2771,211,2536,235,23028
15000US061110086003,481,65,370,111,23029
15000US061110086004,1084,25,812,272,23030
15000US061110087001,1780,243,1344,436,23031
15000US061110087002,2738,524,2128,610,23032
15000US061110087003,1774,263,1466,308,23033
15000US061110088001,3516,855,2409,1107,23034
15000US061110088002,1910,292,1423,487,23035
15000US061110089001,1164,83,993,171,23036
15000US061110089002,2231,341,1840,391,23037
15000US061110091001,1788,11,1603,185,23038
15000US061110091002,1252,95,1107,145,23039
15000US061110091003,493,0,493,0,23040
15000US061110091004,1108,0,1066,42,23041
15000US061119800001,104,27,67,37,23042
15000US061119901000,0,0,0,0,23043
15000US061130101011,848,450,78,770,23044
15000US061130101012,1807,586,964,843,23045
15000US061130101013,3267,904,1713,1554,23046
15000US061130101014,1478,699,356,1122,23047
15000US061130101021,2054,1000,805,1249,23048
15000US061130101022,1694,1115,150,1544,23049
15000US061130101023,700,231,271,429,23050
15000US061130101024,2888,850,1470,1418,23051
15000US061130102011,2340,1099,953,1387,23052
15000US061130102012,937,685,186,751,23053
15000US061130102031,1679,482,1033,646,23054
15000US061130102032,1927,497,889,1038,23055
15000US061130102033,1450,976,218,1232,23056
15000US061130102034,298,218,18,280,23057
15000US061130102041,2760,906,1742,1018,23058
15000US061130102042,822,669,107,715,23059
15000US061130102043,1026,750,173,853,23060
15000US061130103021,1615,768,605,1010,23061
15000US061130103022,1930,1064,582,1348,23062
15000US061130103023,4321,2023,644,3677,23063
15000US061130103101,3475,1434,900,2575,23064
15000US061130103102,1572,924,421,1151,23065
15000US061130103103,690,253,226,464,23066
15000US061130103121,3376,2048,818,2558,23067
15000US061130103122,1676,1185,125,1551,23068
15000US061130103123,579,410,42,537,23069
15000US061130104011,615,557,29,586,23070
15000US061130104012,2610,1624,530,2080,23071
15000US061130104013,1204,753,389,815,23072
15000US061130104021,2248,1298,192,2056,23073
15000US061130104022,2070,843,492,1578,23074
15000US061130105011,4747,1600,639,4108,23075
15000US061130105012,3014,1112,641,2373,23076
15000US061130105051,686,570,61,625,23077
15000US061130105052,250,130,120,130,23078
15000US061130105053,3819,2406,475,3344,23079
15000US061130105081,2453,1793,240,2213,23080
15000US061130105091,1452,760,254,1198,23081
15000US061130105092,1963,1279,308,1655,23082
15000US061130105101,664,428,23,641,23083
15000US061130105102,2095,1072,72,2023,23084
15000US061130105103,1534,518,348,1186,23085
15000US061130105104,1082,813,55,1027,23086
15000US061130105111,1337,678,357,980,23087
15000US061130105112,2145,1324,87,2058,23088
15000US061130105121,1803,952,175,1628,23089
15000US061130105122,1799,903,352,1447,23090
15000US061130105131,1100,809,55,1045,23091
15000US061130105132,1431,816,269,1162,23092
15000US061130106021,2142,1066,363,1779,23093
15000US061130106022,1344,862,227,1117,23094
15000US061130106023,1120,608,329,791,23095
15000US061130106024,1472,464,323,1149,23096
15000US061130106051,2334,1369,89,2245,23097
15000US061130106052,1135,352,455,680,23098
15000US061130106061,1182,804,111,1071,23099
15000US061130106062,1844,1297,135,1709,23100
15000US061130106063,1077,475,192,885,23101
15000US061130106064,2888,1947,557,2331,23102
15000US061130106065,619,470,106,513,23103
15000US061130106071,1219,544,196,1023,23104
15000US061130106072,708,575,16,692,23105
15000US061130106073,2370,1663,161,2209,23106
15000US061130106081,1451,925,181,1270,23107
15000US061130106082,4151,961,700,3451,23108
15000US061130106083,693,273,124,569,23109
15000US061130107011,1200,709,318,882,23110
15000US061130107012,2069,1149,376,1693,23111
15000US061130107013,792,551,136,656,23112
15000US061130107014,737,514,16,721,23113
15000US061130107031,689,346,116,573,23114
15000US061130107032,1925,932,343,1582,23115
15000US061130107033,1961,718,223,1738,23116
15000US061130107034,1118,593,86,1032,23117
15000US061130107041,2510,1510,397,2113,23118
15000US061130108001,1653,622,953,700,23119
15000US061130108002,953,358,461,492,23120
15000US061130108003,1022,55,883,139,23121
15000US061130109011,2248,900,1255,993,23122
15000US061130109012,1053,367,557,496,23123
15000US061130109013,2355,964,1270,1085,23124
15000US061130109021,2260,898,1211,1049,23125
15000US061130109022,2547,844,1446,1101,23126
15000US061130109023,1456,785,481,975,23127
15000US061130110011,2066,1167,780,1286,23128
15000US061130110012,2621,664,1731,890,23129
15000US061130110013,1820,644,917,903,23130
15000US061130110021,1329,816,476,853,23131
15000US061130110022,1303,962,237,1066,23132
15000US061130110023,1009,662,330,679,23133
15000US061130111011,1307,592,602,705,23134
15000US061130111012,1632,719,825,807,23135
15000US061130111021,2815,646,1929,886,23136
15000US061130111022,2190,370,1389,801,23137
15000US061130111031,1826,486,859,967,23138
15000US061130111032,1223,572,409,814,23139
15000US061130112031,1434,910,346,1088,23140
15000US061130112032,968,799,121,847,23141
15000US061130112041,2000,1467,470,1530,23142
15000US061130112042,1907,850,976,931,23143
15000US061130112043,1518,573,670,848,23144
15000US061130112051,2650,886,1204,1446,23145
15000US061130112052,1407,658,626,781,23146
15000US061130112053,1277,387,729,548,23147
15000US061130112054,1515,699,663,852,23148
15000US061130112055,1383,633,529,854,23149
15000US061130112061,1121,435,638,483,23150
15000US061130112062,2758,1879,818,1940,23151
15000US061130112063,4264,1813,918,3346,23152
15000US061130113001,1382,715,651,731,23153
15000US061130113002,927,274,589,338,23154
15000US061130113003,3001,1372,1503,1498,23155
15000US061130113004,2454,885,1418,1036,23156
15000US061130113005,853,539,312,541,23157
15000US061130114001,939,402,482,457,23158
15000US061130114002,2097,675,1416,681,23159
15000US061130114003,1312,647,522,790,23160
15000US061130115001,461,296,105,356,23161
15000US061130115002,987,449,375,612,23162
15000US061130115003,2918,1103,1545,1373,23163
15000US061130115004,535,293,218,317,23164
15000US061130115005,835,151,675,160,23165
15000US061150401001,866,654,124,742,23166
15000US061150401002,652,344,240,412,23167
15000US061150401003,1125,653,249,876,23168
15000US061150401004,952,587,232,720,23169
15000US061150401005,1013,397,346,667,23170
15000US061150402001,671,450,65,606,23171
15000US061150402002,2028,1450,246,1782,23172
15000US061150402003,788,503,148,640,23173
15000US061150402004,1254,540,662,592,23174
15000US061150402005,1043,420,536,507,23175
15000US061150402006,1166,1070,62,1104,23176
15000US061150402007,1151,388,698,453,23177
15000US061150403011,3298,1264,1122,2176,23178
15000US061150403021,2247,895,880,1367,23179
15000US061150403031,6013,2761,1717,4296,23180
15000US061150403032,1474,532,508,966,23181
15000US061150404001,1697,723,827,870,23182
15000US061150404002,1538,832,563,975,23183
15000US061150404003,1824,668,616,1208,23184
15000US061150405001,1277,535,563,714,23185
15000US061150405002,1566,681,528,1038,23186
15000US061150405003,1023,336,594,429,23187
15000US061150406001,1515,857,411,1104,23188
15000US061150406002,787,479,119,668,23189
15000US061150406003,1441,542,844,597,23190
15000US061150406004,861,230,580,281,23191
15000US061150406005,993,611,165,828,23192
15000US061150407001,1990,938,417,1573,23193
15000US061150407002,3425,1647,1366,2059,23194
15000US061150407003,512,207,240,272,23195
15000US061150407004,2893,1553,679,2214,23196
15000US061150407005,3940,2473,887,3053,23197
15000US061150408001,2761,1858,553,2208,23198
15000US061150408002,436,208,193,243,23199
15000US061150408003,1140,933,100,1040,23200
15000US061150409011,1851,1515,205,1646,23201
15000US061150409012,1259,538,401,858,23202
15000US061150409021,1067,631,194,873,23203
15000US061150409022,43,28,4,39,23204
15000US061150409023,512,335,27,485,23205
15000US061150410001,1915,1661,54,1861,23206
15000US061150410002,2423,2123,181,2242,23207
15000US061150410003,1430,1115,259,1171,23208
15000US061150410004,1152,865,162,990,23209
15000US061150410005,499,409,90,409,23210
15000US061150411001,934,754,79,855,23211
15000US061150411002,1597,1256,109,1488,23212
15000US061150411003,1196,1084,45,1151,23213
15000US061150411004,659,617,13,646,23214